AppID,Name,ReleaseYear,Genre,Price,DiscountPercent,PositiveReviews_SteamSpy,NegativeReviews_SteamSpy,TotalReviews_SteamSpy,EstimatedRevenue_SteamSpy,PositiveReviews_HTML,NegativeReviews_HTML,TotalReviews_HTML,EstimatedRevenue_HTML
286160,Tabletop Simulator,2015,Deckbuilding,"₩21,500",0%,66735,3925,70660,75959500000,0,0,0,0
880940,Pummel Party,2018,Deckbuilding,"₩16,500",0%,47800,6014,53814,44396550000,0,0,0,0
3097560,Liar's Bar,2024,Deckbuilding,"₩7,800",0%,44341,4209,48550,18934500000,0,0,0,0
2525310,Drop Duchy,2025,Deckbuilding,"₩13,200",19%,1225,141,1366,901560000,1571,194,1765,1164900000
1948280,Stacklands,2022,Deckbuilding,"₩8,800",0%,0,0,0,0,0,0,0,0
527230,For The King,2018,Deckbuilding,"₩20,500",0%,36581,4906,41487,42524175000,0,0,0,0
1737690,Yacht Dice,2021,Deckbuilding,"₩1,100",0%,292,65,357,19635000,299,79,378,20790000
965580,Root,2020,Deckbuilding,"₩15,500",0%,3971,442,4413,3420075000,0,0,0,0
3358250,Loot of Baal,2025,Deckbuilding,"₩9,760",0%,0,0,0,0,618,395,1013,494344000
3399960,Fish to Dish: Idle Sushi,2025,Deckbuilding,"₩6,700",0%,0,0,0,0,608,32,640,214400000
1236720,Spirit Island,2020,Deckbuilding,"₩27,000",0%,1140,106,1246,1682100000,1088,108,1196,1614600000
3470170,Queens Casino,2025,Deckbuilding,"₩9,900",9%,0,0,0,0,112,0,112,55440000
1555400,Gomoku Let's Go,2021,Deckbuilding,"₩3,300",0%,746,101,847,139755000,718,98,816,134640000
3353100,Passant: A Chess Roguelike,2025,Deckbuilding,"₩12,150",9%,0,0,0,0,121,26,147,89302500
1272160,The Life and Suffering of Sir Brante,2021,Deckbuilding,"₩20,500",0%,7790,829,8619,8834475000,0,0,0,0
3743220,A Solitaire Mystery,2025,Deckbuilding,"₩11,000",0%,0,0,0,0,158,17,175,96250000
3591550,Hunter Roulette,2025,Deckbuilding,"₩1,840",19%,0,0,0,0,322,44,366,33672000
2797650,Pip My Dice,2025,Deckbuilding,"₩12,500",0%,0,0,0,0,67,4,71,44375000
1478220,Puzzle Together Multiplayer Jigsaw Puzzles,2020,Deckbuilding,Free,0%,3801,637,4438,0,0,0,0,0
2442460,Citizen Sleeper 2: Starward Vector,2025,Deckbuilding,"₩27,000",0%,1239,77,1316,1776600000,1277,96,1373,1853550000
3376250,Nine-Ball Roulette,2025,Deckbuilding,"₩4,500",0%,727,111,838,188550000,773,115,888,199800000
3005620,Drop Pockets,2025,Deckbuilding,"₩16,500",0%,0,0,0,0,89,21,110,90750000
502520,Ultimate General: Civil War,2017,Deckbuilding,"₩32,000",0%,7123,861,7984,12774400000,0,0,0,0
1578650,Citizen Sleeper,2022,Deckbuilding,"₩21,500",0%,7522,583,8105,8712875000,0,0,0,0
2004180,DAGURI: Gambling Apocalypse,2022,Deckbuilding,"₩3,300",0%,180,10,190,31350000,174,11,185,30525000
3629080,Sizzle & Stack,2025,Deckbuilding,"₩9,900",9%,0,0,0,0,130,44,174,86130000
3194140,Cozy Sudoku,2024,Deckbuilding,"₩3,400",0%,59,5,64,10880000,58,6,64,10880000
1196310,Fantasy Grounds VTT,2020,Deckbuilding,"₩53,000",0%,730,144,874,2316100000,610,134,744,1971600000
720620,TaleSpire,2021,Deckbuilding,"₩26,000",0%,4271,410,4681,6085300000,0,0,0,0
2248180,Just Xiangqi,2024,Deckbuilding,"₩11,000",0%,536,81,617,339350000,522,92,614,337700000
337150,Sentinels of the Multiverse,2014,Deckbuilding,"₩1,100",90%,1440,168,1608,88440000,1069,80,1149,63195000
3356790,Cozy Solitaire,2024,Deckbuilding,"₩4,500",0%,46,3,49,11025000,50,8,58,13050000
1883000,HEART of CROWN Online,2024,Deckbuilding,"₩17,200",19%,243,43,286,245960000,207,46,253,217580000
351030,Pixel Puzzles Ultimate Jigsaw Puzzles,2022,Deckbuilding,Free,0%,2018,659,2677,0,0,0,0,0
1128810,RISK: Global Domination,2020,Deckbuilding,Free,0%,31060,7783,38843,0,0,0,0,0
1870300,SOVL: Fantasy Warfare,2023,Deckbuilding,Free,0%,0,0,0,0,0,0,0,0
1063580,Aeon's End,2019,Deckbuilding,"₩16,500",0%,363,79,442,364650000,324,71,395,325875000
829660,No Time to Relax,2019,Deckbuilding,"₩14,500",0%,2195,189,2384,1728400000,0,0,0,0
3438800,Doodle Empires,2025,Deckbuilding,"₩7,800",0%,62,4,66,25740000,312,35,347,135330000
247000,Talisman: Digital Classic Edition,2014,Deckbuilding,Free,0%,7569,2092,9661,0,0,0,0,0
770100,One Deck Dungeon,2018,Deckbuilding,"₩11,000",0%,665,158,823,452650000,594,139,733,403150000
1299620,Fabled Lands,2022,Deckbuilding,"₩8,200",60%,393,94,487,199670000,379,95,474,194340000
2088670,Puzzline,2022,Deckbuilding,"₩4,400",0%,124,1,125,27500000,131,0,131,28820000
1383050,Chess Knights: Shinobi,2020,Deckbuilding,"₩2,380",30%,57,12,69,8211000,56,11,67,7973000
2564140,Desktop Garage Kit : Go,2023,Deckbuilding,"₩20,500",0%,16,3,19,19475000,19,6,25,25625000
943410,Istanbul: Digital Edition,2018,Deckbuilding,"₩17,000",0%,186,12,198,168300000,220,22,242,205700000
3547790,My Wife,2025,Deckbuilding,"₩2,300",0%,49,4,53,6095000,71,5,76,8740000
2114370,Takoyaki Party Survival,2022,Deckbuilding,"₩3,400",0%,227,13,240,40800000,196,13,209,35530000
333300,ADOM (Ancient Domains Of Mystery),2015,Deckbuilding,"₩16,000",0%,1297,233,1530,1224000000,1043,156,1199,959200000
2160470,Zup! Y,2024,Deckbuilding,"₩2,300",0%,0,0,0,0,169,13,182,20930000
748970,Zen Chess: Mate in One,2018,Deckbuilding,₩770,30%,358,51,409,15746500,315,39,354,13629000
1058200,Pixel Puzzles Traditional Jigsaw Puzzles,2019,Deckbuilding,Free,0%,373,121,494,0,383,128,511,0
235620,Small World,2013,Deckbuilding,"₩11,000",0%,1011,455,1466,806300000,649,252,901,495550000
1817000,Zodiacats,2022,Deckbuilding,"₩2,200",0%,1088,11,1099,120890000,1055,22,1077,118470000
2693730,Dawnsbury Days,2024,Deckbuilding,"₩5,600",0%,589,12,601,168280000,628,13,641,179480000
349730,Popup Dungeon,2020,Deckbuilding,"₩10,400",60%,772,248,1020,530400000,478,119,597,310440000
965590,Sagrada,2020,Deckbuilding,"₩10,500",0%,352,16,368,193200000,269,11,280,147000000
1725640,Sudocats,2022,Deckbuilding,"₩2,200",0%,1469,17,1486,163460000,1416,29,1445,158950000
397900,Business Tour - Board Game with Online Multiplayer,2017,Deckbuilding,Free,0%,46567,30205,76772,0,0,0,0,0
1500290,Desktop Honey,2021,Deckbuilding,"₩1,100",0%,23,5,28,1540000,19,4,23,1265000
518060,Chess Ultra,2017,Deckbuilding,"₩13,500",0%,1596,539,2135,1441125000,1290,408,1698,1146150000
1974290,Sentinels of Earth-Prime,2023,Deckbuilding,"₩4,290",78%,47,6,53,11368500,33,4,37,7936500
1036950,Super Jigsaw Puzzle: Generations,2019,Deckbuilding,Free,0%,976,52,1028,0,985,63,1048,0
1974300,One Deck Galaxy,2024,Deckbuilding,"₩14,500",0%,33,10,43,31175000,32,11,43,31175000
2491200,TOUHOU GENSOU MAHJONG,2024,Deckbuilding,"₩53,000",0%,37,41,78,206700000,37,45,82,217300000
618550,Chess of Blades,2018,Deckbuilding,"₩26,000",0%,103,10,113,146900000,88,9,97,126100000
628900,Terra Mystica,2017,Deckbuilding,"₩18,500",0%,159,103,262,242350000,151,100,251,232175000
1174460,Poker Club,2020,Deckbuilding,"₩20,500",0%,281,205,486,498150000,264,192,456,467400000
1256490,Othello Let's Go,2020,Deckbuilding,"₩2,200",0%,47,2,49,5390000,42,3,45,4950000
965600,Raiders of the North Sea,2019,Deckbuilding,"₩15,500",0%,207,29,236,182900000,191,28,219,169725000
1318240,Shields of Loyalty,2025,Deckbuilding,"₩15,050",30%,88,16,104,78260000,74,19,93,69982500
2749100,Dawnmaker,2024,Deckbuilding,"₩21,600",0%,122,9,131,141480000,128,11,139,150120000
883080,Ludo Online: Classic Multiplayer Dice Board Game,2019,Deckbuilding,"₩1,100",0%,344,76,420,23100000,247,62,309,16995000
2140850,Looper Tactics,2023,Deckbuilding,"₩12,500",0%,445,53,498,311250000,380,47,427,266875000
3008240,How We Die,2024,Deckbuilding,"₩15,500",0%,18,3,21,16275000,12,3,15,11625000
904400,Cardpocalypse,2020,Deckbuilding,"₩27,000",0%,212,29,241,325350000,157,21,178,240300000
2206560,Zup! Q,2023,Deckbuilding,"₩2,300",0%,0,0,0,0,648,20,668,76820000
2113450,"Forests, Fields and Fortresses",2023,Deckbuilding,"₩5,600",0%,64,2,66,18480000,38,1,39,10920000
1005930,Timeflow – Life Sim,2019,Deckbuilding,"₩9,900",0%,1439,104,1543,763785000,1205,105,1310,648450000
838410,Tabletop Playground,2020,Deckbuilding,"₩16,500",0%,172,72,244,201300000,87,15,102,84150000
1606300,Puzzle Light,2021,Deckbuilding,₩550,50%,42,4,46,1265000,43,3,46,1265000
965610,Reiner Knizia Yellow & Yangtze,2019,Deckbuilding,"₩15,500",0%,97,11,108,83700000,91,9,100,77500000
663390,Rento Fortune: Online Dice Board Game (大富翁),2017,Deckbuilding,"₩5,500",0%,1708,1678,3386,931150000,0,0,0,0
856880,Fighting Fantasy Classics,2018,Deckbuilding,Free,0%,255,63,318,0,260,65,325,0
2427360,Idle Taoist Mage Warrior,2023,Deckbuilding,"₩5,600",0%,112,20,132,36960000,107,17,124,34720000
1309200,3D Math - Ultra,2020,Deckbuilding,"₩5,600",0%,196,12,208,58240000,190,14,204,57120000
2373800,Conclave Virtual Tabletop,2023,Deckbuilding,"₩12,900",40%,24,7,31,19995000,22,7,29,18705000
2346570,Songs of Life,2025,Deckbuilding,"₩9,900",0%,107,20,127,62865000,63,12,75,37125000
908070,Mystic Vale,2019,Deckbuilding,"₩14,500",0%,378,46,424,307400000,312,39,351,254475000
1370170,Diorama Builder,2024,Deckbuilding,"₩5,600",0%,424,25,449,125720000,327,17,344,96320000
2675630,Cats Huddled Together 挤在一起的猫猫们,2023,Deckbuilding,"₩2,300",0%,0,0,0,0,285,50,335,38525000
1234220,Paper Pirates,2020,Deckbuilding,"₩14,500",0%,114,11,125,90625000,98,10,108,78300000
3249580,Yakiniku Party Survival,2024,Deckbuilding,"₩3,400",0%,20,1,21,3570000,21,2,23,3910000
2789810,Bingle Bingle,2024,Deckbuilding,"₩12,500",0%,379,67,446,278750000,368,75,443,276875000
2511780,Vestiges: Fallen Tribes,2025,Deckbuilding,"₩27,000",0%,30,6,36,48600000,26,7,33,44550000
740810,Pleasure Puzzle:Workshop 趣拼拼：拼图工坊,2018,Deckbuilding,"₩1,100",0%,200,26,226,12430000,130,21,151,8305000
1969860,MACHI KORO With Everyone,2024,Deckbuilding,"₩27,000",0%,66,37,103,139050000,66,41,107,144450000
1653970,Jigsaw Puzzle Dreams,2021,Deckbuilding,Free,0%,0,0,0,0,977,62,1039,0
2723460,Dogs Huddled Together 挤在一起的狗狗们,2024,Deckbuilding,"₩2,300",0%,0,0,0,0,99,16,115,13225000
3216750,Caverna,2025,Deckbuilding,"₩21,500",0%,6,1,7,7525000,8,3,11,11825000
2704510,Simple CEO,2024,Deckbuilding,"₩3,150",30%,14,6,20,3150000,11,6,17,2677500
2093900,Island Cities - Jigsaw Puzzle,2022,Deckbuilding,"₩2,300",0%,203,12,215,24725000,184,10,194,22310000
939620,Pleasure Puzzle:Portrait 趣拼拼：肖像画,2018,Deckbuilding,"₩1,100",0%,1681,173,1854,101970000,180,9,189,10395000
1188270,The Curse of Feldar Vale,2021,Deckbuilding,"₩6,000",0%,52,7,59,17700000,53,7,60,18000000
1795110,Classic Card Games Collection,2021,Deckbuilding,"₩15,500",0%,16,6,22,17050000,18,5,23,17825000
3612640,Infiniclick,2025,Deckbuilding,"₩8,900",0%,0,0,0,0,69,30,99,44055000
476240,KNIGHTS,2016,Deckbuilding,"₩1,100",0%,737,48,785,43175000,696,44,740,40700000
1643180,Artist Life Simulator,2022,Deckbuilding,"₩20,500",0%,147,29,176,180400000,128,28,156,159900000
2622750,Nonograms,2024,Deckbuilding,Free,0%,0,0,0,0,61,13,74,0
1131190,NERTS! Online,2021,Deckbuilding,Free,0%,1490,72,1562,0,1499,79,1578,0
391580,Egyptian Senet,2015,Deckbuilding,"₩11,000",0%,277,77,354,194700000,155,36,191,105050000
2011160,Puzzles with nature,2022,Deckbuilding,"₩1,210",89%,12,2,14,847000,9,1,10,605000
917840,Wintermoor Tactics Club,2020,Deckbuilding,"₩16,500",0%,542,69,611,504075000,451,61,512,422400000
257670,Elder Sign: Omens,2013,Deckbuilding,"₩6,700",0%,346,101,447,149745000,330,99,429,143715000
2752720,Dice Player One,2024,Deckbuilding,"₩16,500",0%,458,39,497,410025000,399,40,439,362175000
3370120,Block Puzzle,2024,Deckbuilding,"₩2,300",0%,0,0,0,0,13,1,14,1610000
539270,Mahjong,2017,Deckbuilding,"₩10,500",0%,416,84,500,262500000,388,74,462,242550000
966090,Canasta 3D Premium,2019,Deckbuilding,"₩10,500",0%,48,18,66,34650000,45,17,62,32550000
994270,Where Birds 鸟儿在哪里,2024,Deckbuilding,"₩1,100",0%,0,0,0,0,33,0,33,1815000
1706190,SudoKats,2021,Deckbuilding,"₩2,300",0%,72,7,79,9085000,66,7,73,8395000
1799160,Math+Sticks - Coffee Break Club,2021,Deckbuilding,"₩2,300",0%,48,6,54,6210000,45,6,51,5865000
1101270,Anime Artist,2019,Deckbuilding,"₩2,300",0%,151,33,184,21160000,136,30,166,19090000
293260,Card Hunter,2015,Deckbuilding,Free,0%,4487,749,5236,0,0,0,0,0
1517240,CHESS with LASERS,2021,Deckbuilding,"₩12,500",0%,36,0,36,22500000,26,0,26,16250000
1458590,Anime Artist 3: Harem,2020,Deckbuilding,"₩2,300",0%,62,10,72,8280000,60,11,71,8165000
1145410,Knight Swap,2019,Deckbuilding,"₩1,100",0%,124,16,140,7700000,105,13,118,6490000
1939940,Roll Player - The Board Game,2023,Deckbuilding,"₩15,500",0%,131,16,147,113925000,125,17,142,110050000
1261700,Knight's Retreat,2020,Deckbuilding,"₩3,400",0%,89,8,97,16490000,69,4,73,12410000
661280,Dresden Files Cooperative Card Game,2017,Deckbuilding,"₩18,500",0%,92,21,113,104525000,85,20,105,97125000
1614340,Matchsticks - Coffee Break Club,2021,Deckbuilding,"₩2,300",0%,84,3,87,10005000,80,3,83,9545000
2323670,Jigsaw Puzzle Delicious Foods,2023,Deckbuilding,"₩1,100",0%,16,0,16,880000,15,0,15,825000
900400,Sacred Fire: A Role Playing Game,2021,Deckbuilding,"₩20,500",0%,444,23,467,478675000,414,26,440,451000000
2619860,Animated Jigsaw Puzzles,2024,Deckbuilding,"₩5,600",0%,15,0,15,4200000,10,0,10,2800000
3052500,ColdRidge,2024,Deckbuilding,"₩11,000",0%,77,26,103,56650000,60,25,85,46750000
2394070,Melody Mania,2023,Deckbuilding,"₩20,500",0%,36,10,46,47150000,39,10,49,50225000
2097180,OxU,2022,Deckbuilding,"₩2,300",0%,21,0,21,2415000,208,2,210,24150000
415910,Gigachess,2015,Deckbuilding,"₩4,400",0%,78,16,94,20680000,69,16,85,18700000
1726890,Hidden Kittens: Kingdom of Cats,2024,Deckbuilding,"₩2,300",0%,0,0,0,0,43,0,43,4945000
1798690,Blackjack Avenue,2022,Deckbuilding,"₩3,400",0%,15,1,16,2720000,13,1,14,2380000
778340,Animals Memory: Dogs,2018,Deckbuilding,"₩4,500",0%,37,10,47,10575000,33,8,41,9225000
1607040,Evertried,2021,Deckbuilding,"₩21,500",0%,55,14,69,74175000,25,9,34,36550000
1906140,SEARCH ALL - BERRIES,2022,Deckbuilding,"₩3,400",0%,62,10,72,12240000,57,10,67,11390000
1524690,Chess Brain: Dark Troops,2021,Deckbuilding,"₩1,100",0%,58,4,62,3410000,58,4,62,3410000
620650,Puzzle With Your Friends,2018,Deckbuilding,"₩5,500",0%,159,22,181,49775000,133,22,155,42625000
1454090,Army of Numbers,2021,Deckbuilding,"₩2,300",0%,79,6,85,9775000,74,6,80,9200000
1729050,The Fox in the Forest,2021,Deckbuilding,"₩7,500",0%,29,3,32,12000000,22,2,24,9000000
1674150,Gromopoli,2021,Deckbuilding,Free,0%,0,0,0,0,143,29,172,0
2138580,Exotica: Petshop Simulator,2024,Deckbuilding,"₩8,900",0%,410,78,488,217160000,385,79,464,206480000
869690,Cat Lady - The Card Game,2019,Deckbuilding,"₩4,500",0%,283,19,302,67950000,209,6,215,48375000
1424980,The Solitaire Conspiracy,2020,Deckbuilding,"₩12,500",0%,672,80,752,470000000,648,80,728,455000000
904570,TOK,2018,Deckbuilding,"₩1,100",0%,257,23,280,15400000,247,24,271,14905000
2617350,MACHO SPINNER,2023,Deckbuilding,"₩9,900",0%,16,6,22,10890000,11,6,17,8415000
1342890,Who Needs a Hero?,2021,Deckbuilding,"₩20,880",6%,1331,123,1454,1517976000,1254,124,1378,1438632000
1580600,Hunted: Kobayashi Tower,2021,Deckbuilding,"₩5,500",0%,17,0,17,4675000,17,0,17,4675000
1199660,The Answer Is 42,2019,Deckbuilding,"₩2,300",0%,142,14,156,17940000,119,6,125,14375000
312720,Khet 2.0,2014,Deckbuilding,"₩10,500",0%,143,20,163,85575000,103,13,116,60900000
1568240,Castle Itter - The Strangest Battle of WWII,2021,Deckbuilding,"₩9,500",0%,11,0,11,5225000,10,0,10,4750000
448560,Mind Games,2016,Deckbuilding,"₩5,600",0%,133,54,187,52360000,88,49,137,38360000
300630,Pure Chess Grandmaster Edition,2016,Deckbuilding,"₩16,500",0%,194,69,263,216975000,168,53,221,182325000
1374930,Black Geyser: Couriers of Darkness,2022,Deckbuilding,"₩31,000",0%,663,226,889,1377950000,595,209,804,1246200000
3059390,Hexagod,2025,Deckbuilding,"₩8,900",0%,59,6,65,28925000,65,8,73,32485000
251210,Hive,2014,Deckbuilding,"₩10,500",0%,250,46,296,155400000,192,39,231,121275000
523150,Mahjong World Contest (麻将),2016,Deckbuilding,"₩16,500",0%,181,28,209,172425000,165,25,190,156750000
1373630,Ragnar's Chinese Memory Game,2020,Deckbuilding,"₩6,500",0%,26,0,26,8450000,28,0,28,9100000
2398590,Azure Orphanage,2024,Deckbuilding,"₩18,500",0%,61,9,70,64750000,37,11,48,44400000
1307880,Hanoi Puzzles: Solid Match,2020,Deckbuilding,"₩3,400",0%,54,2,56,9520000,51,2,53,9010000
1653870,Hidden Shapes Old West - Jigsaw Puzzle Game,2021,Deckbuilding,"₩2,300",0%,36,2,38,4370000,23,0,23,2645000
1404190,Chess Brain,2020,Deckbuilding,"₩1,100",0%,135,14,149,8195000,128,16,144,7920000
2474750,Happy Poker,2025,Deckbuilding,"₩5,600",0%,44,2,46,12880000,24,3,27,7560000
1945230,Diablo The Abyss,2023,Deckbuilding,"₩8,800",0%,180,35,215,94600000,171,35,206,90640000
1774700,INVERT,2021,Deckbuilding,"₩2,300",0%,61,2,63,7245000,61,3,64,7360000
705020,Bottom of the 9th,2017,Deckbuilding,"₩1,100",0%,51,9,60,3300000,40,9,49,2695000
2530420,Fatermyth,2024,Deckbuilding,"₩11,000",0%,418,78,496,272800000,371,81,452,248600000
3153240,IFSolitaire,2024,Deckbuilding,"₩1,100",0%,10,2,12,660000,10,2,12,660000
2833590,DACHstudio Jigsaw Puzzle Box,2024,Deckbuilding,Free,0%,0,0,0,0,67,4,71,0
324740,The Warlock of Firetop Mountain,2016,Deckbuilding,"₩21,500",0%,528,180,708,761100000,263,78,341,366575000
3573000,Milo's Tiny Fish Pond,2025,Deckbuilding,"₩5,600",0%,35,0,35,9800000,29,1,30,8400000
1161360,Shisensho Solitaire,2019,Deckbuilding,"₩2,300",0%,80,1,81,9315000,74,1,75,8625000
934540,Pleasure Puzzle:Sexy Girls 趣拼拼：性感少女,2018,Deckbuilding,"₩1,100",0%,195,49,244,13420000,123,31,154,8470000
1946140,Jigsaw Puzzles Infinite,2023,Deckbuilding,Free,0%,324,55,379,0,332,58,390,0
1629600,Hidden Shapes Lovely Cats - Jigsaw Puzzle Game,2021,Deckbuilding,"₩2,300",0%,53,9,62,7130000,39,5,44,5060000
1660560,Chess Valley 2,2021,Deckbuilding,"₩1,100",0%,15,6,21,1155000,14,5,19,1045000
1820690,One Line,2021,Deckbuilding,₩550,50%,54,1,55,1512500,50,1,51,1402500
656590,Eight-Minute Empire,2017,Deckbuilding,"₩10,000",0%,94,27,121,60500000,82,26,108,54000000
1071330,Dark Fantasy 2: Jigsaw Puzzle,2019,Deckbuilding,"₩3,370",0%,121,23,144,24264000,116,24,140,23590000
2167760,Shong,2023,Deckbuilding,Free,0%,0,0,0,0,10,1,11,0
1149940,Lock 'n Load Tactical Digital: Core Game,2020,Deckbuilding,"₩5,500",0%,459,82,541,148775000,445,85,530,145750000
2101710,Cube Farmer - Puzzle,2022,Deckbuilding,"₩1,020",70%,24,0,24,1224000,16,0,16,816000
2070190,Alice in Wonderland Jigsaw Puzzle,2022,Deckbuilding,"₩2,200",0%,22,1,23,2530000,19,1,20,2200000
1951750,This is a game,2022,Deckbuilding,Free,0%,0,0,0,0,14,3,17,0
1707770,Animals Memory: Monkeys,2021,Deckbuilding,"₩3,400",0%,26,4,30,5100000,19,2,21,3570000
799800,Animals Memory: Cats,2018,Deckbuilding,"₩4,500",0%,82,14,96,21600000,69,11,80,18000000
2529880,Royal Card Clash,2024,Deckbuilding,"₩3,400",0%,18,1,19,3230000,12,1,13,2210000
1746700,The Alchemist Shop: An Apprentice's Life,2022,Deckbuilding,"₩3,400",0%,16,0,16,2720000,16,0,16,2720000
962050,Puzzles for smart: Birds,2018,Deckbuilding,"₩4,500",0%,17,3,20,4500000,11,2,13,2925000
775910,Animals Memory: Birds,2018,Deckbuilding,"₩4,500",0%,40,9,49,11025000,38,9,47,10575000
894540,ShyChess,2018,Deckbuilding,"₩2,200",0%,34,7,41,4510000,31,5,36,3960000
2363920,Jigsaw Puzzle World Memories,2023,Deckbuilding,"₩2,300",0%,15,1,16,1840000,14,1,15,1725000
971780,Elemental Connection,2018,Deckbuilding,"₩3,300",0%,11,0,11,1815000,10,0,10,1650000
2470610,Progress Chess,2024,Deckbuilding,"₩8,900",0%,7,3,10,4450000,9,3,12,5340000
1005230,Pixel Puzzles Musical,2024,Deckbuilding,Free,0%,0,0,0,0,16,4,20,0
1462220,Mini War - Three Kingdoms,2020,Deckbuilding,"₩1,100",0%,21,2,23,1265000,16,2,18,990000
1709180,Solitaire Expeditions,2022,Deckbuilding,"₩11,000",0%,78,2,80,44000000,65,2,67,36850000
1815270,PRIMAFLOOWS,2021,Deckbuilding,"₩5,500",0%,12,6,18,4950000,11,1,12,3300000
421260,Militia,2015,Deckbuilding,"₩6,500",0%,134,7,141,45825000,85,5,90,29250000
1991450,Philosophical Jigsaw - The Zen Koans,2022,Deckbuilding,"₩1,540",30%,23,0,23,1771000,20,0,20,1540000
3076120,FreeCell Solitaire Classic Card Game,2024,Deckbuilding,Free,0%,0,0,0,0,12,0,12,0
1593410,The Awakening of Mummies,2021,Deckbuilding,"₩2,300",0%,27,6,33,3795000,21,3,24,2760000
2209270,Moorhuhn Piraten - Crazy Chicken Pirates,2023,Deckbuilding,"₩5,600",0%,10,0,10,2800000,11,0,11,3080000
2119580,Golden Record Retriever,2024,Deckbuilding,"₩17,500",0%,32,16,48,42000000,22,16,38,33250000
2977360,Cartographers,2024,Deckbuilding,"₩6,700",0%,6,6,12,4020000,6,6,12,4020000
366760,Adorables,2016,Deckbuilding,"₩5,600",0%,913,253,1166,326480000,163,36,199,55720000
1034540,Lorenzo il Magnifico,2020,Deckbuilding,"₩15,500",0%,68,24,92,71300000,38,17,55,42625000
1338980,Chess Knights: Viking Lands,2020,Deckbuilding,"₩3,400",0%,61,6,67,11390000,55,4,59,10030000
1906570,The Art of War: Card Game,2024,Deckbuilding,Free,0%,0,0,0,0,61,15,76,0
1221800,Anime Artist 2: Lovely Danya,2020,Deckbuilding,"₩2,300",0%,93,9,102,11730000,91,9,100,11500000
1683590,Hustle Game,2021,Deckbuilding,"₩1,100",0%,8,5,13,715000,10,0,10,550000
1357090,Button Soccer League,2020,Deckbuilding,"₩3,300",0%,13,1,14,2310000,11,1,12,1980000
2136110,Vox Populi: Brazil 2022,2024,Deckbuilding,"₩5,600",0%,74,5,79,22120000,66,4,70,19600000
1054240,Easy puzzle: Animals,2019,Deckbuilding,"₩4,500",0%,14,0,14,3150000,12,0,12,2700000
1272920,Easy puzzle: Streets,2020,Deckbuilding,"₩4,500",0%,12,0,12,2700000,12,0,12,2700000
402560,Tabletopia,2016,Deckbuilding,Free,0%,998,592,1590,0,990,606,1596,0
1485580,Chess Valley,2021,Deckbuilding,"₩1,100",0%,39,5,44,2420000,36,4,40,2200000
835680,Intelligence: Dinosaurs,2018,Deckbuilding,"₩4,500",0%,9,1,10,2250000,9,2,11,2475000
835680,Intelligence: Dinosaurs,2018,Deckbuilding,"₩4,500",0%,9,1,10,2250000,9,2,11,2475000
911270,Intelligence: Cats,2018,Deckbuilding,"₩4,500",0%,12,7,19,4275000,10,0,10,2250000
38600,Faerie Solitaire,2010,Deckbuilding,"₩15,500",0%,2292,229,2521,1953775000,1204,149,1353,1048575000
1692580,Hidden Shapes Black Skull - Jigsaw Puzzle Game,2021,Deckbuilding,"₩2,300",0%,38,4,42,4830000,22,0,22,2530000
493380,ChessVR,2016,Deckbuilding,"₩5,500",0%,11,5,16,4400000,7,5,12,3300000
1593220,Jessie 'Boom' James - a jigsaw chess tale,2021,Deckbuilding,"₩2,300",0%,15,4,19,2185000,14,1,15,1725000
2746610,Oil Sheik,2025,Deckbuilding,Free,0%,0,0,0,0,20,3,23,0
957930,Intelligence: Underwater Kingdom,2018,Deckbuilding,"₩4,500",0%,8,2,10,2250000,8,2,10,2250000
860880,Castle: Jigsaw Puzzles,2018,Deckbuilding,"₩2,300",0%,13,4,17,1955000,8,2,10,1150000
1272330,Easy puzzle: Bridges,2020,Deckbuilding,"₩4,500",0%,12,0,12,2700000,11,0,11,2475000
2969060,Casino Island Simulator,2024,Deckbuilding,"₩9,900",0%,93,36,129,63855000,75,42,117,57915000
1498600,Neko Chan,2021,Deckbuilding,"₩3,400",0%,24,5,29,4930000,20,4,24,4080000
3813480,Game Tech Simulator,2025,Deckbuilding,"₩3,400",0%,0,0,0,0,10,1,11,1870000
431520,Age of Fear: Total,2023,Deckbuilding,"₩63,000",0%,30,4,34,107100000,27,3,30,94500000
1406930,Space Travel Jigsaw Puzzles,2020,Deckbuilding,Free,0%,20,2,22,0,20,2,22,0
1828640,IllusionCircle,2021,Deckbuilding,"₩1,100",0%,92,7,99,5445000,89,9,98,5390000
1029900,Rummy 3D Premium,2019,Deckbuilding,"₩11,000",0%,48,18,66,36300000,41,20,61,33550000
2590580,3D Chess Online,2023,Deckbuilding,"₩1,100",0%,11,8,19,1045000,9,6,15,825000
2196770,Spartacus: Born to be free,2022,Deckbuilding,"₩3,400",0%,13,1,14,2380000,10,1,11,1870000
1343550,Conflict Area,2020,Deckbuilding,"₩4,400",0%,39,8,47,10340000,33,5,38,8360000
1604210,Grid Slayer,2022,Deckbuilding,"₩12,500",0%,25,4,29,18125000,21,3,24,15000000
1324870,Ur Game: The Game of Ancient Gods,2020,Deckbuilding,"₩6,500",0%,33,4,37,12025000,21,2,23,7475000
1587190,Puzzletronics Digital Infinite,2021,Deckbuilding,"₩2,300",0%,43,9,52,5980000,43,8,51,5865000
736420,Yag,2022,Deckbuilding,"₩17,500",0%,35,4,39,34125000,27,4,31,27125000
982750,Puzzles for smart: Underwater Kingdom,2018,Deckbuilding,"₩4,500",0%,12,1,13,2925000,10,1,11,2475000
806900,Them Bombs,2019,Deckbuilding,"₩11,500",0%,66,3,69,39675000,55,4,59,33925000
2504630,Ur,2024,Deckbuilding,Free,0%,0,0,0,0,15,3,18,0
2439780,Godzilla Voxel Wars,2023,Deckbuilding,"₩16,500",0%,109,6,115,94875000,99,6,105,86625000
1427400,Sky Journey - Jigsaw Landscapes,2020,Deckbuilding,"₩2,300",0%,25,4,29,3335000,22,3,25,2875000
2884080,OMG Words,2025,Deckbuilding,"₩11,000",0%,61,10,71,39050000,55,11,66,36300000
428610,Longsword - Tabletop Tactics,2017,Deckbuilding,Free,0%,81,68,149,0,82,67,149,0
3078190,Decipher The Deck,2024,Deckbuilding,"₩5,600",0%,17,0,17,4760000,15,0,15,4200000
835640,Dust and Salt: The Battle for Murk,2018,Deckbuilding,"₩2,250",50%,13,2,15,1687500,8,2,10,1125000
336680,TREBUCHET,2015,Deckbuilding,"₩6,500",0%,29,14,43,13975000,15,7,22,7150000
1285350,Easy puzzle: Landscape,2020,Deckbuilding,"₩4,500",0%,13,2,15,3375000,12,0,12,2700000
777340,Animals Memory: Underwater Kingdom,2018,Deckbuilding,"₩4,500",0%,30,7,37,8325000,28,6,34,7650000
941920,Classic Card Games 3D,2018,Deckbuilding,"₩20,500",0%,70,29,99,101475000,66,24,90,92250000
395900,Backgammon Blitz,2015,Deckbuilding,"₩4,400",0%,145,101,246,54120000,114,94,208,45760000
863400,Feud,2024,Deckbuilding,Free,0%,196,22,218,0,194,24,218,0
891040,Pool 2D - Poolians,2019,Deckbuilding,Free,0%,8222,1216,9438,0,0,0,0,0
2702010,Cute Cats Slide,2023,Deckbuilding,"₩1,100",0%,0,0,0,0,26,14,40,2200000
360730,Cards and Castles,2015,Deckbuilding,Free,0%,561,208,769,0,554,215,769,0
1391200,Pixel With Your Friends,2024,Deckbuilding,"₩5,500",0%,80,0,80,22000000,47,0,47,12925000
1007940,Classic Jigsaw Puzzles,2019,Deckbuilding,"₩5,600",0%,22,6,28,7840000,21,5,26,7280000
1871500,One Line: Letters and Codes,2022,Deckbuilding,"₩1,100",0%,57,3,60,3300000,48,3,51,2805000
3438900,Azazel Gamble 阿撒兹勒赌局,2025,Deckbuilding,"₩11,000",0%,29,1,30,16500000,21,2,23,12650000
1520610,BlackJack Math Cross Numbers,2021,Deckbuilding,"₩1,100",0%,20,5,25,1375000,14,2,16,880000
1292240,The Chess Variants Club,2020,Deckbuilding,"₩5,600",0%,43,11,54,15120000,33,7,40,11200000
769730,Awkward,2018,Deckbuilding,"₩12,500",0%,71,29,100,62500000,62,25,87,54375000
3032230,Mushiverse - Online Boardgame,2024,Deckbuilding,Free,0%,11,0,11,0,12,1,13,0
845860,Gem Rush,2018,Deckbuilding,"₩11,000",0%,18,1,19,10450000,15,1,16,8800000
782570,Endless Road: Reborn,2018,Deckbuilding,"₩11,500",0%,391,127,518,297850000,317,111,428,246100000
1562780,Broilers,2022,Deckbuilding,"₩5,500",0%,13,2,15,4125000,10,2,12,3300000
1415620,Sudoku Forever,2020,Deckbuilding,"₩5,500",0%,17,5,22,6050000,14,5,19,5225000
379610,Animated Puzzles,2016,Deckbuilding,"₩10,500",0%,76,5,81,42525000,68,4,72,37800000
775520,Animals Memory: Dinosaurs,2018,Deckbuilding,"₩4,500",0%,41,9,50,11250000,39,9,48,10800000
837400,Fated Kingdom,2019,Deckbuilding,"₩10,500",0%,225,76,301,158025000,199,66,265,139125000
1428270,Good puzzle: Animals,2020,Deckbuilding,"₩3,400",0%,10,0,10,1700000,12,0,12,2040000
2685280,Where Kiwis 几维鸟在哪里,2024,Deckbuilding,"₩1,100",0%,0,0,0,0,32,0,32,1760000
3430570,Survive till 100 years old,2025,Deckbuilding,"₩2,300",0%,20,5,25,2875000,17,6,23,2645000
1089880,Sudoku 9x16x25,2019,Deckbuilding,"₩2,300",0%,10,4,14,1610000,10,4,14,1610000
1505380,A hermit crab is finding a house,2021,Deckbuilding,"₩1,100",0%,34,0,34,1870000,27,0,27,1485000
944750,Forgotten Souls,2021,Deckbuilding,Free,0%,0,0,0,0,17,5,22,0
1983670,Cosmopoly,2022,Deckbuilding,Free,0%,22,7,29,0,22,7,29,0
1349000,Jigsaw Puzzle - Animals,2020,Deckbuilding,"₩1,100",0%,34,4,38,2090000,27,4,31,1705000
1804760,SEARCH ALL - CANDY,2021,Deckbuilding,"₩3,400",0%,56,12,68,11560000,48,5,53,9010000
858860,Tabletop Gods,2019,Deckbuilding,"₩20,500",0%,85,10,95,97375000,34,2,36,36900000
2222770,Mimi the Cat - Mimi's Scratcher,2022,Deckbuilding,"₩3,400",0%,28,4,32,5440000,24,4,28,4760000
1784220,Chesskoban - Chess Puzzles,2021,Deckbuilding,"₩1,100",0%,35,2,37,2035000,35,2,37,2035000
715370,Fidget Spinner Editor,2017,Deckbuilding,"₩2,300",0%,87,12,99,11385000,40,6,46,5290000
2590810,Vox Populi: Poland 2023,2023,Deckbuilding,"₩5,600",0%,43,7,50,14000000,47,5,52,14560000
675270,Rockets Are Super Hard,2020,Deckbuilding,"₩15,500",0%,17,5,22,17050000,14,4,18,13950000
1871290,Finger Football,2022,Deckbuilding,"₩1,100",0%,17,6,23,1265000,16,6,22,1210000
314340,Chess 2: The Sequel,2014,Deckbuilding,"₩6,500",0%,56,60,116,37700000,35,42,77,25025000
2552560,Panzer Commander,2024,Deckbuilding,"₩7,800",0%,13,0,13,5070000,12,0,12,4680000
1300560,Mars Power Industries: First Job,2020,Deckbuilding,Free,0%,61,4,65,0,60,4,64,0
2552560,Panzer Commander,2024,Deckbuilding,"₩7,800",0%,13,0,13,5070000,12,0,12,4680000
808880,MiniTracks,2020,Deckbuilding,"₩5,500",0%,24,7,31,8525000,20,7,27,7425000
453870,Quantum Chess,2025,Deckbuilding,"₩21,500",0%,34,16,50,53750000,29,17,46,49450000
2667750,Hungry Cats 饥饿的猫,2023,Deckbuilding,"₩3,400",0%,0,0,0,0,9,2,11,1870000
535000,EXIT,2016,Deckbuilding,"₩8,900",0%,52,5,57,25365000,34,5,39,17355000
1513310,Blockee - Sliding Puzzle,2021,Deckbuilding,"₩2,300",0%,43,3,46,5290000,41,3,44,5060000
928140,Puzzles for smart: Dogs,2018,Deckbuilding,"₩4,500",0%,10,6,16,3600000,8,3,11,2475000
1593210,Shinobi's Way - a jigsaw chess tale,2021,Deckbuilding,"₩2,300",0%,18,4,22,2530000,13,0,13,1495000
708760,Social Club VR : Casino Nights,2018,Deckbuilding,"₩20,500",0%,39,12,51,52275000,37,11,48,49200000
2263510,The Simulacrum,2023,Deckbuilding,"₩5,600",0%,106,15,121,33880000,98,12,110,30800000
1780290,Let's Puzzle,2021,Deckbuilding,"₩8,900",0%,29,0,29,12905000,19,0,19,8455000
843660,Rogue Agent,2018,Deckbuilding,Free,0%,345,64,409,0,354,73,427,0
778860,Animals Memory: Insect,2018,Deckbuilding,"₩4,500",0%,36,10,46,10350000,35,10,45,10125000
1636550,Laruaville 11 Match 3 Puzzle,2021,Deckbuilding,"₩11,000",0%,12,1,13,7150000,10,1,11,6050000
2395810,富豪派对重制版,2023,Deckbuilding,"₩7,800",0%,795,165,960,374400000,623,110,733,285870000
1196280,Pussy Puzzle,2020,Deckbuilding,"₩5,500",0%,11,0,11,3025000,17,0,17,4675000
577490,Minos Strategos,2017,Deckbuilding,"₩8,500",0%,36,5,41,17425000,25,3,28,11900000
701290,Legendary Mahjong,2017,Deckbuilding,"₩5,600",0%,40,12,52,14560000,27,10,37,10360000
956090,Animals Memory: Horses,2018,Deckbuilding,"₩4,500",0%,24,0,24,5400000,21,0,21,4725000
2809920,Drop Mahjong tiles,2024,Deckbuilding,"₩4,500",0%,24,16,40,9000000,21,16,37,8325000
1489290,Dice and the Tower of the Reanimator: Glorious Princess,2021,Deckbuilding,"₩6,700",0%,30,5,35,11725000,20,5,25,8375000
2858790,DEAD MAN'S HAND: Card Roulette Action,2024,Deckbuilding,"₩5,600",0%,31,0,31,8680000,30,0,30,8400000
1833680,BeatRider,2024,Deckbuilding,"₩13,500",0%,48,16,64,43200000,17,16,33,22275000
1203580,Photo Quiz - Animals,2019,Deckbuilding,"₩2,300",0%,22,4,26,2990000,14,2,16,1840000
527800,War Cube,2016,Deckbuilding,"₩1,100",0%,48,27,75,4125000,38,17,55,3025000
1213670,Solitaire Forever II,2020,Deckbuilding,Free,0%,337,46,383,0,332,50,382,0
1845880,SEARCH ALL - POTIONS,2021,Deckbuilding,"₩3,400",0%,38,5,43,7310000,37,4,41,6970000
1213770,Blastboard,2020,Deckbuilding,"₩2,000",0%,44,2,46,4600000,41,2,43,4300000
2454020,Mimi the Cat - New Friends,2023,Deckbuilding,"₩3,400",0%,24,0,24,4080000,19,0,19,3230000
2003730,The Fantasy World of Mahjong Princess: General Version,2022,Deckbuilding,"₩10,500",0%,8,3,11,5775000,8,3,11,5775000
2331060,Gambit Shifter,2024,Deckbuilding,"₩8,900",0%,57,2,59,26255000,50,1,51,22695000
1704120,IT Startup: Tech Fodder,2024,Deckbuilding,"₩6,600",40%,27,0,27,8910000,26,0,26,8580000
2479220,The Knight's Path,2023,Deckbuilding,"₩1,100",0%,14,0,14,770000,14,0,14,770000
1547620,JezzBall Atomic,2022,Deckbuilding,"₩6,500",0%,15,0,15,4875000,14,1,15,4875000
1437120,Gizmos: Interstellar Voyage,2021,Deckbuilding,"₩5,600",0%,15,0,15,4200000,14,0,14,3920000
2545560,Frontline: World At War,2024,Deckbuilding,"₩11,000",0%,20,5,25,13750000,11,5,16,8800000
2262960,Artur's Pinball,2023,Deckbuilding,"₩1,100",0%,21,6,27,1485000,19,7,26,1430000
1952930,Soul Wargame,2023,Deckbuilding,"₩8,000",0%,111,22,133,53200000,82,22,104,41600000
1680300,Spades,2021,Deckbuilding,"₩3,400",0%,5,6,11,1870000,7,6,13,2210000
2203140,Keep Sheep,2022,Deckbuilding,"₩3,400",0%,12,9,21,3570000,11,9,20,3400000
3023170,Dice Player One: Trailer,2024,Deckbuilding,Free,0%,0,0,0,0,37,1,38,0
2092330,Powerful Courses,2023,Deckbuilding,"₩16,500",0%,50,0,50,41250000,49,0,49,40425000
695830,Captain Backwater,2017,Deckbuilding,Free,0%,28,6,34,0,28,6,34,0
1395540,BOT.vinnik Chess: Winning Patterns,2020,Deckbuilding,"₩1,730",0%,74,8,82,7093000,69,4,73,6314500
1840330,Dummy Falls,2023,Deckbuilding,Free,0%,37,8,45,0,38,10,48,0
1788430,BOT.vinnik Chess: Late USSR Championships,2021,Deckbuilding,"₩1,730",0%,29,3,32,2768000,24,2,26,2249000
2553440,Egyptian Ratslap - Card Game,2023,Deckbuilding,Free,0%,0,0,0,0,8,2,10,0
1542490,Laser Chess (Prologue),2021,Deckbuilding,Free,0%,0,0,0,0,11,3,14,0
1226000,Nations At War Digital Core Game,2020,Deckbuilding,"₩5,500",0%,75,27,102,28050000,73,28,101,27775000
2553440,Egyptian Ratslap - Card Game,2023,Deckbuilding,Free,0%,0,0,0,0,8,2,10,0
2159880,Highway Cross,2022,Deckbuilding,"₩1,100",0%,15,6,21,1155000,12,2,14,770000
1738100,Puzzle Light: Connect,2021,Deckbuilding,"₩1,100",0%,40,3,43,2365000,41,3,44,2420000
548370,Rezrog,2017,Deckbuilding,"₩11,000",0%,148,180,328,180400000,129,164,293,161150000
1543590,Wildshape - Map Editor (free demo),2021,Deckbuilding,Free,0%,70,26,96,0,70,27,97,0
1611420,Sea Horizon,2022,Deckbuilding,"₩18,000",0%,140,35,175,157500000,106,32,138,124200000
773530,Magic Nations - Card Game,2018,Deckbuilding,"₩15,500",0%,83,35,118,91450000,14,0,14,10850000
766630,Dust and Salt,2018,Deckbuilding,"₩4,450",50%,62,12,74,16465000,52,12,64,14240000
758980,Poker Legends: Texas Hold'em Poker Tournaments,2018,Deckbuilding,Free,0%,559,171,730,0,562,178,740,0
709940,Weapon and Armor: Mahjong,2017,Deckbuilding,"₩2,300",0%,7,3,10,1150000,7,3,10,1150000
2316750,Finger Football: Goal in One,2023,Deckbuilding,"₩1,100",0%,20,0,20,1100000,16,0,16,880000
1583140,War Mines: WW2,2021,Deckbuilding,"₩4,500",0%,41,6,47,10575000,36,5,41,9225000
1431950,Decks & Daggers,2021,Deckbuilding,"₩13,500",0%,49,16,65,43875000,36,14,50,33750000
1427700,Realm Engine | Virtual Tabletop,2021,Deckbuilding,Free,0%,35,14,49,0,35,15,50,0
1996710,Sokolor,2022,Deckbuilding,"₩2,300",0%,26,0,26,2990000,25,0,25,2875000
1329320,Seven Doors,2020,Deckbuilding,"₩5,600",0%,64,31,95,26600000,43,22,65,18200000
1035010,Mini Gal4Xy,2019,Deckbuilding,"₩4,500",0%,31,5,36,8100000,26,3,29,6525000
1908850,Quick Words,2022,Deckbuilding,"₩5,500",0%,18,1,19,5225000,16,1,17,4675000
1689510,RPGScenery,2022,Deckbuilding,"₩7,500",0%,14,12,26,9750000,14,12,26,9750000
810360,Masters of Puzzle,2020,Deckbuilding,"₩27,000",0%,24,5,29,39150000,17,5,22,29700000
724640,AuroraBound Deluxe,2017,Deckbuilding,"₩3,400",0%,23,1,24,4080000,19,1,20,3400000
2066030,The Grizzled: Armistice Digital,2022,Deckbuilding,"₩7,500",0%,7,6,13,4875000,7,5,12,4500000
2784260,Desktop Zoo,2024,Deckbuilding,Free,0%,0,0,0,0,9,6,15,0
1341220,BlackJack Math,2020,Deckbuilding,"₩1,100",0%,82,14,96,5280000,60,10,70,3850000
1178500,Crazy Eights 3D Premium,2020,Deckbuilding,"₩10,500",0%,11,2,13,6825000,8,2,10,5250000
1178500,Crazy Eights 3D Premium,2020,Deckbuilding,"₩10,500",0%,11,2,13,6825000,8,2,10,5250000
453770,Forgotten Tales: Day of the Dead,2016,Deckbuilding,"₩11,000",0%,39,17,56,30800000,18,10,28,15400000
2842880,Vox Populi: Europa 2024,2024,Deckbuilding,"₩8,900",0%,31,1,32,14240000,26,0,26,11570000
1600870,King Bullseye: The Chess Strike,2021,Deckbuilding,"₩2,300",0%,24,2,26,2990000,20,2,22,2530000
1034040,"Causa, Voices of the Dusk",2021,Deckbuilding,Free,0%,245,92,337,0,243,95,338,0
2209380,Chess Morph: The Queen's Wormholes,2023,Deckbuilding,"₩2,300",0%,17,0,17,1955000,16,0,16,1840000
3496440,Snowflake Master,2025,Deckbuilding,"₩5,600",0%,11,0,11,3080000,10,0,10,2800000
877780,Puzzles for smart: Cats,2018,Deckbuilding,"₩4,500",0%,20,18,38,8550000,15,11,26,5850000
1579890,Infinite World:Dice Team,2024,Deckbuilding,"₩4,500",0%,27,8,35,7875000,28,9,37,8325000
2099990,graveyard keeper,2022,Deckbuilding,Free,0%,0,0,0,0,11,3,14,0
2742180,ByteBurst: Hacking Simulator,2024,Deckbuilding,"₩2,300",0%,19,2,21,2415000,15,5,20,2300000
1147490,Frontline: Western Front,2019,Deckbuilding,"₩6,700",0%,40,11,51,17085000,34,10,44,14740000
1163740,Card Hog,2023,Deckbuilding,"₩6,700",0%,501,27,528,176880000,425,27,452,151420000
970000,Puzzles for smart: Horses,2018,Deckbuilding,"₩4,500",0%,12,6,18,4050000,7,5,12,2700000
1510730,Auto World Tycoon,2022,Deckbuilding,"₩10,500",0%,4,6,10,5250000,4,6,10,5250000
1509780,Bombagun,2022,Deckbuilding,Free,0%,0,0,0,0,100,35,135,0
932350,Intelligence: Dogs,2018,Deckbuilding,"₩4,500",0%,7,3,10,2250000,7,4,11,2475000
1177690,The Summoning,2019,Deckbuilding,"₩2,200",0%,54,21,75,8250000,53,20,73,8030000
2016540,Chess Pills,2022,Deckbuilding,"₩3,920",0%,35,3,38,7448000,34,4,38,7448000
2192970,All On Board!,2025,Deckbuilding,"₩11,000",0%,10,6,16,8800000,8,7,15,8250000
2271040,Domino Galaxy,2023,Deckbuilding,"₩2,300",0%,17,1,18,2070000,17,1,18,2070000
2027090,LiMiT's Escape Room Games 2,2023,Deckbuilding,"₩13,500",0%,34,3,37,24975000,30,2,32,21600000
2241910,Sweets Pusher Friends,2023,Deckbuilding,"₩4,500",0%,57,26,83,18675000,50,24,74,16650000
2083670,Cats Yakuza - Online card game,2022,Deckbuilding,"₩5,500",0%,25,1,26,7150000,22,1,23,6325000
3636230,Death Game Hotel,2025,Deckbuilding,Free,0%,0,0,0,0,7,5,12,0
1742850,Card Game Simulator,2021,Deckbuilding,Free,0%,0,0,0,0,21,11,32,0
1289490,Dungeon Solver,2020,Deckbuilding,"₩1,100",0%,33,13,46,2530000,26,13,39,2145000
343180,Top Trumps Turbo,2015,Deckbuilding,"₩3,400",0%,70,148,218,37060000,6,4,10,1700000
1267280,Mystic Isles,2021,Deckbuilding,Free,0%,9,5,14,0,9,5,14,0
909830,Color by Number - Pixel Draw,2018,Deckbuilding,"₩2,300",0%,15,8,23,2645000,12,6,18,2070000
2453770,Pop and Chicks,2023,Deckbuilding,"₩2,300",0%,25,1,26,2990000,22,1,23,2645000
266510,Hand of Fate,2015,Deckbuilding,"₩21,000",0%,9433,1126,10559,11086950000,0,0,0,0
2788960,Hidden Cats in Jigsaw Puzzle,2024,Deckbuilding,Free,0%,0,0,0,0,101,6,107,0
2885880,Tokyo Coffee: Grinding in the Pandemic,2024,Deckbuilding,"₩11,000",0%,25,0,25,13750000,22,0,22,12100000
769150,Casino Slot Machines,2017,Deckbuilding,"₩2,300",0%,8,13,21,2415000,8,12,20,2300000
1776540,Lawnmower Game: Pinball,2021,Deckbuilding,"₩1,100",0%,16,6,22,1210000,10,3,13,715000
1547340,Puzzle Car,2021,Deckbuilding,"₩2,300",0%,90,4,94,10810000,81,2,83,9545000
867420,Andor - Wrecking Dawn,2021,Deckbuilding,Free,0%,81,30,111,0,78,32,110,0
701970,Sliding Blocks,2017,Deckbuilding,"₩3,400",0%,19,2,21,3570000,12,2,14,2380000
253510,WARMACHINE: Tactics,2014,Deckbuilding,Free,0%,511,639,1150,0,506,645,1151,0
2020380,Astrocat: Skylar´s Memories,2022,Deckbuilding,"₩1,100",0%,29,0,29,1595000,27,0,27,1485000
1809930,Christmas With My Family - Jigsaw Puzzle,2021,Deckbuilding,"₩2,300",0%,20,0,20,2300000,21,0,21,2415000
2685220,Where Pandas 熊猫在哪里,2023,Deckbuilding,"₩1,100",0%,0,0,0,0,78,4,82,4510000
874460,Achtung! Cthulhu Tactics,2018,Deckbuilding,"₩26,000",0%,163,76,239,310700000,101,45,146,189800000
1014810,Happy Words,2019,Deckbuilding,"₩5,500",0%,62,64,126,34650000,55,62,117,32175000
2535730,Lost Girl In Mirror,2023,Deckbuilding,"₩1,100",0%,9,8,17,935000,7,7,14,770000
595280,Throne of Lies®: Medieval Politics,2017,Deckbuilding,Free,0%,2070,648,2718,0,0,0,0,0
1733030,Knights of the Tiny Table,2021,Deckbuilding,"₩4,400",0%,23,6,29,6380000,15,6,21,4620000
1843050,Rambell,2024,Deckbuilding,Free,0%,0,0,0,0,15,5,20,0
1206110,Frontline: The Great Patriotic War,2019,Deckbuilding,"₩8,900",0%,26,5,31,13795000,22,5,27,12015000
1206110,Frontline: The Great Patriotic War,2019,Deckbuilding,"₩8,900",0%,26,5,31,13795000,22,5,27,12015000
1677580,My Master's A Moron,2022,Deckbuilding,"₩15,500",0%,24,5,29,22475000,16,5,21,16275000
526890,A Day in the Woods,2016,Deckbuilding,"₩5,500",0%,23,1,24,6600000,22,1,23,6325000
1070770,Skat 3D Premium,2019,Deckbuilding,"₩21,500",0%,14,15,29,31175000,13,13,26,27950000
1363740,The Troop,2023,Deckbuilding,"₩42,000",0%,555,93,648,1360800000,558,99,657,1379700000
1094690,Imagination,2020,Deckbuilding,"₩5,600",0%,29,29,58,16240000,8,8,16,4480000
2204710,Green Garden,2022,Deckbuilding,"₩53,000",0%,11,1,12,31800000,11,0,11,29150000
498850,"Ortus Arena, strategy board game online, FOR FREE",2016,Deckbuilding,Free,0%,28,17,45,0,28,18,46,0
820030,Picross Fairytale - nonogram: Red Riding Hood secret,2018,Deckbuilding,"₩5,600",0%,360,111,471,131880000,163,60,223,62440000
2937810,Animal Bomb Chess,2024,Deckbuilding,"₩2,300",0%,14,0,14,1610000,12,0,12,1380000
1178510,Gin Rummy 3D Premium,2020,Deckbuilding,"₩10,500",0%,18,7,25,13125000,15,6,21,11025000
517780,Ogre,2017,Deckbuilding,"₩27,000",0%,166,85,251,338850000,141,70,211,284850000
517720,Epic Tavern,2017,Deckbuilding,"₩27,000",0%,202,136,338,456300000,162,128,290,391500000
468160,Ancient Go,2017,Deckbuilding,"₩5,500",0%,66,36,102,28050000,61,36,97,26675000
909430,Travel Riddles: Mahjong,2018,Deckbuilding,Free,0%,35,34,69,0,38,36,74,0
2534060,Xonix Casual Edition,2023,Deckbuilding,"₩7,800",0%,11,5,16,6240000,10,5,15,5850000
1038100,Trap for Winners,2019,Deckbuilding,"₩4,450",50%,13,3,16,3560000,11,3,14,3115000
1685610,Jigsaw Frame: Relax,2021,Deckbuilding,"₩1,100",0%,15,13,28,1540000,13,7,20,1100000
1707310,Rue,2023,Deckbuilding,Free,0%,0,0,0,0,9,2,11,0
1833670,2048 3D,2021,Deckbuilding,"₩1,100",0%,10,2,12,660000,10,1,11,605000
830750,Poker Simulator,2018,Deckbuilding,"₩5,500",0%,16,12,28,7700000,11,12,23,6325000
862880,Intelligence: Anime girls,2018,Deckbuilding,"₩4,500",0%,19,13,32,7200000,12,9,21,4725000
755950,Fantasy Quest Solitaire,2018,Deckbuilding,"₩9,500",0%,99,17,116,55100000,77,16,93,44175000
2179260,Simple Snooker,2023,Deckbuilding,"₩2,300",0%,5,6,11,1265000,5,7,12,1380000
1520250,Gnome Jigsaw Puzzles,2021,Deckbuilding,"₩2,300",0%,110,4,114,13110000,60,0,60,6900000
707610,Food Mahjong,2017,Deckbuilding,"₩2,300",0%,10,5,15,1725000,7,5,12,1380000
959200,Battleships and Carriers - WW2 Battleship Game,2018,Deckbuilding,"₩14,500",0%,13,10,23,16675000,12,10,22,15950000
436140,Empire of the Gods,2016,Deckbuilding,"₩3,400",0%,59,22,81,13770000,38,11,49,8330000
699680,Monopolka,2020,Deckbuilding,"₩1,100",0%,22,15,37,2035000,18,12,30,1650000
3105100,SCP: CARDTAINMENT BREACH,2025,Deckbuilding,Free,0%,0,0,0,0,23,2,25,0
1520270,Kyvir: Rebirth,2021,Deckbuilding,"₩8,500",0%,327,85,412,175100000,274,82,356,151300000
528450,Hunt: The Unknown Quarry,2017,Deckbuilding,Free,0%,36,15,51,0,36,16,52,0
1298740,Hopebringers,2020,Deckbuilding,Free,0%,38,5,43,0,39,5,44,0
1882950,CycloHex,2022,Deckbuilding,Free,0%,0,0,0,0,8,4,12,0
623170,Zombie Solitaire 2 Chapter 2,2017,Deckbuilding,"₩9,500",0%,59,9,68,32300000,47,8,55,26125000
1131590,Aegis Online,2020,Deckbuilding,Free,0%,11,8,19,0,11,8,19,0
2067490,Competitive Checkers,2023,Deckbuilding,Free,0%,0,0,0,0,20,19,39,0
1550680,Feudalia,2021,Deckbuilding,"₩12,500",0%,12,3,15,9375000,9,2,11,6875000
707850,Jigsaw Puzzles,2017,Deckbuilding,"₩2,300",0%,7,4,11,1265000,6,4,10,1150000
2471480,Vox Populi: Spain 2023,2023,Deckbuilding,"₩5,600",0%,26,4,30,8400000,23,4,27,7560000
2367190,Looks Good,2023,Deckbuilding,"₩6,700",0%,49,35,84,28140000,38,36,74,24790000
2402100,Cube Airport - Puzzle,2023,Deckbuilding,"₩1,020",70%,20,0,20,1020000,18,0,18,918000
1217550,Guardians of Greyrock,2021,Deckbuilding,Free,0%,14,13,27,0,15,13,28,0
463160,Super Dungeon Tactics,2016,Deckbuilding,"₩10,500",0%,116,32,148,77700000,86,26,112,58800000
1126880,Pixel Puzzles 4k: Japan,2020,Deckbuilding,"₩5,600",0%,8,5,13,3640000,8,5,13,3640000
1516550,Vectors,2021,Deckbuilding,"₩2,300",0%,22,0,22,2530000,21,0,21,2415000
1425550,Who is the Liar?,2021,Deckbuilding,"₩2,700",0%,30,13,43,5805000,27,13,40,5400000
1249510,Hnefatafl,2020,Deckbuilding,"₩10,500",0%,49,0,49,25725000,44,0,44,23100000
1903720,With Good Intentions,2022,Deckbuilding,"₩5,600",0%,19,12,31,8680000,15,9,24,6720000
1780380,Golf Solitaire Simple,2021,Deckbuilding,Free,0%,0,0,0,0,13,3,16,0
1780380,Golf Solitaire Simple,2021,Deckbuilding,Free,0%,0,0,0,0,13,3,16,0
3420700,Pioneers of the Unknown,2025,Deckbuilding,"₩3,630",34%,7,1,8,1452000,9,7,16,2904000
349550,Mighty Dungeons,2015,Deckbuilding,"₩5,500",0%,53,35,88,24200000,44,28,72,19800000
1422780,Gizmos: Spooky Adventures,2020,Deckbuilding,"₩5,600",0%,14,1,15,4200000,11,1,12,3360000
1907420,SEARCH ALL - MUSHROOMS,2022,Deckbuilding,"₩3,400",0%,42,8,50,8500000,38,7,45,7650000
1919350,Coral Cove,2023,Deckbuilding,Free,0%,0,0,0,0,129,10,139,0
814990,Super X Chess,2018,Deckbuilding,"₩6,520",55%,9,5,14,4564000,7,3,10,3260000
2410640,SHARK! SHARK!,2023,Deckbuilding,"₩16,500",0%,9,4,13,10725000,8,4,12,9900000
1105530,Light Hunters: Battalion of Darkness,2019,Deckbuilding,Free,0%,7,6,13,0,7,6,13,0
2560120,Roles & Dice,2024,Deckbuilding,Free,0%,21,4,25,0,20,4,24,0
1522710,LX Patterns,2021,Deckbuilding,₩710,35%,22,4,26,923000,18,5,23,816500
3160500,Kingdom of Cards,2025,Deckbuilding,"₩13,500",0%,63,14,77,51975000,40,14,54,36450000
2825510,Polyoshapes,2024,Deckbuilding,"₩3,900",0%,14,2,16,3120000,14,2,16,3120000
3374340,OPA: Super Janken,2025,Deckbuilding,Free,0%,0,0,0,0,6,5,11,0
1264220,Card Blitz: WWII,2020,Deckbuilding,Free,0%,50,37,87,0,50,37,87,0
575340,Chessaria: The Tactical Adventure (Chess),2018,Deckbuilding,"₩20,500",0%,93,32,125,128125000,73,25,98,100450000
1580570,Blokker,2021,Deckbuilding,"₩2,200",0%,55,3,58,6380000,54,3,57,6270000
2054100,Chess VR: Multiverse Journey,2022,Deckbuilding,"₩18,000",0%,7,9,16,14400000,6,8,14,12600000
740240,Snake Eyes Dungeon,2017,Deckbuilding,"₩5,600",0%,43,38,81,22680000,18,11,29,8120000
1558650,Alphadeck,2021,Deckbuilding,Free,0%,14,14,28,0,14,14,28,0
528250,Patchwork,2016,Deckbuilding,"₩7,800",0%,197,63,260,101400000,103,27,130,50700000
2818390,The Secret Weapon,2024,Deckbuilding,Free,0%,0,0,0,0,7,4,11,0
1599690,WORDLAND,2021,Deckbuilding,"₩2,300",0%,31,1,32,3680000,30,1,31,3565000
1733610,Alpine - The Simulation Game,2021,Deckbuilding,"₩21,500",0%,25,20,45,48375000,15,16,31,33325000
1554660,Cat way Domino,2021,Deckbuilding,"₩1,100",0%,46,3,49,2695000,43,3,46,2530000
1554660,Cat way Domino,2021,Deckbuilding,"₩1,100",0%,46,3,49,2695000,43,3,46,2530000
1969130,Trash Patrol - Academic Version,2022,Deckbuilding,Free,0%,0,0,0,0,141,61,202,0
676450,Double Memory,2017,Deckbuilding,"₩2,300",0%,22,8,30,3450000,22,8,30,3450000
2124660,Fix My Cat Doc,2022,Deckbuilding,"₩210,000",0%,23,6,29,304500000,11,2,13,136500000
1711190,BOT.vinnik Chess: Early USSR Championships,2021,Deckbuilding,"₩1,730",0%,31,2,33,2854500,29,1,30,2595000
1652650,WORDLAND 3,2021,Deckbuilding,"₩2,300",0%,14,1,15,1725000,14,1,15,1725000
528180,Agricola: All Creatures Big and Small,2017,Deckbuilding,"₩7,800",0%,49,74,123,47970000,32,33,65,25350000
2457780,Fi-Knight Kingdom,2023,Deckbuilding,Free,0%,12,2,14,0,12,2,14,0
1861120,Line Time,2024,Deckbuilding,"₩6,300",0%,30,0,30,9450000,12,0,12,3780000
1802860,大富翁少女/Rich Girls,2022,Deckbuilding,"₩3,300",0%,255,94,349,57585000,235,92,327,53955000
1947660,LiMiT's Escape Room Games,2022,Deckbuilding,"₩4,500",0%,85,39,124,27900000,65,34,99,22275000
1373600,Day of the Dead: Solitaire Collection,2020,Deckbuilding,"₩11,000",0%,16,3,19,10450000,16,3,19,10450000
1611650,Acheron's Souls,2021,Deckbuilding,Free,0%,10,1,11,0,10,1,11,0
1397540,On Pixels: A lights out game,2020,Deckbuilding,"₩2,200",0%,16,0,16,1760000,15,0,15,1650000
1558020,Lazy Chess,2021,Deckbuilding,"₩3,300",0%,5,5,10,1650000,5,5,10,1650000
3504140,Screw Puzzle Master,2025,Deckbuilding,"₩2,300",0%,5,2,7,805000,5,5,10,1150000
1612200,Blokker: Orange,2021,Deckbuilding,"₩2,200",0%,30,1,31,3410000,30,1,31,3410000
1193460,Bunny Sudoku,2019,Deckbuilding,"₩3,300",0%,12,4,16,2640000,9,4,13,2145000
1158290,Mini Words - minimalist puzzle,2019,Deckbuilding,"₩2,300",0%,159,11,170,19550000,142,8,150,17250000
294370,Crowntakers,2014,Deckbuilding,"₩11,000",0%,486,175,661,363550000,288,96,384,211200000
1867610,SokoWinter,2022,Deckbuilding,"₩1,100",0%,48,2,50,2750000,46,1,47,2585000
3158990,The Chess,2025,Deckbuilding,Free,0%,0,0,0,0,30,8,38,0
1259460,Trendpoker 3D: Free Online Poker,2020,Deckbuilding,Free,0%,97,37,134,0,96,39,135,0
2093590,Moorhuhn X - Crazy Chicken X,2022,Deckbuilding,"₩5,600",0%,43,0,43,12040000,44,0,44,12320000
1193560,Roast Party,2020,Deckbuilding,Free,0%,22,5,27,0,21,5,26,0
1575580,The Royal Game of Ur 3D,2022,Deckbuilding,"₩8,900",0%,23,1,24,10680000,20,1,21,9345000
2921150,Escape Tales: The Awakening,2024,Deckbuilding,"₩8,900",0%,22,1,23,10235000,16,1,17,7565000
1211490,Math Path,2020,Deckbuilding,"₩1,100",0%,10,3,13,715000,8,5,13,715000
2023070,Mine Seeker,2022,Deckbuilding,Free,0%,13,4,17,0,13,4,17,0
1568190,Cat's Life Jigsaw Puzzles,2021,Deckbuilding,"₩3,400",0%,22,0,22,3740000,15,0,15,2550000
1640760,WORDLAND 2,2021,Deckbuilding,"₩2,300",0%,21,1,22,2530000,20,1,21,2415000
787710,Comrades and Barons: Solitaire of Bloody 1919,2018,Deckbuilding,"₩11,000",0%,44,4,48,26400000,39,4,43,23650000
1131140,The MoneyMakers Rallye,2020,Deckbuilding,"₩3,370",25%,89,11,100,16850000,69,9,78,13143000
2071390,Chess: The Lost Pieces,2023,Deckbuilding,"₩8,900",0%,14,6,20,8900000,12,6,18,8010000
1067110,Idle Chess Story,2019,Deckbuilding,Free,0%,29,27,56,0,29,27,56,0
1178520,Hearts 3D Premium,2024,Deckbuilding,"₩5,600",0%,10,4,14,3920000,8,4,12,3360000
3338320,Snackdown,2025,Deckbuilding,Free,0%,0,0,0,0,10,6,16,0
1384890,Flag Collection,2020,Deckbuilding,"₩1,100",0%,77,32,109,5995000,74,32,106,5830000
1354520,Wild Honesty: A party game for deeper conversations,2020,Deckbuilding,"₩20,500",0%,18,5,23,23575000,19,5,24,24600000
1219080,Dice Tactics,2021,Deckbuilding,Free,0%,9,4,13,0,9,4,13,0
1887050,Nachkriegsratten Punk-Rock Puzzle,2022,Deckbuilding,"₩5,600",0%,39,0,39,10920000,16,0,16,4480000
881930,Business Tycoon Billionaire,2018,Deckbuilding,"₩2,300",0%,6,10,16,1840000,6,8,14,1610000
2787580,Cat Billiards,2024,Deckbuilding,"₩1,100",0%,13,0,13,715000,11,0,11,605000
3551650,Waste Time Lotto,2025,Deckbuilding,Free,0%,0,0,0,0,8,7,15,0
1963900,Knotwords,2022,Deckbuilding,"₩12,500",0%,49,6,55,34375000,47,5,52,32500000
2660750,Teku,2023,Deckbuilding,Free,0%,0,0,0,0,32,2,34,0
1189650,Post Scriptum CTG: Collectible Token Game,2020,Deckbuilding,Free,0%,10,3,13,0,10,3,13,0
3783540,Voden's Job,2025,Deckbuilding,Free,0%,0,0,0,0,7,3,10,0
1788410,BOT.vinnik Chess: Mid-Century USSR Championships,2021,Deckbuilding,"₩1,730",0%,33,2,35,3027500,31,1,32,2768000
722670,Chinese Chess,2017,Deckbuilding,"₩10,500",0%,165,56,221,116025000,124,41,165,86625000
2465490,Nine Realms: Revolt,2023,Deckbuilding,"₩7,800",0%,17,7,24,9360000,5,7,12,4680000
2007180,CandySweet,2022,Deckbuilding,"₩20,500",0%,12,9,21,21525000,11,3,14,14350000
1683820,Board Game Engine,2022,Deckbuilding,Free,0%,0,0,0,0,4,8,12,0
3474190,Sudoku,2025,Deckbuilding,"₩5,600",0%,1,2,3,840000,0,0,0,0
1107720,Spider Solitaire F,2019,Deckbuilding,"₩5,500",0%,7,11,18,4950000,7,11,18,4950000
1455130,Number One Rich,2020,Deckbuilding,"₩6,700",0%,7,12,19,6365000,7,11,18,6030000
3506970,Chess Hunt,2025,Deckbuilding,"₩3,400",0%,0,0,0,0,0,0,0,0
2240720,NONOTOWN: Nonogram Logic Puzzle,2023,Deckbuilding,"₩5,900",0%,6,1,7,2065000,0,0,0,0
2974650,Solitar: Retro Picks,2024,Deckbuilding,"₩8,900",0%,8,0,8,3560000,0,0,0,0
3274940,Liar's Dice,2024,Deckbuilding,"₩3,400",0%,1,1,2,340000,0,0,0,0
1102490,The Tree,2020,Deckbuilding,"₩8,500",0%,3,6,9,3825000,0,0,0,0
525330,Galaxy of Trian Board Game,2016,Deckbuilding,"₩5,500",0%,5,4,9,2475000,0,0,0,0
1337840,Klondike Solitaire Collection,2022,Deckbuilding,"₩8,900",0%,5,1,6,2670000,0,0,0,0
3885750,Sudoku-X,2025,Deckbuilding,"₩1,100",0%,0,0,0,0,0,0,0,0
2285860,Engineering - Mystery of the ancient clock,2023,Deckbuilding,"₩9,900",0%,6,2,8,3960000,0,0,0,0
1279620,Gem Master,2020,Deckbuilding,"₩5,500",0%,14,2,16,4400000,0,0,0,0
3098580,CASE,2024,Deckbuilding,"₩4,500",0%,6,0,6,1350000,0,0,0,0
2095350,NONOGRAM - KAWAII CUTIES,2022,Deckbuilding,"₩2,300",0%,7,1,8,920000,0,0,0,0
689270,Chessia,2018,Deckbuilding,"₩8,500",0%,2,4,6,2550000,0,0,0,0
680850,Sixteen,2021,Deckbuilding,"₩2,300",0%,1,0,1,115000,0,0,0,0
2417650,Carrom Slam!,2023,Deckbuilding,"₩6,700",0%,0,0,0,0,0,0,0,0
2972300,Beauty Jigsaw,2024,Deckbuilding,"₩1,100",0%,7,1,8,440000,0,0,0,0
516010,Board Defenders,2016,Deckbuilding,"₩5,500",0%,18,1,19,5225000,0,0,0,0
874780,Brick Breaker Premium,2018,Deckbuilding,"₩1,100",0%,3,5,8,440000,0,0,0,0
874780,Brick Breaker Premium,2018,Deckbuilding,"₩1,100",0%,3,5,8,440000,0,0,0,0
2872780,OG Puzzlers: Synthwave Knights,2024,Deckbuilding,"₩1,100",0%,0,0,0,0,0,0,0,0
2884270,OG Puzzlers: Synthwave Dragons,2024,Deckbuilding,"₩1,100",0%,0,0,0,0,0,0,0,0
2882580,OG Puzzlers: Synthwave Astronauts,2024,Deckbuilding,"₩1,100",0%,0,0,0,0,0,0,0,0
1532750,Jigsaw Pieces 2 - Shades of Mood,2021,Deckbuilding,"₩4,200",60%,7,0,7,1470000,0,0,0,0
1889050,Legends And Lore,2022,Deckbuilding,"₩26,000",0%,1,3,4,5200000,0,0,0,0
2884280,OG Puzzlers: Synthwave Cats,2024,Deckbuilding,"₩1,100",0%,1,0,1,55000,0,0,0,0
1462830,Super Sketchy Party,2023,Deckbuilding,"₩11,000",0%,2,2,4,2200000,0,0,0,0
2504210,The Leverage Game Business Edition,2023,Deckbuilding,"₩1,278,400",0%,0,0,0,0,0,0,0,0
2806780,Virtual Jigsaw Puzzles - Animals,2024,Deckbuilding,"₩1,100",0%,1,1,2,110000,0,0,0,0
1549950,Domino killer,2021,Deckbuilding,"₩6,700",0%,1,4,5,1675000,0,0,0,0
1487990,Relax Memory Game,2020,Deckbuilding,"₩5,500",0%,3,5,8,2200000,0,0,0,0
3351760,Chromapix,2024,Deckbuilding,"₩2,300",0%,2,1,3,345000,0,0,0,0
2673380,OG Puzzlers: Synthwave Boats,2024,Deckbuilding,"₩1,100",0%,0,1,1,55000,0,0,0,0
1139870,The Dark Eye : Book of Heroes,2020,Deckbuilding,"₩11,000",0%,83,127,210,115500000,73,118,191,105050000
1793780,Poly Memory: Furries 2,2021,Deckbuilding,"₩2,300",0%,1,0,1,115000,0,0,0,0
2882590,OG Puzzlers: Synthwave Dinosaurs,2024,Deckbuilding,"₩1,100",0%,1,0,1,55000,0,0,0,0
3783500,Hot Stakes Casino - American Roulette,2025,Deckbuilding,Unknown,0%,0,0,0,0,0,0,0,0
1749210,Tile Connect - Onet Match,2021,Deckbuilding,"₩2,300",0%,1,0,1,115000,0,0,0,0
3753530,Sort Hexa Tiles,2025,Deckbuilding,"₩3,920",30%,0,0,0,0,0,0,0,0
2334620,Poly Jigsaw: Birds,2023,Deckbuilding,"₩2,300",0%,0,0,0,0,0,0,0,0
2196300,GrassGames Hearts 3,2022,Deckbuilding,Free,0%,0,0,0,0,0,0,0,0
2802080,Prime,2024,Deckbuilding,"₩1,100",0%,0,0,0,0,0,0,0,0
3589480,あみだくじ ~Amidakuji~,2025,Deckbuilding,"₩5,600",0%,0,0,0,0,0,0,0,0
2101360,Crossroad of Worlds: 100 Doors Collector's Edition,2022,Deckbuilding,"₩8,900",0%,1,3,4,1780000,0,0,0,0
3201940,Paper Puzzle,2024,Deckbuilding,"₩2,300",0%,0,0,0,0,0,0,0,0
3505280,Fluffy's House,2025,Deckbuilding,"₩4,500",0%,0,0,0,0,0,0,0,0
2587050,在线乞讨,2023,Deckbuilding,"₩1,100",0%,1,0,1,55000,0,0,0,0
1711930,Between Two Cities - Stonemaier Games,2021,Deckbuilding,"₩3,300",0%,0,1,1,165000,0,0,0,0
3238650,OG Memory: Synthwave Vampires,2024,Deckbuilding,"₩1,100",0%,0,0,0,0,0,0,0,0
2473240,Dungeon Evolution: Nemesis,2023,Deckbuilding,"₩11,000",0%,1,3,4,2200000,0,0,0,0
2773430,Sip'it,2025,Deckbuilding,"₩5,600",0%,0,0,0,0,0,0,0,0
3812980,Get a cat,2025,Deckbuilding,"₩1,100",0%,0,0,0,0,0,0,0,0
3475490,Sinoda,2025,Deckbuilding,"₩13,500",0%,0,0,0,0,0,0,0,0
3841140,Sudoku online with friends,2025,Deckbuilding,Unknown,0%,0,0,0,0,0,0,0,0
3780890,Baazi,2025,Deckbuilding,"₩5,600",0%,0,0,0,0,0,0,0,0
2204720,Sunny Memories,2022,Deckbuilding,"₩2,300",0%,5,5,10,1150000,0,0,0,0
2499620,The Leverage Game,2023,Deckbuilding,"₩1,278,400",0%,1,0,1,63920000,0,0,0,0
1931890,Trivia Party,2022,Deckbuilding,"₩11,000",0%,7,2,9,4950000,0,0,0,0
3358300,Mahjong Tiles,2024,Deckbuilding,"₩5,600",0%,0,0,0,0,0,0,0,0
2881860,TaleSpire - Guest Edition,2024,Deckbuilding,Free,0%,0,0,0,0,8,9,17,0
3474230,Blocks,2025,Deckbuilding,"₩5,600",0%,0,0,0,0,0,0,0,0
2385850,JACKPOT,2023,Deckbuilding,"₩5,600",0%,1,1,2,560000,0,0,0,0
2452370,A Shadow Cast on Water,2023,Deckbuilding,"₩4,500",0%,1,0,1,225000,0,0,0,0
1476950,Planetary Control!,2021,Deckbuilding,"₩5,500",0%,7,2,9,2475000,0,0,0,0
2855450,OG Memory: Synthwave Boats,2024,Deckbuilding,"₩1,100",0%,0,0,0,0,0,0,0,0
3535110,HEXA-WORLD-3D,2025,Deckbuilding,"₩7,800",0%,0,0,0,0,0,0,0,0
3381760,Plant poker,2025,Deckbuilding,"₩2,300",0%,0,0,0,0,0,0,0,0
3323000,Mahjong,2024,Deckbuilding,"₩5,600",0%,2,1,3,840000,0,0,0,0
2789910,Culture Warz: Chess,2024,Deckbuilding,"₩2,300",0%,0,0,0,0,0,0,0,0
2323690,Jigsaw Puzzles: Fantasy Landscapes,2023,Deckbuilding,"₩1,100",0%,0,0,0,0,0,0,0,0
1467380,Ancient Warriors Casino Jackpot,2020,Deckbuilding,"₩2,300",0%,1,3,4,460000,0,0,0,0
3473780,Multiple Territory War,2025,Deckbuilding,"₩5,600",0%,1,0,1,280000,0,0,0,0
1780530,Cyber Sweep,2022,Deckbuilding,"₩2,300",0%,0,0,0,0,0,0,0,0
1795370,UZO,2022,Deckbuilding,"₩1,100",0%,0,0,0,0,0,0,0,0
2972260,Ghosts,2024,Deckbuilding,"₩3,400",0%,0,0,0,0,0,0,0,0
2537290,Fantasy Adventure Builder,2024,Deckbuilding,"₩14,500",0%,0,3,3,2175000,0,0,0,0
3233960,Aleator,2025,Deckbuilding,"₩5,600",0%,6,0,6,1680000,0,0,0,0
3648550,Your Magic Hook,2025,Deckbuilding,"₩3,400",0%,0,0,0,0,0,0,0,0
2855830,Reversi Temple,2024,Deckbuilding,"₩1,360",60%,2,0,2,136000,0,0,0,0
1608860,XANDO: Xtreme & Over the Top,2021,Deckbuilding,"₩4,400",0%,4,1,5,1100000,0,0,0,0
2292690,Efemeris - DTDA Games,2023,Deckbuilding,"₩3,400",0%,0,1,1,170000,0,0,0,0
3373990,Sprout's Words,2024,Deckbuilding,"₩9,660",0%,1,0,1,483000,0,0,0,0
2758110,Dice & Sword,2025,Deckbuilding,"₩7,920",19%,3,0,3,1188000,0,0,0,0
2532360,Point Salad - The Board Game,2024,Deckbuilding,"₩9,900",0%,6,2,8,3960000,0,0,0,0
3753470,Sort Tiles,2025,Deckbuilding,"₩3,920",30%,0,0,0,0,0,0,0,0
1498400,Jigsaw Puzzle - Pixel Art Master,2020,Deckbuilding,"₩2,300",0%,1,0,1,115000,0,0,0,0
704370,Water Pipeline,2017,Deckbuilding,"₩2,300",0%,5,4,9,1035000,0,0,0,0
2759530,Virtual Jigsaw Puzzles,2024,Deckbuilding,"₩1,100",0%,5,1,6,330000,0,0,0,0
666170,Space Betrayers,2022,Deckbuilding,"₩26,000",0%,1,0,1,1300000,0,0,0,0
887880,O.C.D. - On Completeness & Dissonance,2018,Deckbuilding,"₩1,100",0%,7,3,10,550000,0,0,0,0
1855420,Tabletop Warriors,2023,Deckbuilding,"₩16,500",0%,2,3,5,4125000,0,0,0,0
2403450,Gaslamp Cases 5 - The dreadful City,2023,Deckbuilding,"₩8,900",0%,5,0,5,2225000,0,0,0,0
3642530,桌面猫猫钓鱼,2025,Deckbuilding,"₩3,400",0%,5,0,5,850000,0,0,0,0
2867250,Matsutake Game,2024,Deckbuilding,"₩3,700",0%,5,0,5,925000,0,0,0,0
2897010,Deck Remover,2024,Deckbuilding,"₩1,100",0%,0,0,0,0,0,0,0,0
2928750,Shout Seven,2024,Deckbuilding,"₩2,300",0%,5,0,5,575000,0,0,0,0
1747800,Legendary Mahjong 2,2021,Deckbuilding,"₩11,000",0%,10,0,10,5500000,0,0,0,0
2314580,Jigsaw Puzzle Fever,2023,Deckbuilding,"₩8,900",0%,7,3,10,4450000,0,0,0,0
2250110,Blue Sky,2023,Deckbuilding,"₩2,300",0%,6,7,13,1495000,0,0,0,0
2188660,NONOGRAM - KAWAII CUTIES 2nd,2022,Deckbuilding,"₩2,300",0%,4,1,5,575000,0,0,0,0
1691860,Vizzle,2021,Deckbuilding,"₩2,300",0%,8,0,8,920000,0,0,0,0
1969570,Shenanigans,2023,Deckbuilding,"₩3,400",0%,3,0,3,510000,0,0,0,0
3035440,Cute Dogs Slide,2024,Deckbuilding,"₩1,100",0%,0,0,0,0,0,0,0,0
1929770,Xpraize Beta,2022,Deckbuilding,"₩15,500",0%,1,0,1,775000,0,0,0,0
3541650,Gambling Forever,2025,Deckbuilding,Free,0%,0,0,0,0,0,0,0,0
1818080,Hidden Beast,2022,Deckbuilding,"₩2,200",0%,0,0,0,0,0,0,0,0
1930130,Solitaire Beach Season 3,2022,Deckbuilding,"₩3,400",0%,1,3,4,680000,0,0,0,0
2665660,Jigsaw Together,2023,Deckbuilding,"₩1,100",0%,2,1,3,165000,0,0,0,0
1283070,3D Jigsaw Puzzle Simulator,2020,Deckbuilding,"₩5,500",0%,10,0,10,2750000,0,0,0,0
1481660,Sun Girls,2020,Deckbuilding,"₩1,100",0%,5,0,5,275000,0,0,0,0
2655930,Solitary Cat,2023,Deckbuilding,"₩3,400",0%,3,0,3,510000,0,0,0,0
1911010,Voxel Digger,2022,Deckbuilding,"₩4,400",0%,2,1,3,660000,0,0,0,0
3615710,HAKO,2025,Deckbuilding,"₩1,100",0%,0,0,0,0,0,0,0,0
730690,EXIT 4 - Portal,2018,Deckbuilding,"₩8,900",0%,6,1,7,3115000,0,0,0,0
3394850,Jigsaw USA,2025,Deckbuilding,"₩5,600",0%,5,0,5,1400000,0,0,0,0
3646430,BoxIsland: Sokoban,2025,Deckbuilding,"₩2,240",60%,2,0,2,224000,0,0,0,0
3219170,Severed Decks,2024,Deckbuilding,"₩2,300",0%,2,1,3,345000,0,0,0,0
2250100,Red Flower,2023,Deckbuilding,"₩2,300",0%,3,5,8,920000,0,0,0,0
3157750,Casino Manager Simulator,2024,Deckbuilding,"₩1,100",0%,3,4,7,385000,0,0,0,0
2479610,Take the King!,2023,Deckbuilding,"₩7,800",0%,7,1,8,3120000,0,0,0,0
730670,EXIT 3 - Painter,2017,Deckbuilding,"₩8,900",0%,3,1,4,1780000,0,0,0,0
2715180,Summon My Girl,2023,Deckbuilding,"₩1,100",0%,2,1,3,165000,0,0,0,0
3523990,Sitting,2025,Deckbuilding,"₩7,350",0%,1,1,2,735000,0,0,0,0
2122960,Cyber Attack VR board game,2022,Deckbuilding,Free,0%,6,3,9,0,0,0,0,0
3523990,Sitting,2025,Deckbuilding,"₩7,350",0%,1,1,2,735000,0,0,0,0
2810270,My Rusty Submarine - New Waters,2025,Deckbuilding,"₩2,300",0%,0,0,0,0,0,0,0,0
3136270,Alaska Solitaire Classic Card Game,2024,Deckbuilding,Free,0%,0,0,0,0,0,0,0,0
728110,Board Games VR,2020,Deckbuilding,"₩20,500",0%,8,2,10,10250000,0,0,0,0
1281180,Jigsaw Puzzles for Kids and Adults - Europe,2020,Deckbuilding,"₩3,400",0%,3,0,3,510000,0,0,0,0
2792900,Roguelike Chess,2024,Deckbuilding,"₩2,300",0%,2,0,2,230000,0,0,0,0
1433830,Peg Adventure - Solo Noble,2020,Deckbuilding,"₩1,100",0%,11,1,12,660000,0,0,0,0
2706310,Paper Hero Manager,2023,Deckbuilding,"₩5,600",0%,0,0,0,0,0,0,0,0
2104850,Moving Jigsaw Puzzles,2022,Deckbuilding,"₩2,300",0%,6,0,6,690000,0,0,0,0
1911050,Reversilly,2022,Deckbuilding,"₩3,400",0%,4,0,4,680000,0,0,0,0
2091810,Logic Circuit: Marble Puzzle,2022,Deckbuilding,"₩6,500",0%,3,0,3,975000,0,0,0,0
3053910,Mytho Duel,2024,Deckbuilding,"₩1,100",0%,2,0,2,110000,0,0,0,0
2750490,9000 Years Ago,2024,Deckbuilding,"₩7,800",0%,0,0,0,0,0,0,0,0
3425120,Drop 4,2025,Deckbuilding,"₩2,300",0%,7,0,7,805000,0,0,0,0
1428040,Gizmos: Spirit Of The Christmas,2020,Deckbuilding,"₩5,600",0%,8,0,8,2240000,0,0,0,0
2393100,GoKaDu,2025,Deckbuilding,Unknown,0%,0,0,0,0,0,0,0,0
1342770,逃出囚笼 Rush Out Of The Room,2020,Deckbuilding,"₩2,200",0%,0,0,0,0,0,0,0,0
2314980,Fishjong 2,2023,Deckbuilding,"₩9,900",0%,8,1,9,4455000,0,0,0,0
3442720,Tilebound,2025,Deckbuilding,"₩3,400",0%,0,0,0,0,0,0,0,0
2123430,BULLCRAP!,2023,Deckbuilding,"₩6,700",0%,4,0,4,1340000,0,0,0,0
3201990,Creatures and Creations,2025,Deckbuilding,"₩5,600",0%,0,1,1,280000,0,0,0,0
1298180,Pair Matching Puzzle Connect,2020,Deckbuilding,"₩2,300",0%,3,2,5,575000,0,0,0,0
1619720,Patchwork Image,2021,Deckbuilding,"₩1,100",0%,0,0,0,0,0,0,0,0
873710,Paris: Jigsaw Puzzles,2018,Deckbuilding,"₩2,300",0%,6,3,9,1035000,0,0,0,0
2832430,Flag & Country,2024,Deckbuilding,₩990,9%,5,1,6,297000,0,0,0,0
1589670,Bullfrogs,2021,Deckbuilding,"₩10,500",0%,4,0,4,2100000,0,0,0,0
2299520,Japanese Style Tien Gow,2023,Deckbuilding,"₩8,900",0%,6,0,6,2670000,0,0,0,0
856670,Present for Manager,2019,Deckbuilding,"₩4,400",0%,14,0,14,3080000,0,0,0,0
1751700,Dungeon Arsenal,2021,Deckbuilding,"₩4,500",0%,7,0,7,1575000,0,0,0,0
2991150,Project Kinesis,2024,Deckbuilding,"₩2,300",0%,1,0,1,115000,0,0,0,0
3229300,Be touch-and-go,2024,Deckbuilding,"₩2,300",0%,0,1,1,115000,0,0,0,0
3747050,Silver,2025,Deckbuilding,"₩16,500",0%,0,0,0,0,0,0,0,0
1342270,Nofrills Solitaire,2020,Deckbuilding,"₩2,300",0%,11,0,11,1265000,0,0,0,0
3002340,Sunset Solitaire,2024,Deckbuilding,"₩5,600",0%,8,0,8,2240000,0,0,0,0
2430290,Neon Fantasy: Furries,2023,Deckbuilding,₩640,72%,0,0,0,0,0,0,0,0
3553920,Snap Flex,2025,Deckbuilding,"₩3,400",0%,0,0,0,0,0,0,0,0
1554510,Zenbones,2021,Deckbuilding,"₩15,500",0%,1,0,1,775000,0,0,0,0
2862560,Kingmaker,2024,Deckbuilding,"₩3,400",0%,1,0,1,170000,0,0,0,0
3646640,Legend Of The Platforms,2025,Deckbuilding,Free,0%,0,0,0,0,0,0,0,0
2329790,Steal It,2025,Deckbuilding,"₩6,700",0%,0,0,0,0,0,0,0,0
2329790,Steal It,2025,Deckbuilding,"₩6,700",0%,0,0,0,0,0,0,0,0
1430820,Monstermonger,2020,Deckbuilding,"₩9,900",0%,4,0,4,1980000,0,0,0,0
2297160,Lightballs,2023,Deckbuilding,"₩1,100",0%,0,2,2,110000,0,0,0,0
3553970,Dungeon Story,2025,Deckbuilding,"₩2,300",0%,4,1,5,575000,0,0,0,0
1109660,Age of Fear 5: The Day of the Rat,2024,Deckbuilding,"₩32,000",0%,10,1,11,17600000,0,0,0,0
1467200,Soliterix,2020,Deckbuilding,"₩1,100",0%,3,2,5,275000,0,0,0,0
1416700,Grimm Shuffle,2020,Deckbuilding,"₩1,100",0%,0,0,0,0,0,0,0,0
2899160,AI Fantasy,2024,Deckbuilding,"₩5,600",0%,2,4,6,1680000,0,0,0,0
2617110,无限板块 Infinity Blocks,2024,Deckbuilding,"₩1,100",0%,2,0,2,110000,0,0,0,0
1665570,Brickbuilder VR,2021,Deckbuilding,"₩26,000",0%,7,2,9,11700000,0,0,0,0
2700070,Behind the Beyond: Ulti,2024,Deckbuilding,"₩5,600",0%,4,3,7,1960000,0,0,0,0
1539270,Yōso Warriors,2021,Deckbuilding,"₩2,200",0%,0,0,0,0,0,0,0,0
1153730,SteamCity Chronicles - Rise Of The Rose,2020,Deckbuilding,"₩13,500",0%,8,6,14,9450000,0,0,0,0
968580,Halloween Puzzles,2018,Deckbuilding,"₩2,300",0%,1,3,4,460000,0,0,0,0
1857730,Color Patterns,2022,Deckbuilding,"₩1,100",0%,2,2,4,220000,0,0,0,0
1113290,Token Game,2020,Deckbuilding,"₩5,500",0%,0,0,0,0,0,0,0,0
2348970,CheckMaze,2023,Deckbuilding,"₩7,800",0%,0,1,1,390000,0,0,0,0
2642720,GOT HIGH,2024,Deckbuilding,"₩5,600",0%,2,1,3,840000,0,0,0,0
1979060,Erectus,2022,Deckbuilding,"₩3,300",0%,0,0,0,0,0,0,0,0
693240,Mahjong Challenge,2017,Deckbuilding,"₩3,400",0%,3,8,11,1870000,3,8,11,1870000
1917970,Laruaville 12,2022,Deckbuilding,"₩11,000",0%,5,1,6,3300000,0,0,0,0
1857730,Color Patterns,2022,Deckbuilding,"₩1,100",0%,2,2,4,220000,0,0,0,0
3261060,Twisted Logic: Abbotsfield,2024,Deckbuilding,"₩5,600",0%,3,1,4,1120000,0,0,0,0
2950890,A Matching Game,2024,Deckbuilding,"₩1,400",75%,4,0,4,280000,0,0,0,0
874810,Brick Breaker Premium 3,2018,Deckbuilding,"₩1,100",0%,1,2,3,165000,0,0,0,0
2226930,EsoTarot VR,2022,Deckbuilding,"₩5,590",0%,2,0,2,559000,0,0,0,0
918620,Warships 3D,2019,Deckbuilding,"₩7,500",0%,10,1,11,4125000,0,0,0,0
1803870,The Knight of Turn,2021,Deckbuilding,"₩2,300",0%,2,0,2,230000,0,0,0,0
1051320,Mahjong: Magic Chips,2019,Deckbuilding,"₩3,400",0%,0,3,3,510000,0,0,0,0
884270,Cabins: Jigsaw Puzzles,2018,Deckbuilding,"₩2,300",0%,8,1,9,1035000,0,0,0,0
1522030,SUKAKKO,2021,Deckbuilding,"₩2,200",0%,1,1,2,220000,0,0,0,0
658870,EXIT 2 - Directions,2017,Deckbuilding,"₩8,900",0%,11,2,13,5785000,0,0,0,0
1855910,Flood,2022,Deckbuilding,"₩1,100",0%,1,2,3,165000,0,0,0,0
3215840,Player vs. Dealer Blackjack,2024,Deckbuilding,"₩3,400",0%,1,0,1,170000,0,0,0,0
2172780,Poly Puzzle: Dinosaurs,2022,Deckbuilding,"₩2,300",0%,0,0,0,0,0,0,0,0
931150,Rento Fortune VR,2018,Deckbuilding,"₩10,500",0%,5,1,6,3150000,0,0,0,0
1837590,Hammerground: Splat!,2022,Deckbuilding,"₩5,500",0%,0,0,0,0,0,0,0,0
2286960,Spellarium 9 Match 3 Puzzle,2023,Deckbuilding,"₩11,000",0%,4,0,4,2200000,0,0,0,0
1505570,labyrinth 3,2021,Deckbuilding,"₩1,100",0%,4,0,4,220000,0,0,0,0
1505570,labyrinth 3,2021,Deckbuilding,"₩1,100",0%,4,0,4,220000,0,0,0,0
1552740,First Days of Atlantis,2021,Deckbuilding,"₩10,500",0%,14,0,14,7350000,0,0,0,0
2270910,Poly Puzzle: Butterflies,2023,Deckbuilding,₩640,72%,0,0,0,0,0,0,0,0
3082610,Cube Railway - Puzzle,2024,Deckbuilding,"₩1,020",70%,10,0,10,510000,0,0,0,0
1621000,Ultimate Waifu Battle Online,2022,Deckbuilding,"₩3,400",0%,2,2,4,680000,0,0,0,0
714570,Hidden Object - Tools,2017,Deckbuilding,"₩2,300",0%,3,3,6,690000,0,0,0,0
721670,Frontiers.io,2017,Deckbuilding,"₩2,300",0%,3,3,6,690000,0,0,0,0
1535590,flChess 2,2021,Deckbuilding,"₩4,500",0%,6,4,10,2250000,0,0,0,0
1742940,Poly Puzzle: Furries,2021,Deckbuilding,₩640,72%,4,3,7,224000,0,0,0,0
3421800,Swingin' Beats,2025,Deckbuilding,"₩3,400",0%,2,0,2,340000,0,0,0,0
888880,Summer: Jigsaw Puzzles,2018,Deckbuilding,"₩4,500",0%,0,1,1,225000,0,0,0,0
2239050,Poly Puzzle: Animals,2022,Deckbuilding,"₩2,300",0%,0,0,0,0,0,0,0,0
901020,Adventure Portal,2018,Deckbuilding,"₩1,100",0%,2,1,3,165000,0,0,0,0
908950,Glow Chess,2018,Deckbuilding,"₩1,100",0%,2,12,14,770000,0,0,0,0
3595000,Farkle with Friends,2025,Deckbuilding,"₩5,600",0%,0,0,0,0,0,0,0,0
2188910,Waifu Museum,2022,Deckbuilding,"₩2,300",0%,9,4,13,1495000,0,0,0,0
2314790,Fishjong,2023,Deckbuilding,"₩8,900",0%,7,0,7,3115000,0,0,0,0
2754110,Pocketing the ball-Billiards Simulator - 8 ball- 3D pool,2024,Deckbuilding,"₩4,500",0%,2,2,4,900000,0,0,0,0
1856170,Poker - Texas,2022,Deckbuilding,"₩5,500",0%,1,0,1,275000,0,0,0,0
2345540,Perfect Hand of Nostalpix [REMASTER],2024,Deckbuilding,"₩7,800",0%,8,0,8,3120000,0,0,0,0
784040,Food Monster and Animals Memory Match,2018,Deckbuilding,"₩2,300",0%,1,1,2,230000,0,0,0,0
2903530,Primrows,2025,Deckbuilding,"₩8,900",0%,5,0,5,2225000,0,0,0,0
3291790,Durak Online,2025,Deckbuilding,"₩3,400",0%,5,2,7,1190000,0,0,0,0
3633390,DECK COLLECTOR,2025,Deckbuilding,"₩13,500",0%,0,0,0,0,0,0,0,0
1258290,Fantasy Memory Card Game,2020,Deckbuilding,"₩2,300",0%,1,1,2,230000,0,0,0,0
854950,Not Without You,2018,Deckbuilding,"₩2,200",0%,2,0,2,220000,0,0,0,0
2230060,Night&Scape,2023,Deckbuilding,"₩5,600",0%,6,0,6,1680000,0,0,0,0
3296050,Space Corps,2025,Deckbuilding,"₩2,300",0%,0,0,0,0,0,0,0,0
1840060,Shinogi Chess Club,2022,Deckbuilding,"₩16,500",0%,8,2,10,8250000,0,0,0,0
3614220,24 Grab Points,2025,Deckbuilding,"₩1,100",0%,0,0,0,0,0,0,0,0
3479070,Stainless Steel 2048,2025,Deckbuilding,"₩3,400",0%,0,0,0,0,0,0,0,0
1829760,Game Of Seven,2022,Deckbuilding,"₩8,500",0%,2,0,2,850000,0,0,0,0
1868510,Wordish,2022,Deckbuilding,"₩4,400",0%,7,3,10,2200000,0,0,0,0
1715530,Medieval Wars,2021,Deckbuilding,"₩1,150",89%,7,8,15,862500,0,0,0,0
709610,Mahjong Match,2017,Deckbuilding,"₩3,400",0%,1,7,8,1360000,0,0,0,0
718350,Loot Collection: Mahjong,2017,Deckbuilding,"₩2,300",0%,4,4,8,920000,0,0,0,0
1219120,RETRO-PIXEL COLOR PALETTE: Color by Number,2020,Deckbuilding,"₩3,400",0%,1,1,2,340000,0,0,0,0
3405960,Cataclysm Wars,2025,Deckbuilding,"₩11,000",0%,4,0,4,2200000,0,0,0,0
2077070,Shufflepoker,2022,Deckbuilding,"₩3,400",0%,3,0,3,510000,0,0,0,0
2499290,Lunch: The Card Game,2025,Deckbuilding,"₩5,600",0%,2,0,2,560000,0,0,0,0
3479070,Stainless Steel 2048,2025,Deckbuilding,"₩3,400",0%,0,0,0,0,0,0,0,0
3164850,Card Weapon Shop,2024,Deckbuilding,"₩7,800",0%,1,4,5,1950000,0,0,0,0
2269880,Battle of 2048 - Fantasy Edition,2023,Deckbuilding,"₩2,300",0%,6,1,7,805000,0,0,0,0
906360,LUXO Buddies,2018,Deckbuilding,"₩2,300",0%,4,2,6,690000,0,0,0,0
1715530,Medieval Wars,2021,Deckbuilding,"₩1,150",89%,7,8,15,862500,0,0,0,0
3556680,FJN Blackjack Cup,2025,Deckbuilding,"₩5,600",0%,0,0,0,0,0,0,0,0
1993510,Spellarium 8 Match 3 Puzzle,2022,Deckbuilding,"₩11,000",0%,4,0,4,2200000,0,0,0,0
2366070,Grant of God,2023,Deckbuilding,Free,0%,0,0,0,0,0,0,0,0
3614220,24 Grab Points,2025,Deckbuilding,"₩1,100",0%,0,0,0,0,0,0,0,0
1839780,Cat Dimension,2022,Deckbuilding,"₩1,040",89%,3,0,3,156000,0,0,0,0
1035790,Laruaville 7 - Match 3 Adventure,2019,Deckbuilding,"₩11,000",0%,4,0,4,2200000,0,0,0,0
3222680,Reconquista,2024,Deckbuilding,Free,0%,0,0,0,0,0,0,0,0
1757820,Hidden Object Hunt Classic,2021,Deckbuilding,"₩2,300",0%,1,0,1,115000,0,0,0,0
2957200,Pyradice,2024,Deckbuilding,"₩5,600",0%,4,0,4,1120000,0,0,0,0
2143190,The Cat Maze,2022,Deckbuilding,"₩5,600",0%,2,0,2,560000,0,0,0,0
1068540,Aurora Hex - Pattern Puzzles,2019,Deckbuilding,"₩3,400",0%,6,1,7,1190000,0,0,0,0
3447310,ON money,2025,Deckbuilding,"₩5,600",0%,3,1,4,1120000,0,0,0,0
3377900,Dice Clash World,2025,Deckbuilding,"₩11,000",0%,3,0,3,1650000,0,0,0,0
3448530,Your mini wife,2025,Deckbuilding,"₩3,400",0%,1,2,3,510000,0,0,0,0
2086130,Canfield Solitaire Collection,2022,Deckbuilding,"₩8,900",0%,3,1,4,1780000,0,0,0,0
1254770,Haulin' Oats,2025,Deckbuilding,"₩11,000",0%,9,0,9,4950000,0,0,0,0
1391490,Deep Maze,2023,Deckbuilding,"₩3,400",0%,0,0,0,0,0,0,0,0
3273730,Shut the Box,2024,Deckbuilding,"₩2,300",0%,3,2,5,575000,0,0,0,0
1575160,One4,2021,Deckbuilding,Free,0%,0,0,0,0,0,0,0,0
3829300,Forest Rites,2025,Deckbuilding,Free,0%,0,0,0,0,0,0,0,0
1238620,Peg Solitaire Adventure,2020,Deckbuilding,"₩6,700",0%,1,3,4,1340000,0,0,0,0
1238620,Peg Solitaire Adventure,2020,Deckbuilding,"₩6,700",0%,1,3,4,1340000,0,0,0,0
1370220,BAO,2020,Deckbuilding,"₩7,500",0%,5,1,6,2250000,0,0,0,0
3885080,Mage of Tempest Castle,2025,Deckbuilding,Unknown,0%,0,0,0,0,0,0,0,0
3252700,Soli-tair-ror,2024,Deckbuilding,"₩1,100",0%,0,1,1,55000,0,0,0,0
2019770,Emi's Country Store and Farm,2022,Deckbuilding,"₩8,500",0%,3,1,4,1700000,0,0,0,0
2054140,Checkers VR: Multiverse Journey,2022,Deckbuilding,"₩17,500",0%,1,0,1,875000,0,0,0,0
915360,Hexahedral Pathfinder,2021,Deckbuilding,"₩3,300",0%,13,0,13,2145000,0,0,0,0
1190640,Memory Match Saga,2019,Deckbuilding,"₩2,300",0%,1,1,2,230000,0,0,0,0
1595340,Sweet Home Puzzle,2021,Deckbuilding,"₩9,500",0%,3,0,3,1425000,0,0,0,0
2675640,Chess Gambit,2024,Deckbuilding,"₩9,900",0%,1,2,3,1485000,0,0,0,0
3921980,Pool Party,2025,Deckbuilding,Free,0%,0,0,0,0,0,0,0,0
1371110,labyrinth 2,2020,Deckbuilding,"₩1,100",0%,4,0,4,220000,0,0,0,0
713590,Hidden Object - Food,2017,Deckbuilding,"₩2,300",0%,1,12,13,1495000,1,11,12,1380000
3900540,Hexa Harmony,2025,Deckbuilding,"₩1,380",40%,0,0,0,0,0,0,0,0
2940560,Upstream Ante,2024,Deckbuilding,"₩9,900",40%,0,1,1,495000,0,0,0,0
1941660,Spider Solitaire Collection,2022,Deckbuilding,"₩8,900",0%,6,3,9,4005000,0,0,0,0
3136310,Scorpion Solitaire Classic Card Game,2024,Deckbuilding,Free,0%,0,0,0,0,0,0,0,0
3136310,Scorpion Solitaire Classic Card Game,2024,Deckbuilding,Free,0%,0,0,0,0,0,0,0,0
2553240,Shadow Overlord: The Beginning,2023,Deckbuilding,Free,0%,0,0,0,0,0,0,0,0
1596810,ArtPuzzle VR,2021,Deckbuilding,"₩10,500",0%,2,0,2,1050000,0,0,0,0
1750990,Merge Chess,2021,Deckbuilding,"₩1,100",0%,1,0,1,55000,0,0,0,0
1927580,Poly Memory: Birds,2022,Deckbuilding,"₩2,300",0%,4,2,6,690000,0,0,0,0
3834260,Hack&Po,2025,Deckbuilding,Free,0%,0,0,0,0,0,0,0,0
2714910,Stratum Descent,2024,Deckbuilding,"₩5,600",0%,7,1,8,2240000,0,0,0,0
923480,Strategist,2023,Deckbuilding,"₩3,400",0%,9,3,12,2040000,0,0,0,0
1755170,Coloring Pixel - Fantasy Characters,2021,Deckbuilding,"₩2,300",0%,4,0,4,460000,0,0,0,0
1153220,Mahjong Dimensions 3D - Fantasy Anime,2019,Deckbuilding,"₩2,300",0%,2,2,4,460000,0,0,0,0
2115480,Poly Puzzle: Predators,2022,Deckbuilding,"₩2,300",0%,0,1,1,115000,0,0,0,0
2291390,Peaceful Lands,2023,Deckbuilding,"₩3,400",0%,2,2,4,680000,0,0,0,0
1552090,Cursed House 9 - Match 3 Puzzle,2021,Deckbuilding,"₩11,000",0%,8,1,9,4950000,0,0,0,0
2768730,Panda?,2024,Deckbuilding,"₩2,300",0%,0,0,0,0,0,0,0,0
3666180,Solitaire of Stygian Shadows,2025,Deckbuilding,"₩11,000",0%,0,0,0,0,0,0,0,0
3106580,MightyKingdom,2025,Deckbuilding,"₩7,800",0%,0,0,0,0,0,0,0,0
2013010,Blood Scheme,2022,Deckbuilding,"₩6,500",0%,1,2,3,975000,0,0,0,0
1701870,Crumbling,2024,Deckbuilding,"₩23,500",0%,9,1,10,11750000,0,0,0,0
3260190,Slide Puzzle,2024,Deckbuilding,"₩2,300",0%,0,0,0,0,0,0,0,0
642390,Blocksworld,2017,Deckbuilding,Unknown,0%,501,269,770,0,0,0,0,0
3062620,Go Quirk!,2024,Deckbuilding,"₩3,400",0%,5,0,5,850000,0,0,0,0
1788860,labyrinth inf,2021,Deckbuilding,"₩1,100",0%,1,1,2,110000,0,0,0,0
1943870,FreeCell Solitaire Collection,2022,Deckbuilding,"₩8,900",0%,3,5,8,3560000,0,0,0,0
3163210,Tower Collapse,2024,Deckbuilding,"₩3,400",0%,0,0,0,0,0,0,0,0
3363730,Christmas Chaos,2024,Deckbuilding,"₩2,300",0%,0,0,0,0,0,0,0,0
1943880,Forty Thieves Solitaire Collection,2022,Deckbuilding,"₩8,900",0%,4,3,7,3115000,0,0,0,0
1789100,Roman Wars: Deck Building Game,2021,Deckbuilding,"₩1,700",50%,5,0,5,425000,0,0,0,0
1789100,Roman Wars: Deck Building Game,2021,Deckbuilding,"₩1,700",50%,5,0,5,425000,0,0,0,0
2208270,Handless show,2023,Deckbuilding,"₩8,900",0%,2,0,2,890000,0,0,0,0
1943880,Forty Thieves Solitaire Collection,2022,Deckbuilding,"₩8,900",0%,4,3,7,3115000,0,0,0,0
2258790,Activate: 激活,2023,Deckbuilding,"₩2,300",0%,3,1,4,460000,0,0,0,0
2072540,icosi-do,2022,Deckbuilding,"₩9,500",0%,6,5,11,5225000,0,0,0,0
2451200,Sands Of Solaris,2023,Deckbuilding,"₩4,500",0%,2,0,2,450000,0,0,0,0
3238920,Lexica,2024,Deckbuilding,"₩5,600",0%,6,0,6,1680000,0,0,0,0
3539920,Hexa Fusion 2048,2025,Deckbuilding,"₩2,300",0%,0,0,0,0,0,0,0,0
3059820,Block Mover Challenge,2024,Deckbuilding,"₩2,300",0%,1,0,1,115000,0,0,0,0
1879130,Mystic Cards,2022,Deckbuilding,"₩46,000",0%,0,0,0,0,0,0,0,0
2603650,Don't Let It Die,2024,Deckbuilding,"₩5,600",0%,8,0,8,2240000,0,0,0,0
1470300,Paper Tales - Catch Up Games,2020,Deckbuilding,"₩3,300",0%,2,3,5,825000,0,0,0,0
3434430,Goblin's Gamble 24,2025,Deckbuilding,"₩3,400",0%,8,1,9,1530000,0,0,0,0
1331310,Card escape: Plane crash,2022,Deckbuilding,"₩1,100",0%,2,0,2,110000,0,0,0,0
2292360,Jigsaw Puzzle Lovers,2023,Deckbuilding,"₩11,000",0%,3,0,3,1650000,0,0,0,0
2119960,Cursed House 11 Match 3 Puzzle,2022,Deckbuilding,"₩11,000",0%,3,0,3,1650000,0,0,0,0
2086580,Hiddens Awakening,2022,Deckbuilding,Free,0%,5,0,5,0,0,0,0,0
2616670,Flappy Swan,2023,Deckbuilding,"₩5,600",0%,7,2,9,2520000,0,0,0,0
2119960,Cursed House 11 Match 3 Puzzle,2022,Deckbuilding,"₩11,000",0%,3,0,3,1650000,0,0,0,0
3914140,Slice Surge,2025,Deckbuilding,"₩1,380",40%,0,0,0,0,0,0,0,0
1652170,Space puzzle,2021,Deckbuilding,"₩1,150",89%,4,10,14,805000,0,0,0,0
1746730,Hidden Objects - Cartoon Fantasy,2021,Deckbuilding,"₩2,300",0%,0,1,1,115000,0,0,0,0
2918960,Feed The Gods,2024,Deckbuilding,"₩5,600",0%,4,0,4,1120000,0,0,0,0
2269710,Mega Sudoku - Binary & Suguru,2023,Deckbuilding,"₩8,900",0%,4,2,6,2670000,0,0,0,0
705960,DreamPuzzle,2025,Deckbuilding,"₩10,500",0%,0,0,0,0,0,0,0,0
2597330,Quiz Game Night,2023,Deckbuilding,Free,0%,0,0,0,0,0,0,0,0
3478300,Saláta,2025,Deckbuilding,"₩5,600",0%,0,0,0,0,0,0,0,0
2822910,DrawBall,2024,Deckbuilding,"₩3,400",0%,1,1,2,340000,0,0,0,0
1889030,Rabbit & Dominoes,2022,Deckbuilding,"₩1,100",0%,0,0,0,0,0,0,0,0
3275720,Drinking Song,2025,Deckbuilding,"₩2,300",0%,0,0,0,0,0,0,0,0
1703650,Hashi: Light,2021,Deckbuilding,"₩4,400",0%,11,0,11,2420000,0,0,0,0
2587040,JACKPOT 2,2023,Deckbuilding,"₩4,500",0%,0,2,2,450000,0,0,0,0
2587040,JACKPOT 2,2023,Deckbuilding,"₩4,500",0%,0,2,2,450000,0,0,0,0
3600730,Desktop Standing Card Plates,2025,Deckbuilding,₩550,50%,8,0,8,220000,0,0,0,0
1427450,Dino Drink,2022,Deckbuilding,"₩3,400",0%,1,4,5,850000,0,0,0,0
1488740,The Best BJ,2021,Deckbuilding,"₩2,300",0%,12,2,14,1610000,0,0,0,0
1701650,Baklava Simulator,2021,Deckbuilding,"₩4,500",0%,8,1,9,2025000,0,0,0,0
3409820,HexaMerge 2048,2025,Deckbuilding,"₩2,300",0%,2,1,3,345000,0,0,0,0
2369100,Cities of the World Jigsaw Puzzles,2023,Deckbuilding,"₩2,300",0%,0,1,1,115000,0,0,0,0
1848640,VR Async Balls,2022,Deckbuilding,"₩3,300",0%,1,0,1,165000,0,0,0,0
3812840,magical capture,2025,Deckbuilding,"₩6,700",0%,0,0,0,0,0,0,0,0
1473100,Guess Colors,2020,Deckbuilding,"₩1,100",0%,2,0,2,110000,0,0,0,0
3376590,Hearth Storm,2024,Deckbuilding,"₩5,600",0%,1,0,1,280000,0,0,0,0
801150,IMM Defense,2018,Deckbuilding,"₩1,100",0%,1,3,4,220000,0,0,0,0
3259710,Whole Note,2024,Deckbuilding,"₩1,100",0%,1,0,1,55000,0,0,0,0
801150,IMM Defense,2018,Deckbuilding,"₩1,100",0%,1,3,4,220000,0,0,0,0
1759480,Funny puzzle,2021,Deckbuilding,"₩1,260",89%,2,7,9,567000,0,0,0,0
2918650,Starbiz,2024,Deckbuilding,"₩7,800",0%,2,1,3,1170000,0,0,0,0
2640050,Norwegian Jigsaw Puzzles,2023,Deckbuilding,"₩2,300",0%,1,0,1,115000,0,0,0,0
2094380,Chai,2022,Deckbuilding,"₩11,000",0%,7,0,7,3850000,0,0,0,0
1774810,Laruaville 10 Match 3 Puzzle,2021,Deckbuilding,"₩11,000",0%,2,2,4,2200000,0,0,0,0
1825060,Poly Memory: Cats,2021,Deckbuilding,₩640,72%,1,4,5,160000,0,0,0,0
3475710,Dungeon Spheres,2025,Deckbuilding,"₩5,600",0%,12,0,12,3360000,0,0,0,0
1937050,Chased Around The World,2022,Deckbuilding,"₩3,300",0%,1,0,1,165000,0,0,0,0
3810000,Geargrid Tile Match,2025,Deckbuilding,"₩2,300",0%,0,0,0,0,0,0,0,0
2056480,Classic Memory Game,2022,Deckbuilding,"₩2,300",0%,3,1,4,460000,0,0,0,0
3291510,Fantasy Memory: A Relaxing Match Game,2024,Deckbuilding,"₩2,300",0%,0,0,0,0,0,0,0,0
3380940,Paw & Hop Jigsaw Quest,2024,Deckbuilding,"₩2,300",0%,1,0,1,115000,0,0,0,0
3444760,Unpuzzle Quest,2025,Deckbuilding,"₩2,300",0%,0,0,0,0,0,0,0,0
3166480,LOCUS POKER,2024,Deckbuilding,"₩6,700",0%,1,0,1,335000,0,0,0,0
3160980,Block Twist Challenge,2024,Deckbuilding,"₩2,300",0%,1,0,1,115000,0,0,0,0
1949330,Jigsaw Savant,2022,Deckbuilding,"₩21,500",0%,2,0,2,2150000,0,0,0,0
1051280,Ballista Legend,2019,Deckbuilding,"₩3,300",0%,6,3,9,1485000,0,0,0,0
2797080,Mercenary Squad Auto Chess,2025,Deckbuilding,"₩6,700",0%,5,3,8,2680000,0,0,0,0
3679500,Rise to King Ortler,2025,Deckbuilding,Unknown,0%,0,0,0,0,0,0,0,0
991500,Make A Jigsaw Puzzle,2018,Deckbuilding,"₩2,200",0%,3,1,4,440000,0,0,0,0
1660580,Invasion: Neo Earth,2022,Deckbuilding,"₩9,500",0%,3,0,3,1425000,0,0,0,0
1774910,Bubble POP IT ASMR,2021,Deckbuilding,"₩2,300",0%,15,0,15,1725000,0,0,0,0
1778490,Hexagourds,2022,Deckbuilding,"₩7,500",0%,3,2,5,1875000,0,0,0,0
3739420,Burr Puzzle,2025,Deckbuilding,"₩1,100",0%,0,0,0,0,0,0,0,0
2778280,DeskPet,2024,Deckbuilding,"₩4,500",0%,0,1,1,225000,0,0,0,0
2988780,Rocket Poker,2024,Deckbuilding,"₩2,300",0%,3,0,3,345000,0,0,0,0
839820,Match Connect Challenge,2018,Deckbuilding,"₩2,300",0%,6,2,8,920000,0,0,0,0
3107820,Underground Turtle Races,2024,Deckbuilding,"₩1,100",0%,10,1,11,605000,0,0,0,0
2660870,Gemstone Puzzle Fury,2023,Deckbuilding,"₩2,300",0%,3,0,3,345000,0,0,0,0
3003780,Thor's Breakout,2024,Deckbuilding,"₩1,100",0%,0,2,2,110000,0,0,0,0
3582460,Misty's Super Golf Solitaire,2025,Deckbuilding,"₩5,600",0%,1,0,1,280000,0,0,0,0
1157070,Arabian Stones - The VR Sudoku Game,2019,Deckbuilding,"₩2,200",0%,1,0,1,110000,0,0,0,0
2734440,Puzzle Maker,2024,Deckbuilding,"₩5,600",0%,7,0,7,1960000,0,0,0,0
2703370,United States of America Jigsaw Puzzles,2023,Deckbuilding,"₩2,300",0%,1,0,1,115000,0,0,0,0
3195070,Paint Puzzle Quest,2024,Deckbuilding,"₩2,300",0%,5,0,5,575000,0,0,0,0
1990100,World War 3: Card Battler,2024,Deckbuilding,"₩1,100",0%,2,1,3,165000,0,0,0,0
1281470,Chessсakе,2020,Deckbuilding,"₩6,700",0%,5,3,8,2680000,0,0,0,0
1719980,Creepy Mahjong,2021,Deckbuilding,"₩8,500",0%,2,0,2,850000,0,0,0,0
1402010,Table Soccer Club,2020,Deckbuilding,"₩1,100",0%,3,0,3,165000,0,0,0,0
3009890,Thebes,2024,Deckbuilding,"₩2,300",0%,0,0,0,0,0,0,0,0
3219090,Games For The Table,2024,Deckbuilding,Free,0%,0,0,0,0,0,0,0,0
2642870,StepByStep,2024,Deckbuilding,"₩4,500",0%,0,0,0,0,0,0,0,0
2531060,Last Minute,2023,Deckbuilding,"₩3,400",0%,1,0,1,170000,0,0,0,0
3136300,Canfield Solitaire Classic Card Game,2024,Deckbuilding,Free,0%,0,0,0,0,0,0,0,0
2931390,War Room: Blitz,2024,Deckbuilding,"₩2,300",0%,6,0,6,690000,0,0,0,0
1221510,IMM Defense 2,2020,Deckbuilding,"₩1,100",0%,4,2,6,330000,0,0,0,0
2680310,Oriental Gold : Golden Trains Edition - Slots,2023,Deckbuilding,"₩12,500",0%,0,0,0,0,0,0,0,0
1210830,labyrinth,2020,Deckbuilding,"₩1,100",0%,7,2,9,495000,0,0,0,0
3357680,Deadwalker Chronicles,2025,Deckbuilding,"₩14,500",0%,1,2,3,2175000,0,0,0,0
3598790,Bear vs. Wolf Jigsaw Puzzle,2025,Deckbuilding,"₩2,300",0%,0,0,0,0,0,0,0,0
2969040,Roulette Simulator 2025,2024,Deckbuilding,"₩2,300",0%,1,3,4,460000,0,0,0,0
3182360,Bakery Shop Match Up,2024,Deckbuilding,"₩2,300",0%,0,0,0,0,0,0,0,0
1094130,Bugs!,2019,Deckbuilding,"₩6,700",0%,7,2,9,3015000,0,0,0,0
2850520,KanjiMemory,2024,Deckbuilding,"₩4,500",0%,0,0,0,0,0,0,0,0
3913060,Tic Cat Dog,2025,Deckbuilding,₩930,15%,0,0,0,0,0,0,0,0
3182360,Bakery Shop Match Up,2024,Deckbuilding,"₩2,300",0%,0,0,0,0,0,0,0,0
2474880,Paint by Cubes,2024,Deckbuilding,"₩11,000",0%,1,0,1,550000,0,0,0,0
1391600,Anime Jigsaw Puzzles,2020,Deckbuilding,"₩4,500",0%,4,1,5,1125000,0,0,0,0
2353900,Jigsaw Puzzle - Baby Animals,2023,Deckbuilding,"₩2,300",0%,3,0,3,345000,0,0,0,0
873830,Subcube,2019,Deckbuilding,"₩3,400",0%,10,1,11,1870000,0,0,0,0
2739170,Splurge,2024,Deckbuilding,"₩3,400",0%,5,0,5,850000,0,0,0,0
3219910,Rumor Raiders,2025,Deckbuilding,"₩4,500",0%,0,0,0,0,0,0,0,0
2261440,BallZ,2023,Deckbuilding,"₩1,100",0%,2,0,2,110000,0,0,0,0
2668800,Ticker Tape,2025,Deckbuilding,"₩5,600",0%,3,0,3,840000,0,0,0,0
2891930,memorel,2024,Deckbuilding,"₩3,000",0%,6,0,6,900000,0,0,0,0
3777750,Color Pathways,2025,Deckbuilding,"₩2,300",0%,0,0,0,0,0,0,0,0
1815430,Cursed House 10 - Match 3 Puzzle,2021,Deckbuilding,"₩11,000",0%,5,0,5,2750000,0,0,0,0
2609270,Aerial Nature Jigsaw Puzzles,2023,Deckbuilding,"₩2,300",0%,2,0,2,230000,0,0,0,0
3344530,Château Royale Jigsaw,2024,Deckbuilding,"₩2,300",0%,0,1,1,115000,0,0,0,0
2568410,Arena 9th,2024,Deckbuilding,"₩9,900",0%,9,0,9,4455000,0,0,0,0
3333900,Timber Trails Alpine Puzzle,2024,Deckbuilding,"₩2,300",0%,0,0,0,0,0,0,0,0
3319290,USA Nature's Trails Jigsaw Edition,2024,Deckbuilding,"₩2,300",0%,0,1,1,115000,0,0,0,0
2350500,Childhood Dreams - Jigsaw Puzzle,2023,Deckbuilding,"₩2,300",0%,1,0,1,115000,0,0,0,0
2568410,Arena 9th,2024,Deckbuilding,"₩9,900",0%,9,0,9,4455000,0,0,0,0
2693830,Panda Magix : Golden Trains Edition - Slots,2023,Deckbuilding,"₩12,500",0%,0,0,0,0,0,0,0,0
2214860,Look for connecting stars,2022,Deckbuilding,"₩6,800",0%,1,0,1,340000,0,0,0,0
3343630,Card Heroes of Millford,2025,Deckbuilding,"₩8,900",0%,0,0,0,0,0,0,0,0
1955520,Escape from the Marble Monster,2023,Deckbuilding,"₩1,100",0%,6,0,6,330000,0,0,0,0
1576770,Superhero Recruitment Simulator,2021,Deckbuilding,"₩1,100",0%,3,0,3,165000,0,0,0,0
2988470,Fool's Gambit,2024,Deckbuilding,"₩4,500",0%,4,0,4,900000,0,0,0,0
3758650,词力牌：LexiLoong,2025,Deckbuilding,"₩7,800",0%,0,0,0,0,0,0,0,0
3774030,Kingdoms of Dice - The Elonia Chronicles,2025,Deckbuilding,"₩9,900",0%,0,0,0,0,0,0,0,0
2242080,Just Chess,2025,Deckbuilding,"₩7,800",0%,0,0,0,0,0,0,0,0
2597600,Golden Leaf Jigsaw Puzzles,2023,Deckbuilding,"₩2,300",0%,1,0,1,115000,0,0,0,0
3127780,Retropy VR,2024,Deckbuilding,"₩9,900",0%,0,0,0,0,0,0,0,0
1526000,folding maze,2022,Deckbuilding,"₩2,200",0%,3,0,3,330000,0,0,0,0
776160,Up and Down,2018,Deckbuilding,"₩9,900",0%,21,4,25,12375000,0,0,0,0
1371900,KYOKI,2020,Deckbuilding,"₩5,600",0%,0,0,0,0,0,0,0,0
1721010,Master of the Wizards,2022,Deckbuilding,"₩10,500",0%,2,1,3,1575000,0,0,0,0
2601010,Sequence: The Ranked Poker Dice Game,2024,Deckbuilding,"₩4,500",0%,1,0,1,225000,0,0,0,0
3860200,Space Memory: Predators,2025,Deckbuilding,"₩2,300",0%,0,0,0,0,0,0,0,0
3137640,H.A.R.D.,2024,Deckbuilding,"₩2,300",0%,1,0,1,115000,0,0,0,0
1178530,Thirty-One 3D Premium,2024,Deckbuilding,"₩5,600",0%,6,0,6,1680000,0,0,0,0
3243720,Cast Dice Away,2024,Deckbuilding,"₩3,400",0%,4,0,4,680000,0,0,0,0
3339600,HO-HOP! - Christmas Board Game,2024,Deckbuilding,"₩1,100",0%,10,0,10,550000,0,0,0,0
3844090,Fatebound Cards: Sundering Cities,2025,Deckbuilding,"₩4,500",0%,0,0,0,0,0,0,0,0
1813570,jingor sudoku,2021,Deckbuilding,"₩2,200",0%,1,1,2,220000,0,0,0,0
2719000,Ace Triad,2024,Deckbuilding,"₩1,100",0%,0,0,0,0,0,0,0,0
3641990,Mahjong Expedition,2025,Deckbuilding,"₩9,900",0%,6,0,6,2970000,0,0,0,0
728670,Maze Up!,2017,Deckbuilding,"₩2,300",0%,4,1,5,575000,0,0,0,0
3082750,Dice Dice Dice,2024,Deckbuilding,"₩3,400",0%,1,0,1,170000,0,0,0,0
2948060,Twizzle Puzzle: Horses,2024,Deckbuilding,"₩2,300",0%,0,0,0,0,0,0,0,0
2875920,Twizzle Puzzle: Monkeys,2024,Deckbuilding,"₩2,300",0%,0,0,0,0,0,0,0,0
2757530,Twizzle Puzzle: Reptiles,2024,Deckbuilding,₩640,72%,0,0,0,0,0,0,0,0
3690130,Beastopia,2025,Deckbuilding,Free,0%,0,0,0,0,0,0,0,0
2133250,Poly Memory: Predators,2022,Deckbuilding,₩640,72%,0,0,0,0,0,0,0,0
2729040,Twizzle Puzzle: Animals,2023,Deckbuilding,"₩2,300",0%,0,0,0,0,0,0,0,0
3874510,Nightmare Mines,2025,Deckbuilding,Unknown,0%,0,0,0,0,0,0,0,0
3138800,Twizzle Puzzle: Dragons,2024,Deckbuilding,"₩2,300",0%,0,0,0,0,0,0,0,0
3500080,Find My Love,2025,Deckbuilding,"₩2,300",0%,1,0,1,115000,0,0,0,0
2649460,Die Cook,2024,Deckbuilding,"₩11,000",0%,2,0,2,1100000,0,0,0,0
2473470,Wyrmicide,2023,Deckbuilding,Free,0%,8,1,9,0,0,0,0,0
3176790,Tesserarii: The Dice Rolling Roguelike,2025,Deckbuilding,"₩8,900",0%,3,0,3,1335000,0,0,0,0
3866270,The Trade Dynasty,2025,Deckbuilding,Unknown,0%,0,0,0,0,0,0,0,0
2194940,Takenoko - Tilt Five AR,2023,Deckbuilding,"₩21,500",0%,2,0,2,2150000,0,0,0,0
1478980,Pinball,2020,Deckbuilding,"₩3,400",0%,3,2,5,850000,0,0,0,0
1606910,Jigsaw Puzzle VR,2021,Deckbuilding,"₩5,500",0%,1,1,2,550000,0,0,0,0
1666090,Karanos Solitaire,2021,Deckbuilding,"₩3,300",0%,5,0,5,825000,0,0,0,0
1543620,Paintings Jigsaw Puzzles,2021,Deckbuilding,"₩4,500",0%,2,0,2,450000,0,0,0,0
1765960,Chezzle,2021,Deckbuilding,"₩1,100",0%,12,1,13,715000,0,0,0,0
3578580,Pair Master,2025,Deckbuilding,Free,0%,0,0,0,0,0,0,0,0
1428290,Anime - Match The Memory,2020,Deckbuilding,"₩2,300",0%,2,0,2,230000,0,0,0,0
2672780,New Zealand Jigsaw Puzzles,2023,Deckbuilding,"₩2,300",0%,1,0,1,115000,0,0,0,0
2485470,Poly Jigsaw: Furries,2023,Deckbuilding,"₩2,300",0%,0,0,0,0,0,0,0,0
1780410,Christmas Slots - Casino Game,2021,Deckbuilding,"₩2,300",0%,3,1,4,460000,0,0,0,0
2548260,The Devil's Typist,2024,Deckbuilding,"₩1,100",0%,4,2,6,330000,0,0,0,0
1574320,神秘世界 Mysterious world,2021,Deckbuilding,"₩5,500",0%,0,1,1,275000,0,0,0,0
2704230,Twizzle Puzzle: Cats,2023,Deckbuilding,"₩2,300",0%,0,0,0,0,0,0,0,0
2456260,While waiting my turn,2024,Deckbuilding,Free,0%,0,0,0,0,0,0,0,0
1842190,jingor 2048,2022,Deckbuilding,"₩2,200",0%,1,0,1,110000,0,0,0,0
1533570,Word Wise,2021,Deckbuilding,"₩3,400",0%,7,3,10,1700000,0,0,0,0
2100600,kabuto,2023,Deckbuilding,"₩3,400",0%,1,0,1,170000,0,0,0,0
1619260,Flag Color Number - Painting and Coloring,2021,Deckbuilding,"₩2,300",0%,2,2,4,460000,0,0,0,0
1193930,Ping Pong Space - Retro Tennis,2019,Deckbuilding,"₩3,400",0%,6,1,7,1190000,0,0,0,0
3753010,Pudding Fantasy: Tales of Go and Magic,2025,Deckbuilding,Free,0%,0,0,0,0,0,0,0,0
1375780,The Scam,2020,Deckbuilding,"₩5,600",0%,3,0,3,840000,0,0,0,0
3135250,Deckception,2024,Deckbuilding,"₩5,600",0%,5,0,5,1400000,0,0,0,0
1842200,jingor mine,2022,Deckbuilding,"₩2,200",0%,1,1,2,220000,0,0,0,0
3581810,Desktop Cat,2025,Deckbuilding,"₩4,500",0%,0,0,0,0,0,0,0,0
3677420,Tile Tales Builder,2025,Deckbuilding,"₩2,110",53%,2,1,3,316500,0,0,0,0
2264200,Domination - War of Nations,2023,Deckbuilding,"₩5,600",0%,5,0,5,1400000,0,0,0,0
680070,Puzzle: Underwater World,2017,Deckbuilding,"₩2,300",0%,4,5,9,1035000,0,0,0,0
1672680,Kungfu Football Captain,2021,Deckbuilding,"₩3,300",0%,5,5,10,1650000,0,0,0,0
3402180,Fighting for Land / 打怪兽抢领地,2025,Deckbuilding,"₩4,000",0%,3,0,3,600000,0,0,0,0
3616630,Arcadia: Cloudbound,2025,Deckbuilding,"₩16,500",0%,0,0,0,0,0,0,0,0
1443760,Snaaker & Friends,2020,Deckbuilding,"₩2,200",0%,1,0,1,110000,0,0,0,0
3376550,4X4 PROGRESS,2025,Deckbuilding,"₩6,700",0%,2,0,2,670000,0,0,0,0
2948750,Block Pieces - 3D Jigsaw Puzzle,2024,Deckbuilding,"₩2,300",0%,6,0,6,690000,0,0,0,0
3723480,Cardrottini,2025,Deckbuilding,"₩4,500",0%,5,0,5,1125000,0,0,0,0
3525650,Macro Data Refinement Simulator: Shapes,2025,Deckbuilding,"₩5,600",0%,1,0,1,280000,0,0,0,0
3396280,Big Cat Jigsaw Quest,2024,Deckbuilding,"₩2,300",0%,3,0,3,345000,0,0,0,0
3429970,Digital Revolution,2025,Deckbuilding,"₩2,300",0%,5,0,5,575000,0,0,0,0
3267500,Through the stars,2024,Deckbuilding,"₩13,500",0%,0,0,0,0,0,0,0,0
2671990,Spooky Spins Returns : Crazy Cash Edition - Slots,2023,Deckbuilding,"₩12,500",0%,0,0,0,0,0,0,0,0
1789440,Ani Leaving Sirius,2021,Deckbuilding,"₩5,600",0%,6,0,6,1680000,0,0,0,0
1807150,KeyHero,2021,Deckbuilding,"₩1,100",0%,4,1,5,275000,0,0,0,0
250900,The Binding of Isaac: Rebirth,2014,Roguelike,"₩15,500",0%,334165,9255,343420,266150500000,0,0,0,0
2226730,OVIS LOOP,2025,Roguelike,"₩14,800",19%,0,0,0,0,301,49,350,259000000
322330,Don't Starve Together,2016,Roguelike,"₩15,500",0%,475393,23668,499061,386772275000,0,0,0,0
1721110,Abyssus,2025,Roguelike,"₩22,950",15%,0,0,0,0,1139,217,1356,1556010000
2379780,Balatro,2024,Roguelike,"₩16,500",0%,150524,3042,153566,126691950000,0,0,0,0
1145350,Hades II,2024,Roguelike,"₩32,000",0%,60844,3288,64132,102611200000,0,0,0,0
1217060,Gunfire Reborn,2021,Roguelike,"₩20,500",0%,92655,6517,99172,101651300000,0,0,0,0
632360,Risk of Rain 2,2020,Roguelike,"₩26,000",0%,293127,20450,313577,407650100000,0,0,0,0
2530470,Garden of Witches,2025,Roguelike,"₩17,600",19%,479,19,498,438240000,807,42,849,747120000
1145360,Hades,2020,Roguelike,"₩27,000",0%,274829,4912,279741,377650350000,0,0,0,0
2835570,Buckshot Roulette,2024,Roguelike,"₩3,400",0%,91745,3796,95541,16241970000,0,0,0,0
646570,Slay the Spire,2019,Roguelike,"₩27,000",0%,178250,4027,182277,246073950000,0,0,0,0
1127500,Mini Motorways,2021,Roguelike,"₩10,500",0%,20615,817,21432,11251800000,0,0,0,0
2525310,Drop Duchy,2025,Roguelike,"₩13,200",19%,1225,141,1366,901560000,1571,194,1765,1164900000
262060,Darkest Dungeon®,2016,Roguelike,"₩27,000",0%,137026,12430,149456,201765600000,0,0,0,0
2742830,Monster Train 2,2025,Roguelike,"₩27,000",0%,3505,159,3664,4946400000,0,0,0,0
2106670,Gatekeeper,2025,Roguelike,"₩16,500",0%,1409,244,1653,1363725000,0,0,0,0
2071280,Ravenswatch,2024,Roguelike,"₩27,000",0%,12942,3211,16153,21806550000,0,0,0,0
2427700,Backpack Battles,2025,Roguelike,"₩16,500",0%,13410,1370,14780,12193500000,0,0,0,0
1794680,Vampire Survivors,2022,Roguelike,"₩5,000",0%,246479,3855,250334,62583500000,0,0,0,0
269210,Hero Siege,2014,Roguelike,"₩8,900",0%,29813,13699,43512,19362840000,0,0,0,0
568220,Lobotomy Corporation | Monster Management Simulation,2018,Roguelike,"₩26,000",0%,41213,2719,43932,57111600000,0,0,0,0
1147560,Skul: The Hero Slayer,2021,Roguelike,"₩20,500",0%,51218,3683,54901,56273525000,0,0,0,0
625960,Stoneshard,2020,Roguelike,"₩18,000",25%,22298,7764,30062,27055800000,0,0,0,0
3028310,Nordhold,2025,Roguelike,"₩15,050",30%,1924,216,2140,1610350000,0,0,0,0
1286580,Ship of Fools,2022,Roguelike,"₩9,900",60%,4328,979,5307,2626965000,0,0,0,0
588650,Dead Cells,2018,Roguelike,"₩25,800",0%,163549,4915,168464,217318560000,0,0,0,0
2820820,Jotunnslayer: Hordes of Hel,2025,Roguelike,"₩16,500",0%,3274,693,3967,3272775000,0,0,0,0
527230,For The King,2018,Roguelike,"₩20,500",0%,36581,4906,41487,42524175000,0,0,0,0
2085540,Stick It to the Stickman,2025,Roguelike,"₩5,600",0%,0,0,0,0,416,8,424,118720000
3406850,Debugging Hero,2025,Roguelike,"₩9,900",9%,0,0,0,0,124,19,143,70785000
1911610,Windblown,2024,Roguelike,"₩27,000",0%,7610,843,8453,11411550000,0,0,0,0
1188930,Chrono Ark,2024,Roguelike,"₩27,000",0%,11075,1192,12267,16560450000,0,0,0,0
1569580,Blue Prince,2025,Roguelike,"₩32,000",0%,7306,1096,8402,13443200000,0,0,0,0
753420,Dungreed,2018,Roguelike,"₩10,500",0%,8672,621,9293,4878825000,0,0,0,0
692890,Roboquest,2023,Roguelike,"₩30,000",0%,20701,988,21689,32533500000,0,0,0,0
881100,Noita,2020,Roguelike,"₩20,500",0%,74759,3718,78477,80438925000,0,0,0,0
418530,Spelunky 2,2020,Roguelike,"₩20,500",0%,19062,1423,20485,20997125000,0,0,0,0
247080,Crypt of the NecroDancer,2015,Roguelike,"₩16,500",0%,24053,1063,25116,20720700000,0,0,0,0
2138710,Sifu,2023,Roguelike,"₩41,000",0%,19536,1593,21129,43314450000,0,0,0,0
2103140,Magicraft,2024,Roguelike,"₩17,500",0%,12485,1048,13533,11841375000,0,0,0,0
1296830,暖雪 Warm Snow,2022,Roguelike,"₩18,500",0%,34444,2563,37007,34231475000,0,0,0,0
3201070,Gigantes Ex Machina,2025,Roguelike,"₩14,850",9%,0,0,0,0,82,19,101,74992500
2423300,School Labyrinth,2024,Roguelike,"₩7,800",0%,580,117,697,271830000,540,110,650,253500000
1280930,Astral Ascent,2023,Roguelike,"₩13,000",50%,6549,365,6914,4494100000,0,0,0,0
1473350,(the) Gnorp Apologue,2023,Roguelike,"₩7,500",0%,7849,294,8143,3053625000,0,0,0,0
2002220,Keeper's Toll,2024,Roguelike,"₩7,800",0%,491,47,538,209820000,427,47,474,184860000
2644610,Menace from the Deep,2024,Roguelike,"₩13,400",32%,1446,258,1704,1141680000,1498,285,1783,1194610000
445980,Wizard of Legend,2018,Roguelike,"₩4,950",70%,18633,1887,20520,5078700000,0,0,0,0
1763250,SWORN,2025,Roguelike,"₩27,000",0%,2039,422,2461,3322350000,0,0,0,0
590380,Into the Breach,2018,Roguelike,"₩15,500",0%,19126,1090,20216,15667400000,0,0,0,0
1025250,Shadow Corridor,2019,Roguelike,"₩8,500",0%,1796,182,1978,840650000,1685,167,1852,787100000
3072640,Guidus Zero,2025,Roguelike,"₩13,200",19%,254,105,359,236940000,315,111,426,281160000
371970,Barony,2015,Roguelike,"₩21,500",0%,9725,786,10511,11299325000,0,0,0,0
311690,Enter the Gungeon,2016,Roguelike,"₩16,500",0%,81669,3893,85562,70588650000,0,0,0,0
2193540,Wizard of Legend 2,2025,Roguelike,"₩20,800",19%,859,446,1305,1357200000,959,694,1653,1719120000
3109580,I Am Legion: Stand Survivors,2025,Roguelike,"₩9,000",0%,1331,255,1586,713700000,1372,281,1653,743850000
337320,Paint the Town Red,2021,Roguelike,"₩21,500",0%,28358,1218,29576,31794200000,0,0,0,0
2803280,Dragon Is Dead,2025,Roguelike,"₩21,500",0%,279,63,342,367650000,444,133,577,620275000
2780710,Asgard's Fall — Viking Survivors,2025,Roguelike,"₩7,800",0%,710,112,822,320580000,746,164,910,354900000
2206270,Vampire Hunters,2024,Roguelike,"₩9,900",40%,1375,144,1519,751905000,1314,146,1460,722700000
219740,Don't Starve,2013,Roguelike,"₩10,500",0%,106118,3698,109816,57653400000,0,0,0,0
1147860,UFO 50,2024,Roguelike,"₩27,000",0%,5982,267,6249,8436150000,0,0,0,0
3449590,Murim Survival,2025,Roguelike,"₩8,900",0%,129,28,157,69865000,147,34,181,80545000
597170,Clone Drone in the Danger Zone,2021,Roguelike,"₩20,500",0%,32025,1042,33067,33893675000,0,0,0,0
2445690,Lost Castle 2,2024,Roguelike,"₩16,500",0%,6425,1865,8290,6839250000,0,0,0,0
1740720,Have a Nice Death,2023,Roguelike,"₩27,000",0%,8588,1351,9939,13417650000,0,0,0,0
1694420,Card Survival: Tropical Island,2022,Roguelike,"₩26,000",0%,2596,133,2729,3547700000,0,0,0,0
2738490,Sol Cesto,2025,Roguelike,"₩13,500",0%,844,35,879,593325000,1586,101,1687,1138725000
992300,嗜血印 Bloody Spell,2022,Roguelike,"₩26,000",0%,31311,3806,35117,45652100000,0,0,0,0
113200,The Binding of Isaac,2011,Roguelike,"₩5,500",0%,57299,3080,60379,16604225000,0,0,0,0
3353100,Passant: A Chess Roguelike,2025,Roguelike,"₩12,150",9%,0,0,0,0,121,26,147,89302500
960690,One Step From Eden,2020,Roguelike,"₩8,200",60%,6940,495,7435,3048350000,0,0,0,0
1769170,Shattered Pixel Dungeon,2022,Roguelike,"₩11,000",0%,1529,77,1606,883300000,1546,81,1627,894850000
212680,FTL: Faster Than Light,2012,Roguelike,"₩10,500",0%,71561,3491,75052,39402300000,0,0,0,0
200210,Realm of the Mad God Exalt,2012,Roguelike,Free,0%,38723,7897,46620,0,0,0,0,0
323220,Vagante,2018,Roguelike,"₩16,000",0%,4319,521,4840,3872000000,0,0,0,0
1282730,Loop Hero,2021,Roguelike,"₩16,500",0%,32214,2445,34659,28593675000,0,0,0,0
2564520,Lost in Random: The Eternal Die,2025,Roguelike,"₩21,600",19%,0,0,0,0,363,59,422,455760000
1296610,Peglin,2024,Roguelike,"₩21,500",0%,13369,2624,15993,17192475000,0,0,0,0
1140150,Touhou: Lost Branch of Legend,2022,Roguelike,"₩35,000",0%,1536,114,1650,2887500000,1540,116,1656,2898000000
677120,Heroes of Hammerwatch,2018,Roguelike,"₩3,370",75%,8061,1123,9184,1547504000,0,0,0,0
1286350,BPM: BULLETS PER MINUTE,2020,Roguelike,"₩21,500",0%,10091,1023,11114,11947550000,0,0,0,0
3141720,Monster Battles,2025,Roguelike,"₩11,000",0%,162,48,210,115500000,208,69,277,152350000
1830970,The Last Flame,2025,Roguelike,"₩21,500",0%,2167,362,2529,2718675000,0,0,0,0
1076200,Roguebook,2021,Roguelike,"₩3,900",85%,3231,625,3856,751920000,0,0,0,0
973230,We Who Are About To Die,2022,Roguelike,"₩24,000",0%,6500,874,7374,8848800000,0,0,0,0
2746910,Three Kingdoms: The Blood Moon,2025,Roguelike,"₩9,900",0%,412,27,439,217305000,416,41,457,226215000
1404850,Luck be a Landlord,2023,Roguelike,"₩11,000",0%,9928,702,10630,5846500000,0,0,0,0
1646790,Striving for Light,2025,Roguelike,"₩19,500",0%,86,18,104,101400000,109,35,144,140400000
2068280,Nordic Ashes: Survivors of Ragnarok,2024,Roguelike,"₩11,000",0%,5280,677,5957,3276350000,0,0,0,0
3223160,Apocalypse Express,2025,Roguelike,"₩11,000",0%,0,0,0,0,82,8,90,49500000
3238670,Conquest Dark,2025,Roguelike,"₩11,000",0%,1465,115,1580,869000000,1699,189,1888,1038400000
274520,Darkwood,2017,Roguelike,"₩16,500",0%,20529,1089,21618,17834850000,0,0,0,0
1915510,Yao-Guai Hunter,2025,Roguelike,"₩18,150",0%,1614,316,1930,1751475000,1520,311,1831,1661632500
3439320,Red or Blue,2025,Roguelike,"₩4,500",0%,75,4,79,17775000,88,6,94,21150000
2400160,Glyphica: Typing Survival,2024,Roguelike,"₩10,000",0%,1031,115,1146,573000000,1091,149,1240,620000000
1951230,Pizza Possum,2023,Roguelike,"₩3,510",55%,1624,112,1736,304668000,1380,104,1484,260442000
1534980,Terminus: Zombie Survivors,2024,Roguelike,"₩19,900",0%,3782,215,3997,3977015000,0,0,0,0
2531940,Stray Path,2025,Roguelike,"₩9,000",40%,536,184,720,324000000,492,191,683,307350000
656350,UnderMine,2020,Roguelike,"₩20,500",0%,8280,778,9058,9284450000,0,0,0,0
2289650,Mini Airways - ATC simulator,2024,Roguelike,"₩11,000",0%,1102,82,1184,651200000,1007,76,1083,595650000
2163330,Yet Another Zombie Survivors,2023,Roguelike,"₩16,500",0%,10169,1044,11213,9250725000,0,0,0,0
2464530,VOIN,2024,Roguelike,"₩19,500",0%,771,46,817,796575000,779,59,838,817050000
1253920,Rogue Legacy 2,2022,Roguelike,"₩27,000",0%,13143,1326,14469,19533150000,0,0,0,0
3011360,Primordialis,2025,Roguelike,"₩21,500",0%,0,0,0,0,232,15,247,265525000
998740,Ring of Pain,2020,Roguelike,"₩6,150",70%,4398,407,4805,1477537500,0,0,0,0
1490610,METALLIC CHILD,2021,Roguelike,"₩15,300",40%,1032,177,1209,924885000,930,177,1107,846855000
1097430,Book of Yog Idle RPG,2022,Roguelike,Free,0%,4733,2650,7383,0,0,0,0,0
293780,Crawl,2017,Roguelike,"₩16,500",0%,6673,366,7039,5807175000,0,0,0,0
2093910,Time Walker: Dark World,2023,Roguelike,"₩5,600",0%,1224,193,1417,396760000,1173,191,1364,381920000
2608350,Snezhinka:Sentinel Girls2,2024,Roguelike,"₩8,500",0%,1946,67,2013,855525000,0,0,0,0
2597080,Realm of Ink,2024,Roguelike,"₩18,500",0%,2653,201,2854,2639950000,0,0,0,0
2924580,Inkborn,2025,Roguelike,"₩21,500",0%,0,0,0,0,42,9,51,54825000
512900,Streets of Rogue,2019,Roguelike,"₩21,500",0%,21076,857,21933,23577975000,0,0,0,0
2501600,DICEOMANCER,2024,Roguelike,"₩16,500",0%,4567,129,4696,3874200000,0,0,0,0
2459550,Emberward,2024,Roguelike,"₩16,500",0%,2609,76,2685,2215125000,0,0,0,0
3191030,Nubby's Number Factory,2025,Roguelike,"₩5,600",0%,9206,227,9433,2641240000,0,0,0,0
3411020,Villages & Dungeons,2025,Roguelike,"₩7,800",0%,358,35,393,153270000,499,49,548,213720000
3470340,RogueCraft,2025,Roguelike,"₩11,000",0%,0,0,0,0,24,3,27,14850000
3399950,Your Mother,2025,Roguelike,"₩1,100",0%,3989,386,4375,240625000,0,0,0,0
873940,Crying Suns,2019,Roguelike,"₩7,800",70%,3664,603,4267,1664130000,0,0,0,0
3047370,Net.Attack(),2025,Roguelike,"₩8,010",9%,0,0,0,0,131,29,160,64080000
2296550,Axon TD: Uprising - Tower Defense,2024,Roguelike,"₩21,500",0%,572,72,644,692300000,530,79,609,654675000
981430,Gordian Quest,2022,Roguelike,"₩20,500",0%,5157,627,5784,5928600000,0,0,0,0
1519490,The Doors of Trithius,2021,Roguelike,"₩16,000",0%,489,17,506,404800000,600,38,638,510400000
1108370,Ratropolis,2020,Roguelike,"₩18,500",0%,4759,629,5388,4983900000,0,0,0,0
1990110,SpellRogue,2025,Roguelike,"₩21,500",0%,1081,154,1235,1327625000,1150,187,1337,1437275000
1494810,Mortal Sin,2023,Roguelike,"₩27,000",0%,3313,148,3461,4672350000,0,0,0,0
259680,Tales of Maj'Eyal,2016,Roguelike,"₩7,500",0%,6381,331,6712,2517000000,0,0,0,0
807120,Iratus: Lord of the Dead,2020,Roguelike,"₩34,000",0%,6694,1116,7810,13277000000,0,0,0,0
296710,Monstrum,2015,Roguelike,"₩19,000",0%,3161,318,3479,3305050000,0,0,0,0
278890,Angvik,2014,Roguelike,"₩3,400",0%,2194,309,2503,425510000,1851,229,2080,353600000
1891700,Tap Ninja - Idle game,2022,Roguelike,Free,0%,0,0,0,0,0,0,0,0
858210,Nova Drift,2024,Roguelike,"₩19,000",0%,13393,592,13985,13285750000,0,0,0,0
1123770,Curse of the Dead Gods,2021,Roguelike,"₩22,800",0%,7207,1357,8564,9762960000,0,0,0,0
1227280,Despot's Game: Dystopian Battle Simulator,2022,Roguelike,"₩22,000",0%,2689,497,3186,3504600000,0,0,0,0
2760790,Another Farm Roguelike: Rebirth,2025,Roguelike,"₩7,800",0%,0,0,0,0,216,92,308,120120000
2788310,Twilight Survivors,2024,Roguelike,"₩3,400",0%,806,90,896,152320000,825,102,927,157590000
1290750,Crawl Tactics,2022,Roguelike,"₩20,500",0%,133,9,142,145550000,130,11,141,144525000
3005620,Drop Pockets,2025,Roguelike,"₩16,500",0%,0,0,0,0,89,21,110,90750000
298630,The Escapists,2015,Roguelike,"₩19,000",0%,14481,1569,16050,15247500000,0,0,0,0
666570,Infectonator 3: Apocalypse,2018,Roguelike,"₩2,900",80%,943,193,1136,164720000,900,184,1084,157180000
2974620,SignaNota,2025,Roguelike,"₩11,000",0%,63,4,67,36850000,72,5,77,42350000
1668690,Alina of the Arena,2022,Roguelike,"₩15,500",0%,3404,318,3722,2884550000,0,0,0,0
3234700,Break Siege,2025,Roguelike,"₩16,500",0%,61,5,66,54450000,48,4,52,42900000
1755830,Astrea: Six-Sided Oracles,2023,Roguelike,"₩27,000",0%,3793,336,4129,5574150000,0,0,0,0
651670,Star Renegades,2020,Roguelike,"₩27,000",0%,2357,483,2840,3834000000,0,0,0,0
1125240,Ancient Dungeon,2021,Roguelike,"₩21,500",0%,1377,68,1445,1553375000,1321,70,1391,1495325000
3519530,Merge Maestro,2025,Roguelike,"₩3,400",0%,0,0,0,0,194,4,198,33660000
242680,Nuclear Throne,2015,Roguelike,"₩12,500",0%,17279,700,17979,11236875000,0,0,0,0
1232580,Knock on the Coffin Lid,2024,Roguelike,"₩26,000",0%,2186,382,2568,3338400000,0,0,0,0
2218400,Greedland,2023,Roguelike,"₩14,000",0%,2091,340,2431,1701700000,0,0,0,0
2088570,Tiny Rogues,2022,Roguelike,"₩10,500",0%,9445,310,9755,5121375000,0,0,0,0
3206200,Magic Rune Stone,2025,Roguelike,"₩11,000",0%,266,70,336,184800000,273,86,359,197450000
239350,Spelunky,2013,Roguelike,"₩16,000",0%,15005,1288,16293,13034400000,0,0,0,0
1543960,Squiggle Football,2025,Roguelike,"₩14,800",19%,0,0,0,0,70,2,72,53280000
2321350,StormEdge,2024,Roguelike,"₩6,600",60%,129,40,169,55770000,97,42,139,45870000
1479140,AK-xolotl: Together,2023,Roguelike,"₩20,500",0%,660,191,851,872275000,668,235,903,925575000
3040560,Elite Exorcist Miko,2024,Roguelike,"₩8,800",19%,59,4,63,27720000,66,4,70,30800000
3288300,Dark Fairy Tale: Dreamland Survivors,2025,Roguelike,"₩5,600",0%,0,0,0,0,212,29,241,67480000
861540,Dicey Dungeons,2019,Roguelike,"₩16,500",0%,9953,1161,11114,9169050000,0,0,0,0
1761380,Otherworld Legends 战魂铭人,2024,Roguelike,Free,0%,802,485,1287,0,852,501,1353,0
2643010,Becoming Saint,2025,Roguelike,"₩16,500",0%,0,0,0,0,78,23,101,83325000
1296660,Wartorn,2025,Roguelike,"₩32,000",0%,0,0,0,0,79,18,97,155200000
2113040,RUNGORE,2024,Roguelike,"₩16,500",0%,793,96,889,733425000,733,109,842,694650000
1296360,Archvale,2021,Roguelike,"₩7,750",50%,1992,250,2242,868775000,1705,232,1937,750587500
3553210,Auto Rogue,2025,Roguelike,"₩7,800",0%,318,21,339,132210000,489,43,532,207480000
1457080,The Mageseeker: A League of Legends Story™,2023,Roguelike,"₩32,000",0%,2126,394,2520,4032000000,0,0,0,0
382140,SKYHILL,2015,Roguelike,"₩12,000",0%,4047,1144,5191,3114600000,0,0,0,0
1275890,Baldi's Basics Plus,2020,Roguelike,"₩10,500",0%,7265,172,7437,3904425000,0,0,0,0
1724770,Castle Of Alchemists,2025,Roguelike,"₩16,500",0%,556,90,646,532950000,466,95,561,462825000
811320,Jupiter Hell,2021,Roguelike,"₩26,000",0%,1788,157,1945,2528500000,1532,152,1684,2189200000
1589570,Dunjungle,2024,Roguelike,"₩12,800",0%,598,12,610,390400000,573,18,591,378240000
757320,Atomicrops,2020,Roguelike,"₩16,500",0%,5218,442,5660,4669500000,0,0,0,0
811320,Jupiter Hell,2021,Roguelike,"₩26,000",0%,1788,157,1945,2528500000,1532,152,1684,2189200000
3339780,Desktop Survivors 98,2025,Roguelike,"₩5,600",0%,554,28,582,162960000,855,45,900,252000000
2868860,Card Survival: Fantasy Forest,2025,Roguelike,"₩19,500",0%,647,246,893,870675000,641,262,903,880425000
317820,Guild of Dungeoneering Ultimate Edition,2015,Roguelike,"₩20,500",0%,1979,591,2570,2634250000,1304,412,1716,1758900000
1056490,The World is Your Weapon,2019,Roguelike,"₩10,500",0%,630,19,649,340725000,595,18,613,321825000
3435260,Dice With Death,2025,Roguelike,"₩15,500",0%,101,9,110,85250000,276,27,303,234825000
1842730,Nightmare: The Lunatic,2024,Roguelike,"₩18,500",0%,216,27,243,224775000,175,28,203,187775000
3385370,Maze Mice,2025,Roguelike,"₩11,000",0%,67,2,69,37950000,199,22,221,121550000
2870430,Godslayer Arena,2025,Roguelike,"₩16,500",0%,0,0,0,0,131,39,170,140250000
1199030,Tainted Grail: Conquest,2021,Roguelike,"₩20,500",0%,6875,726,7601,7791025000,0,0,0,0
2726870,Loopstructor,2024,Roguelike,"₩5,600",0%,291,57,348,97440000,255,60,315,88200000
2464880,Terracards,2023,Roguelike,"₩9,900",0%,595,101,696,344520000,586,103,689,341055000
2689470,CRUEL,2025,Roguelike,"₩11,000",0%,975,48,1023,562650000,1065,56,1121,616550000
1842320,Slayer : the Demon Haunted World,2025,Roguelike,"₩19,500",0%,21,3,24,23400000,10,3,13,12675000
2797650,Pip My Dice,2025,Roguelike,"₩12,500",0%,0,0,0,0,67,4,71,44375000
2917350,Spin Hero,2024,Roguelike,"₩8,900",0%,421,113,534,237630000,383,121,504,224280000
2881660,Holy Shoot,2025,Roguelike,"₩18,990",0%,0,0,0,0,60,12,72,68364000
2097230,Turnip Boy Robs a Bank,2024,Roguelike,"₩16,500",0%,1800,79,1879,1550175000,1601,84,1685,1390125000
3876470,Deep Line,2025,Roguelike,"₩3,600",19%,0,0,0,0,9,1,10,1800000
1016600,Devil Slayer - Raksasi,2021,Roguelike,"₩15,500",0%,2397,424,2821,2186275000,0,0,0,0
2862890,Become the Moon,2025,Roguelike,"₩18,500",0%,0,0,0,0,109,32,141,130425000
3066570,Aotenjo: Infinite Hands,2025,Roguelike,"₩11,000",0%,737,111,848,466400000,682,111,793,436150000
603960,Star of Providence,2017,Roguelike,"₩16,000",0%,2783,94,2877,2301600000,0,0,0,0
858260,Until You Fall,2020,Roguelike,"₩27,000",0%,3039,185,3224,4352400000,0,0,0,0
2715370,Ancient Cultivatrix,2025,Roguelike,"₩15,340",0%,287,96,383,293761000,164,71,235,180245000
304650,SUNLESS SEA,2015,Roguelike,"₩20,000",0%,7715,1573,9288,9288000000,0,0,0,0
931500,Touhou Genso Wanderer -Reloaded-,2018,Roguelike,"₩29,000",0%,1684,120,1804,2615800000,1586,119,1705,2472250000
3140120,Wordatro!,2025,Roguelike,"₩11,370",0%,0,0,0,0,197,38,235,133597500
3546240,Cirno's Card Class,2025,Roguelike,"₩4,500",0%,26,2,28,6300000,29,2,31,6975000
940710,Colt Canyon,2020,Roguelike,"₩16,500",0%,1497,195,1692,1395900000,1202,133,1335,1101375000
252610,Death Road to Canada,2016,Roguelike,"₩15,500",0%,8712,673,9385,7273375000,0,0,0,0
528230,SYNTHETIK: Legion Rising,2018,Roguelike,"₩20,500",0%,11971,746,12717,13034925000,0,0,0,0
1803400,Beneath Oresa,2023,Roguelike,"₩27,000",0%,1116,321,1437,1939950000,783,221,1004,1355400000
2128270,Path of Achra,2024,Roguelike,"₩7,700",30%,2537,41,2578,992530000,0,0,0,0
249050,Dungeon of the ENDLESS™,2014,Roguelike,"₩13,000",0%,11749,1985,13734,8927100000,0,0,0,0
1332340,DISORDER,2025,Roguelike,"₩28,320",19%,46,55,101,143016000,55,58,113,160008000
2009860,Tower Escape,2023,Roguelike,"₩8,900",0%,322,68,390,173550000,283,58,341,151745000
2499520,Be My Horde,2024,Roguelike,"₩5,000",0%,1026,135,1161,290250000,1186,193,1379,344750000
241600,Rogue Legacy,2013,Roguelike,"₩16,500",0%,17124,1353,18477,15243525000,0,0,0,0
2058570,Rift Wizard 2,2025,Roguelike,"₩21,500",0%,486,46,532,571900000,539,53,592,636400000
1925860,Seonbi : Scholar of Joseon,2023,Roguelike,"₩1,920",75%,28,5,33,3168000,23,5,28,2688000
537800,Bomber Crew,2017,Roguelike,"₩16,500",0%,12925,1812,14737,12158025000,0,0,0,0
769560,月圆之夜 (Night of Full Moon),2019,Roguelike,Free,0%,8648,1784,10432,0,0,0,0,0
2494810,Dark Hunting Ground,2024,Roguelike,"₩14,000",0%,366,18,384,268800000,375,24,399,279300000
3205380,Omelet You Cook,2025,Roguelike,"₩11,000",0%,0,0,0,0,358,0,358,196900000
2129810,Reignbreaker,2025,Roguelike,"₩10,000",0%,253,47,300,150000000,243,68,311,155500000
1135810,Vault of the Void,2022,Roguelike,"₩18,500",0%,2538,196,2734,2528950000,0,0,0,0
248820,Risk of Rain (2013),2013,Roguelike,"₩10,500",0%,27648,1978,29626,15553650000,0,0,0,0
1804270,Swordship,2022,Roguelike,"₩21,500",0%,111,10,121,130075000,144,21,165,177375000
2099220,Mobmania,2025,Roguelike,"₩5,500",0%,329,45,374,102850000,303,49,352,96800000
1734320,Brutal Orchestra,2021,Roguelike,"₩20,500",0%,1764,36,1800,1845000000,1637,33,1670,1711750000
3667230,The Deadseat,2025,Roguelike,"₩3,400",0%,225,5,230,39100000,396,12,408,69360000
1579880,The Light Brigade,2023,Roguelike,"₩27,000",0%,973,114,1087,1467450000,894,110,1004,1355400000
456670,Hand of Fate 2,2017,Roguelike,"₩31,000",0%,4795,885,5680,8804000000,0,0,0,0
2202010,Neon Ascending,2025,Roguelike,"₩3,370",25%,49,6,55,9267500,54,10,64,10784000
809540,Mechs V Kaijus - Tower Defense,2022,Roguelike,"₩10,120",25%,420,83,503,254518000,394,87,481,243386000
1037020,ScourgeBringer,2020,Roguelike,"₩17,500",0%,2614,381,2995,2620625000,0,0,0,0
2827780,Summonsters,2024,Roguelike,"₩3,400",0%,129,42,171,29070000,133,42,175,29750000
2789810,Bingle Bingle,2024,Roguelike,"₩12,500",0%,379,67,446,278750000,368,75,443,276875000
98800,Dungeons of Dredmor,2011,Roguelike,"₩8,900",0%,4978,323,5301,2358945000,0,0,0,0
266510,Hand of Fate,2015,Roguelike,"₩21,000",0%,9433,1126,10559,11086950000,0,0,0,0
2289390,Crab God,2024,Roguelike,"₩21,500",0%,190,31,221,237575000,176,36,212,227900000
798490,Othercide,2020,Roguelike,"₩34,800",0%,3966,853,4819,8385060000,0,0,0,0
2853160,SHOOPER NOVA,2025,Roguelike,"₩7,000",0%,307,72,379,132650000,290,73,363,127050000
525620,Octogeddon,2018,Roguelike,"₩9,490",0%,1048,93,1141,541404500,1030,90,1120,531440000
2332210,Born Again,2023,Roguelike,Free,0%,0,0,0,0,769,158,927,0
1711610,Dungeon 100,2023,Roguelike,"₩13,500",0%,1313,274,1587,1071225000,1252,275,1527,1030725000
1421290,Battle Shapers,2024,Roguelike,"₩27,000",0%,696,143,839,1132650000,650,152,802,1082700000
535480,Sundered®: Eldritch Edition,2017,Roguelike,"₩21,500",0%,4067,890,4957,5328775000,0,0,0,0
3064290,Trizon,2025,Roguelike,"₩9,900",0%,350,27,377,186615000,397,34,431,213345000
787810,Rogue Heroes: Ruins of Tasos,2021,Roguelike,"₩20,500",0%,2708,746,3454,3540350000,0,0,0,0
3057190,LOOTPLOT,2025,Roguelike,"₩7,800",0%,60,2,62,24180000,126,7,133,51870000
2305500,FAIRY TAIL: DUNGEONS,2024,Roguelike,"₩15,500",0%,529,42,571,442525000,519,45,564,437100000
698640,Deep Sky Derelicts,2018,Roguelike,"₩3,220",85%,2027,688,2715,437115000,1378,509,1887,303807000
1040420,Dreamscaper,2021,Roguelike,"₩27,000",0%,2670,358,3028,4087800000,0,0,0,0
3021630,Savara,2025,Roguelike,"₩21,500",0%,311,30,341,366575000,378,47,425,456875000
2435090,Talented,2024,Roguelike,"₩4,500",0%,1081,94,1175,264375000,1106,96,1202,270450000
1870300,SOVL: Fantasy Warfare,2023,Roguelike,Free,0%,0,0,0,0,0,0,0,0
2958790,Cyclopean: The Great Abyss,2025,Roguelike,"₩11,000",0%,39,1,40,22000000,71,7,78,42900000
396750,EVERSPACE™,2017,Roguelike,"₩21,900",0%,8668,2352,11020,12066900000,0,0,0,0
596970,Sunless Skies: Sovereign Edition,2019,Roguelike,"₩27,000",0%,2806,514,3320,4482000000,0,0,0,0
248860,NEO Scavenger,2014,Roguelike,"₩16,500",0%,4693,536,5229,4313925000,0,0,0,0
732370,Juicy Realm,2018,Roguelike,"₩10,500",0%,3177,443,3620,1900500000,0,0,0,0
2800840,Gunbot Diplomacy,2025,Roguelike,"₩4,900",0%,121,17,138,33810000,123,18,141,34545000
2455060,Taboo Trial,2023,Roguelike,"₩16,000",0%,1368,252,1620,1296000000,1337,255,1592,1273600000
2761610,Creator of Another World,2024,Roguelike,"₩20,500",0%,189,30,219,224475000,199,32,231,236775000
2481670,Dino Path Trail,2025,Roguelike,"₩16,500",0%,120,19,139,114675000,113,21,134,110550000
2598800,Psionic Sentry : Infinite,2025,Roguelike,"₩5,000",0%,124,14,138,34500000,139,17,156,39000000
1938850,Temp Zero,2022,Roguelike,"₩2,750",50%,154,9,163,22412500,138,10,148,20350000
770100,One Deck Dungeon,2018,Roguelike,"₩11,000",0%,665,158,823,452650000,594,139,733,403150000
1184760,Shovel Knight Pocket Dungeon,2021,Roguelike,"₩20,500",0%,460,45,505,517625000,435,43,478,489950000
2523890,Whispers of the Eyeless,2025,Roguelike,"₩21,500",0%,96,15,111,119325000,84,20,104,111800000
2147530,Raining Blood: Hellfire,2025,Roguelike,"₩8,900",0%,92,5,97,43165000,141,9,150,66750000
3868720,Doomfields,2025,Roguelike,"₩16,500",0%,0,0,0,0,31,7,38,31350000
1454010,Diary of Lucie,2023,Roguelike,"₩14,500",0%,385,52,437,316825000,361,54,415,300875000
1367300,Blade Assault,2022,Roguelike,"₩19,000",0%,1680,558,2238,2126100000,1344,448,1792,1702400000
1895860,Monster Girls and the Mysterious Adventure 2,2022,Roguelike,"₩26,000",0%,271,30,301,391300000,271,34,305,396500000
2096510,The Ouroboros King,2023,Roguelike,"₩11,000",0%,372,75,447,245850000,329,67,396,217800000
1299620,Fabled Lands,2022,Roguelike,"₩8,200",60%,393,94,487,199670000,379,95,474,194340000
1911360,Trinity Fusion,2023,Roguelike,"₩21,500",0%,644,87,731,785825000,516,77,593,637475000
1299620,Fabled Lands,2022,Roguelike,"₩8,200",60%,393,94,487,199670000,379,95,474,194340000
1812060,Yokai Art: Night Parade of One Hundred Demons,2022,Roguelike,"₩7,800",0%,963,101,1064,414960000,935,104,1039,405210000
3167970,Starless Abyss,2025,Roguelike,"₩21,000",0%,201,31,232,243600000,175,33,208,218400000
1606340,Conquest of Elysium 5,2021,Roguelike,"₩32,000",0%,955,110,1065,1704000000,947,117,1064,1702400000
314410,Rampage Knights,2015,Roguelike,"₩14,500",0%,3298,260,3558,2579550000,0,0,0,0
2102320,MISTROGUE: Mist and the Living Dungeons,2023,Roguelike,"₩4,350",70%,142,63,205,44587500,120,64,184,40020000
3427090,Refence,2025,Roguelike,"₩6,700",0%,67,11,78,26130000,80,17,97,32495000
984110,SYNTHETIK: Arena,2019,Roguelike,Free,0%,2099,223,2322,0,0,0,0,0
288120,Dungeonmans,2014,Roguelike,"₩16,000",0%,1064,102,1166,932800000,938,104,1042,833600000
3090570,Time for Bed,2025,Roguelike,"₩6,200",0%,0,0,0,0,43,1,44,13640000
2348090,Crop Rotation,2023,Roguelike,"₩11,000",0%,448,29,477,262350000,457,29,486,267300000
1260590,Hadean Tactics,2023,Roguelike,"₩21,500",0%,1574,182,1756,1887700000,1442,178,1620,1741500000
234390,Teleglitch: Die More Edition,2013,Roguelike,"₩15,000",0%,2434,435,2869,2151750000,869,118,987,740250000
699920,Despotism 3k,2018,Roguelike,"₩8,500",0%,2862,817,3679,1563575000,783,184,967,410975000
1046300,Pirates Outlaws,2020,Roguelike,"₩21,000",0%,585,116,701,736050000,523,115,638,669900000
1491200,Few Nights More,2025,Roguelike,"₩9,500",0%,298,56,354,168150000,280,57,337,160075000
2118370,Bosorka,2023,Roguelike,"₩1,670",75%,355,51,406,33901000,312,39,351,29308500
362490,Exanima,2015,Roguelike,"₩15,000",0%,10132,2214,12346,9259500000,0,0,0,0
1944570,Boneraiser Minions,2023,Roguelike,"₩5,600",0%,4941,185,5126,1435280000,0,0,0,0
1390700,The Crackpet Show,2022,Roguelike,"₩18,500",0%,673,89,762,704850000,560,84,644,595700000
349730,Popup Dungeon,2020,Roguelike,"₩10,400",60%,772,248,1020,530400000,478,119,597,310440000
2536960,Shadowveil: Legend of The Five Rings,2025,Roguelike,"₩27,000",0%,301,95,396,534600000,304,101,405,546750000
615120,COMPOUND,2022,Roguelike,"₩21,000",0%,2013,63,2076,2179800000,0,0,0,0
1416050,Shovel Knight Dig,2022,Roguelike,"₩26,000",0%,594,211,805,1046500000,554,195,749,973700000
615120,COMPOUND,2022,Roguelike,"₩21,000",0%,2013,63,2076,2179800000,0,0,0,0
2856370,Into the Emberlands,2025,Roguelike,"₩7,800",0%,166,23,189,73710000,136,22,158,61620000
1271280,Rift Wizard,2021,Roguelike,"₩15,500",0%,945,75,1020,790500000,899,78,977,757175000
333300,ADOM (Ancient Domains Of Mystery),2015,Roguelike,"₩16,000",0%,1297,233,1530,1224000000,1043,156,1199,959200000
1493520,Beat Hazard 3,2024,Roguelike,"₩21,500",0%,511,96,607,652525000,446,79,525,564375000
3343940,Spin Forward,2025,Roguelike,"₩5,880",0%,0,0,0,0,20,3,23,6762000
887450,Tunche,2021,Roguelike,"₩5,120",75%,539,197,736,188416000,442,155,597,152832000
3442280,Phantomancer,2025,Roguelike,"₩13,500",0%,80,4,84,56700000,79,8,87,58725000
1073320,Meteorfall: Krumit's Tale,2020,Roguelike,"₩15,500",0%,763,80,843,653325000,657,73,730,565750000
2455920,Mimic Logic,2024,Roguelike,"₩4,500",0%,440,7,447,100575000,457,9,466,104850000
360740,Downwell,2015,Roguelike,"₩3,400",0%,7921,279,8200,1394000000,0,0,0,0
2258890,Xanadu Land,2025,Roguelike,Free,0%,0,0,0,0,596,140,736,0
1220010,Home Behind 2,2022,Roguelike,"₩20,500",0%,6072,892,6964,7138100000,0,0,0,0
3232040,BodyRecords,2025,Roguelike,"₩3,900",50%,187,135,322,62790000,222,115,337,65715000
2118250,Kitchen Crisis,2024,Roguelike,"₩16,500",0%,240,76,316,260700000,229,76,305,251625000
1709900,Tower Tactics: Liberation,2023,Roguelike,"₩13,500",0%,1007,119,1126,760050000,990,122,1112,750600000
379210,Wayward,2016,Roguelike,"₩8,900",0%,1124,181,1305,580725000,1003,163,1166,518870000
2175450,Rhythm Stones,2022,Roguelike,"₩9,900",0%,19,6,25,12375000,19,6,25,12375000
2082410,Anomaly Collapse,2024,Roguelike,"₩21,500",0%,501,84,585,628875000,456,80,536,576200000
264160,WazHack,2014,Roguelike,"₩10,500",0%,632,74,706,370650000,498,68,566,297150000
1059980,Just King,2023,Roguelike,"₩5,600",0%,1310,139,1449,405720000,1203,134,1337,374360000
2881800,SuperTaxCity,2025,Roguelike,"₩11,000",0%,128,13,141,77550000,115,11,126,69300000
1441840,FALL IN LABYRINTH,2021,Roguelike,"₩20,500",0%,950,49,999,1023975000,927,59,986,1010650000
841600,Aura of Worlds,2024,Roguelike,"₩16,500",0%,96,7,103,84975000,71,5,76,62700000
2514910,KKCKC,2024,Roguelike,"₩11,900",0%,28,2,30,17850000,13,1,14,8330000
1167680,Orbital Bullet – The 360° Rogue-lite,2022,Roguelike,"₩17,500",0%,596,97,693,606375000,432,88,520,455000000
588950,Kingsway,2017,Roguelike,"₩10,500",0%,1518,128,1646,864150000,1324,115,1439,755475000
378030,Cardinal Quest 2,2015,Roguelike,"₩5,500",0%,109,11,120,33000000,96,11,107,29425000
790060,The Void Rains Upon Her Heart,2018,Roguelike,"₩13,500",0%,1645,13,1658,1119150000,1346,27,1373,926775000
1245540,Touhou Endless Dream,2021,Roguelike,"₩8,500",0%,1746,108,1854,787950000,1563,118,1681,714425000
365900,Pixel Dungeon,2015,Roguelike,"₩5,500",0%,387,45,432,118800000,367,45,412,113300000
1929870,Nomad Survival,2022,Roguelike,"₩5,600",0%,1745,314,2059,576520000,1310,196,1506,421680000
265990,Rogue's Tale,2014,Roguelike,"₩7,800",0%,517,201,718,280020000,450,167,617,240630000
224820,Super House of Dead Ninjas,2013,Roguelike,"₩7,500",0%,1629,70,1699,637125000,1394,58,1452,544500000
1422410,Into the Pit,2021,Roguelike,"₩4,650",70%,166,83,249,57892500,92,42,134,31155000
268750,Magicite,2014,Roguelike,"₩11,000",0%,6459,1120,7579,4168450000,0,0,0,0
3777060,Gold Miner:Classic Edition,2025,Roguelike,"₩4,500",0%,0,0,0,0,124,24,148,33300000
2100150,Shadow of the Depth,2025,Roguelike,"₩16,500",0%,325,129,454,374550000,307,126,433,357225000
1641240,Hero's Quest,2023,Roguelike,"₩4,500",0%,164,32,196,44100000,145,32,177,39825000
2946260,Poker Dungeon : Joker's Madness,2024,Roguelike,"₩9,900",0%,24,3,27,13365000,18,3,21,10395000
956450,Rogue Fable III,2021,Roguelike,"₩10,500",0%,663,47,710,372750000,648,49,697,365925000
1334500,RP7: Spin Your Own Encounter,2024,Roguelike,"₩18,000",0%,74,14,88,79200000,38,14,52,46800000
264690,Coin Crypt,2014,Roguelike,"₩10,500",0%,516,84,600,315000000,180,18,198,103950000
655380,Dig Dog,2018,Roguelike,₩900,80%,60,19,79,3555000,50,16,66,2970000
1129310,Receiver 2,2020,Roguelike,"₩21,500",0%,2483,243,2726,2930450000,0,0,0,0
3297050,GABANG: ULTIMATE,2025,Roguelike,"₩11,000",0%,53,5,58,31900000,53,5,58,31900000
1600910,Demon's Mirror,2024,Roguelike,"₩21,500",0%,83,12,95,102125000,69,11,80,86000000
1323470,GetsuFumaDen: Undying Moon,2022,Roguelike,"₩26,500",0%,838,253,1091,1445575000,0,0,0,0
2688680,Girls of The Tower,2024,Roguelike,"₩7,800",0%,494,81,575,224250000,466,82,548,213720000
1256060,Cosmodread,2021,Roguelike,"₩15,500",0%,372,33,405,313875000,347,30,377,292175000
1256060,Cosmodread,2021,Roguelike,"₩15,500",0%,372,33,405,313875000,347,30,377,292175000
2688680,Girls of The Tower,2024,Roguelike,"₩7,800",0%,494,81,575,224250000,466,82,548,213720000
1815230,Summum Aeterna,2023,Roguelike,"₩21,500",0%,313,51,364,391300000,252,41,293,314975000
1903560,Atomic Picnic,2024,Roguelike,"₩21,500",0%,345,132,477,512775000,279,119,398,427850000
1054550,Phantom Rose,2019,Roguelike,"₩15,000",0%,666,188,854,640500000,600,179,779,584250000
2251010,The Witch's Cauldron,2024,Roguelike,"₩8,900",0%,541,45,586,260770000,494,49,543,241635000
234190,Receiver,2013,Roguelike,"₩5,600",0%,3302,839,4141,1159480000,0,0,0,0
1865930,Space Prison,2024,Roguelike,"₩21,500",0%,182,30,212,227900000,179,34,213,228975000
2510760,Gods Wars : infinity Epic,2024,Roguelike,"₩11,000",0%,83,17,100,55000000,52,12,64,35200000
1314770,Three Kingdom: The Journey,2023,Roguelike,"₩13,500",0%,189,33,222,149850000,156,32,188,126900000
2186580,Shuffle Tactics,2025,Roguelike,"₩13,200",19%,0,0,0,0,46,21,67,44220000
915230,Zombie Rollerz: Pinball Heroes,2022,Roguelike,"₩17,000",0%,312,54,366,311100000,241,42,283,240550000
3031590,13F,2024,Roguelike,"₩4,500",0%,88,4,92,20700000,84,4,88,19800000
2644230,Critter Crossfire,2025,Roguelike,"₩16,500",0%,0,0,0,0,23,1,24,19800000
1245430,Golden Light,2022,Roguelike,"₩21,900",0%,2994,492,3486,3817170000,1737,172,1909,2090355000
2597020,Coreless,2025,Roguelike,"₩8,900",0%,0,0,0,0,17,4,21,9345000
1037130,Dandy Ace,2021,Roguelike,"₩20,500",0%,1079,143,1222,1252550000,873,130,1003,1028075000
659540,Warsim: The Realm of Aslona,2022,Roguelike,"₩10,000",0%,1916,82,1998,999000000,1764,74,1838,919000000
2311990,Rack and Slay,2024,Roguelike,"₩6,700",0%,436,36,472,158120000,425,42,467,156445000
1256530,Sentimental K,2022,Roguelike,"₩23,800",0%,294,60,354,421260000,263,58,321,381990000
1766010,Force Reboot,2022,Roguelike,"₩3,400",0%,585,29,614,104380000,558,29,587,99790000
328080,Rise to Ruins,2019,Roguelike,"₩16,500",0%,6737,915,7652,6312900000,0,0,0,0
2552680,Rogue Samurai,2024,Roguelike,"₩5,600",0%,30,19,49,13720000,27,19,46,12880000
1184820,Poker Quest: Swords and Spades,2022,Roguelike,"₩16,500",0%,590,88,678,559350000,563,92,655,540375000
3669690,Noir Lords,2025,Roguelike,"₩9,900",0%,0,0,0,0,15,0,15,7425000
2581750,W.A.N.D. Project,2024,Roguelike,"₩12,900",0%,141,50,191,123195000,98,48,146,94170000
1098610,Crush the Industry,2025,Roguelike,"₩16,500",0%,233,17,250,206250000,210,18,228,188100000
3549210,NOVEMS,2025,Roguelike,"₩11,000",0%,0,0,0,0,27,6,33,18150000
3008240,How We Die,2024,Roguelike,"₩15,500",0%,18,3,21,16275000,12,3,15,11625000
1766390,FORWARD: Escape the Fold - Ultimate Edition,2022,Roguelike,"₩10,500",0%,552,91,643,337575000,506,89,595,312375000
252630,Eldritch,2013,Roguelike,"₩15,000",0%,1932,268,2200,1650000000,1482,202,1684,1263000000
339400,Runestone Keeper,2015,Roguelike,"₩10,500",0%,2071,379,2450,1286250000,564,124,688,361200000
1359120,The Dungeon Beneath,2020,Roguelike,"₩16,500",0%,748,95,843,695475000,626,85,711,586575000
1674890,👑 Idle Calibur 👑（选王之剑）,2022,Roguelike,"₩8,500",0%,1124,172,1296,550800000,1055,172,1227,521475000
2811200,Machick,2024,Roguelike,"₩5,000",0%,158,21,179,44750000,145,22,167,41750000
2460660,A Dark Room ®,2023,Roguelike,"₩7,800",0%,38,4,42,16380000,43,5,48,18720000
1394130,Breach Wanderers,2023,Roguelike,"₩15,500",0%,353,43,396,306900000,311,42,353,273575000
3538820,Galactic Simulator2: Stargate,2025,Roguelike,"₩6,700",0%,0,0,0,0,12,3,15,5025000
3471350,Alpha League HD,2025,Roguelike,Free,0%,0,0,0,0,800,99,899,0
2488510,FatalZone,2024,Roguelike,"₩7,800",0%,1531,695,2226,868140000,0,0,0,0
1709050,Nitro Kid,2022,Roguelike,"₩21,500",0%,430,54,484,520300000,332,41,373,400975000
2508890,Etaine: Magic Survivor / 伊泰恩：魔法幸存者,2024,Roguelike,"₩3,950",0%,204,25,229,45227500,178,27,205,40487500
856570,Lost Flame,2019,Roguelike,"₩15,500",0%,82,2,84,65100000,76,2,78,60450000
2591360,Witch & Bun Cats,2025,Roguelike,"₩8,000",0%,0,0,0,0,43,11,54,21600000
1640630,Heading Out,2024,Roguelike,"₩22,000",0%,444,128,572,629200000,409,129,538,591800000
2191770,Gregory Horror Show: Soul of Roses,2024,Roguelike,"₩18,500",0%,116,1,117,108225000,53,0,53,49025000
238910,Bionic Dues,2013,Roguelike,"₩11,000",0%,743,244,987,542850000,243,50,293,161150000
711810,Never Split the Party,2019,Roguelike,Free,0%,3326,1029,4355,0,0,0,0,0
401710,Flinthook,2017,Roguelike,"₩6,400",60%,612,216,828,264960000,430,159,589,188480000
293740,Road Not Taken,2014,Roguelike,"₩16,500",0%,280,67,347,286275000,195,49,244,201300000
2074480,Sunset Routes,2022,Roguelike,"₩1,100",0%,474,21,495,27225000,457,24,481,26455000
2459180,Praise Dead,2023,Roguelike,"₩8,900",0%,77,21,98,43610000,74,19,93,41385000
1660290,Monmusu Gladiator,2021,Roguelike,"₩5,600",0%,167,8,175,49000000,161,10,171,47880000
3308920,Depths of Endor: Dungeon Crawler,2024,Roguelike,"₩8,900",0%,14,1,15,6675000,13,1,14,6230000
1717090,Into the Necrovale,2024,Roguelike,"₩16,500",0%,483,67,550,453750000,454,74,528,435600000
2089830,Beat Slayer,2024,Roguelike,"₩12,900",40%,106,6,112,72240000,65,6,71,45795000
598060,Slasher's Keep,2020,Roguelike,"₩14,500",0%,1791,355,2146,1555850000,1649,338,1987,1440575000
1079230,Himno - The Silent Melody,2021,Roguelike,"₩13,500",0%,270,62,332,224100000,220,52,272,183600000
2286450,Striving for Light: Survival,2023,Roguelike,"₩5,600",0%,125,33,158,44240000,92,33,125,35000000
2125420,Zorbus,2022,Roguelike,"₩5,600",0%,285,28,313,87640000,288,28,316,88480000
493080,Card Quest,2017,Roguelike,"₩10,500",0%,307,51,358,187950000,275,41,316,165900000
2633080,Struggle F.O,2024,Roguelike,"₩9,900",0%,158,72,230,113850000,157,77,234,115830000
1316800,Destropolis,2020,Roguelike,"₩6,500",0%,221,32,253,82225000,200,25,225,73125000
861250,Cyber Shadow,2021,Roguelike,"₩19,800",0%,1182,228,1410,1395900000,986,202,1188,1176120000
322110,20XX,2017,Roguelike,"₩16,000",0%,4021,377,4398,3518400000,0,0,0,0
1234940,Astronarch,2021,Roguelike,"₩15,500",0%,982,115,1097,850175000,726,81,807,625425000
779590,Scavenger SV-4,2018,Roguelike,"₩7,750",50%,493,46,539,208862500,495,49,544,210800000
1176710,Space Crew: Legendary Edition,2020,Roguelike,"₩16,500",0%,2192,723,2915,2404875000,1243,351,1594,1315050000
3449690,Malys,2025,Roguelike,"₩11,000",0%,0,0,0,0,74,0,74,40700000
1643180,Artist Life Simulator,2022,Roguelike,"₩20,500",0%,147,29,176,180400000,128,28,156,159900000
2666230,Dog And Goblin,2024,Roguelike,"₩8,900",0%,120,34,154,68530000,101,36,137,60965000
2206240,Footgun: Underground,2024,Roguelike,"₩16,500",0%,101,13,114,94050000,81,13,94,77550000
497800,Golden Krone Hotel,2017,Roguelike,"₩10,500",0%,298,14,312,163800000,281,15,296,155400000
3292980,Hacky,2024,Roguelike,"₩5,600",0%,71,7,78,21840000,71,6,77,21560000
1260810,Touhou Blooming Chaos 2,2021,Roguelike,"₩6,160",19%,2364,178,2542,782936000,0,0,0,0
2286790,Helmetman,2023,Roguelike,"₩21,500",0%,114,24,138,148350000,110,24,134,144050000
1365010,Lost Potato,2020,Roguelike,"₩3,400",0%,192,8,200,34000000,180,11,191,32470000
1127610,Iris and the Giant,2020,Roguelike,"₩18,500",0%,1105,141,1246,1152550000,582,79,661,611425000
1260810,Touhou Blooming Chaos 2,2021,Roguelike,"₩6,160",19%,2364,178,2542,782936000,0,0,0,0
296970,Renowned Explorers: International Society,2015,Roguelike,"₩21,000",0%,2609,238,2847,2989350000,0,0,0,0
2648990,Nerd Survivors,2024,Roguelike,"₩2,240",60%,68,8,76,8512000,65,7,72,8064000
946610,Pocket Rogues,2018,Roguelike,"₩11,000",0%,433,54,487,267850000,418,52,470,258500000
2577850,Seekers of Eclipse,2025,Roguelike,"₩12,500",0%,5,1,6,3750000,16,2,18,11250000
2992190,Blue Hunter,2025,Roguelike,"₩16,500",0%,30,3,33,27225000,21,3,24,19800000
2340510,Moon's Creed,2025,Roguelike,"₩13,500",0%,73,10,83,56025000,56,14,70,47250000
2144460,Path to purge,2024,Roguelike,"₩6,700",0%,125,18,143,47905000,93,19,112,37520000
2097030,Union of Gnomes,2025,Roguelike,"₩16,500",0%,265,36,301,248325000,207,46,253,208725000
606230,Thea 2: The Shattering,2019,Roguelike,"₩26,000",0%,1707,484,2191,2848300000,1456,387,1843,2395900000
1000760,Foregone,2021,Roguelike,"₩20,500",0%,1102,248,1350,1383750000,1042,244,1286,1318150000
1058430,A Legionary's Life,2019,Roguelike,"₩8,500",0%,2063,308,2371,1007675000,0,0,0,0
2516820,LuckLand,2023,Roguelike,"₩9,900",0%,423,22,445,220275000,390,21,411,203445000
1078200,Spirits Abyss,2020,Roguelike,"₩9,900",0%,388,15,403,199485000,377,20,397,196515000
2569170,Widow in the Endless Labyrinth,2023,Roguelike,"₩16,500",0%,95,28,123,101475000,94,28,122,100650000
357330,Space Beast Terror Fright,2022,Roguelike,"₩16,000",0%,1567,146,1713,1370400000,1098,109,1207,965600000
2332260,Feed the Deep,2024,Roguelike,"₩3,900",50%,403,42,445,86775000,391,43,434,84630000
1385100,Insurmountable,2021,Roguelike,"₩27,000",0%,696,179,875,1181250000,594,168,762,1028700000
2083240,Asterogues,2024,Roguelike,"₩16,000",0%,91,8,99,79200000,75,8,83,66400000
2280060,Tenebris: Terra Incognita,2024,Roguelike,"₩21,500",0%,156,16,172,184900000,140,19,159,170925000
2731640,QUESTER | OSAKA,2024,Roguelike,"₩21,500",0%,42,9,51,54825000,39,9,48,51600000
1193590,Abomi Nation,2021,Roguelike,"₩4,120",75%,106,19,125,25750000,93,18,111,22866000
2731640,QUESTER | OSAKA,2024,Roguelike,"₩21,500",0%,42,9,51,54825000,39,9,48,51600000
1193590,Abomi Nation,2021,Roguelike,"₩4,120",75%,106,19,125,25750000,93,18,111,22866000
968760,Blood Card 2: Dark Mist,2021,Roguelike,"₩15,500",0%,245,39,284,220100000,230,41,271,210025000
1198400,Rhythm Fighter,2020,Roguelike,"₩15,500",0%,356,81,437,338675000,302,76,378,292950000
574090,MOTHERGUNSHIP,2018,Roguelike,"₩28,000",0%,1185,372,1557,2179800000,823,232,1055,1477000000
3156010,Minesweeper & Dungeon RPG - 扫雷与地下城,2024,Roguelike,"₩3,400",0%,20,4,24,4080000,21,5,26,4420000
1677090,Godless,2024,Roguelike,"₩11,000",0%,86,8,94,51700000,68,8,76,41800000
3151420,Mystic Explorer,2025,Roguelike,"₩5,600",0%,0,0,0,0,22,2,24,6720000
1668290,Dungeons of Aether,2023,Roguelike,"₩16,500",0%,494,110,604,498300000,463,109,572,471900000
1919750,Ponchoman,2022,Roguelike,"₩1,100",0%,107,1,108,5940000,106,1,107,5885000
619280,Gloom,2017,Roguelike,"₩10,500",0%,498,99,597,313425000,426,87,513,269325000
555630,A Magical High School Girl / 魔法の女子高生,2016,Roguelike,"₩11,000",0%,149,51,200,110000000,113,28,141,77550000
262790,Our Darker Purpose,2014,Roguelike,"₩16,000",0%,601,131,732,585600000,449,98,547,437600000
2365860,The Pair Annihilation,2024,Roguelike,"₩12,900",0%,23,1,24,15480000,23,1,24,15480000
250500,Super Amazing Wagon Adventure,2013,Roguelike,"₩3,400",0%,1836,90,1926,327420000,1560,82,1642,279140000
1035800,Mistress of Maids: First Castle,2019,Roguelike,Free,0%,88,13,101,0,88,13,101,0
332540,We Slay Monsters,2017,Roguelike,Free,0%,80,6,86,0,81,6,87,0
749850,DragonFangZ - The Rose & Dungeon of Time,2018,Roguelike,"₩26,000",0%,127,46,173,224900000,96,41,137,178100000
1397130,Primateria,2024,Roguelike,"₩13,500",0%,152,24,176,118800000,126,22,148,99900000
662540,Haque,2017,Roguelike,"₩15,500",0%,138,23,161,124775000,102,22,124,96100000
930780,Blood Card,2019,Roguelike,"₩15,500",0%,575,133,708,548700000,520,130,650,503750000
1278210,Space Raiders in Space,2020,Roguelike,"₩10,500",0%,129,7,136,71400000,63,6,69,36225000
1209430,Dungeon Cards,2020,Roguelike,"₩2,200",0%,69,5,74,8140000,64,6,70,7700000
561740,MidBoss,2017,Roguelike,"₩16,500",0%,233,37,270,222750000,174,33,207,170775000
2927780,Last Outpost,2025,Roguelike,"₩11,000",0%,35,8,43,23650000,35,11,46,25300000
2884080,OMG Words,2025,Roguelike,"₩11,000",0%,61,10,71,39050000,55,11,66,36300000
2927780,Last Outpost,2025,Roguelike,"₩11,000",0%,35,8,43,23650000,35,11,46,25300000
2188790,Unknown Pyramid,2023,Roguelike,"₩5,600",0%,21,1,22,6160000,20,1,21,5880000
630720,Mana Spark,2018,Roguelike,"₩12,500",0%,523,141,664,415000000,371,93,464,290000000
2054770,Combo Card Clashers,2024,Roguelike,"₩13,500",0%,95,17,112,75600000,70,17,87,58725000
2542140,Ketz: Galactic Overlords,2025,Roguelike,"₩9,000",0%,132,52,184,82800000,167,75,242,108900000
2727040,Blood Sins,2025,Roguelike,"₩15,500",0%,0,0,0,0,13,0,13,10075000
2228010,Right and Down and Dice,2024,Roguelike,"₩13,500",0%,84,19,103,69525000,67,10,77,51975000
685400,Skelly Selest,2018,Roguelike,"₩5,500",0%,265,17,282,77550000,244,16,260,71500000
364420,Roguelands,2016,Roguelike,"₩11,000",0%,2978,725,3703,2036650000,0,0,0,0
3666980,Diceball,2025,Roguelike,"₩11,000",0%,0,0,0,0,13,2,15,8250000
2704510,Simple CEO,2024,Roguelike,"₩3,150",30%,14,6,20,3150000,11,6,17,2677500
1189230,Door in the Woods,2019,Roguelike,"₩10,500",0%,196,56,252,132300000,181,54,235,123375000
2688900,Super Algebrawl,2024,Roguelike,"₩6,700",0%,155,14,169,56615000,145,14,159,53265000
3033600,Rogue Rollout,2024,Roguelike,"₩13,500",0%,23,2,25,16875000,17,2,19,12825000
331440,bit Dungeon II,2014,Roguelike,"₩4,400",0%,1821,386,2207,485540000,1150,253,1403,308660000
2374320,Heroes Of  Loot: Gauntlet Of Power,2024,Roguelike,"₩16,500",0%,57,8,65,53625000,57,7,64,52800000
2089980,Extremely Powerful Capybaras,2023,Roguelike,"₩6,700",0%,689,381,1070,358450000,528,338,866,290110000
3145320,Elements and build,2024,Roguelike,"₩9,900",0%,157,40,197,97515000,126,47,173,85635000
837200,NetHack: Legacy,2018,Roguelike,"₩6,500",0%,41,12,53,17225000,42,11,53,17225000
266110,Tower of Guns,2014,Roguelike,"₩17,000",0%,982,238,1220,1037000000,437,71,508,431800000
736710,Yōdanji,2017,Roguelike,"₩2,750",50%,30,6,36,4950000,28,5,33,4537500
443880,Loot Rascals,2017,Roguelike,"₩10,500",0%,140,63,203,106575000,56,9,65,34125000
1048350,Nigate Tale,2024,Roguelike,"₩20,500",0%,628,291,919,941975000,440,207,647,663175000
1160020,AshenForest,2020,Roguelike,"₩7,500",0%,188,8,196,73500000,177,9,186,69750000
971220,Rogue Monster Rush,2025,Roguelike,"₩5,600",0%,54,2,56,15680000,50,3,53,14840000
1138970,Dandy Dungeon - Legend of Brave Yamada -,2019,Roguelike,"₩19,500",0%,71,12,83,80925000,68,12,80,78000000
2848740,OverRider,2024,Roguelike,"₩11,000",0%,44,7,51,28050000,27,6,33,18150000
3874490,Denrei Survivors,2025,Roguelike,"₩11,000",0%,0,0,0,0,21,0,21,11550000
2929730,Cat Bait,2024,Roguelike,"₩5,600",0%,1019,24,1043,292040000,1056,33,1089,304920000
1229460,Dice Legacy,2021,Roguelike,"₩15,200",0%,706,320,1026,779760000,588,290,878,667280000
1470390,City of Beats,2023,Roguelike,"₩21,500",0%,101,25,126,135450000,56,6,62,66650000
2263510,The Simulacrum,2023,Roguelike,"₩5,600",0%,106,15,121,33880000,98,12,110,30800000
2549380,Cryptical Path,2025,Roguelike,"₩10,890",34%,136,19,155,84397500,111,18,129,70240500
2510850,Slay the Minotaur,2024,Roguelike,"₩5,600",0%,171,11,182,50960000,167,14,181,50680000
2569330,Pixel Descent,2024,Roguelike,"₩6,700",0%,102,20,122,40870000,93,20,113,37855000
2992470,Rustwing,2025,Roguelike,"₩6,700",0%,11,1,12,4020000,14,2,16,5360000
2187130,Rabat Protocol:Metal Rhapsody,2023,Roguelike,"₩7,230",0%,103,12,115,41572500,66,14,80,28920000
326840,Heart&Slash,2016,Roguelike,"₩15,500",0%,500,118,618,478950000,404,95,499,386725000
1842410,Deadly Racing Duel,2022,Roguelike,"₩5,500",0%,12,3,15,4125000,11,1,12,3300000
589200,Dreadhalls,2017,Roguelike,"₩10,500",0%,320,23,343,180075000,305,23,328,172200000
1232100,BroodStar,2022,Roguelike,"₩11,500",0%,88,4,92,52900000,74,6,80,46000000
2746220,Popmoji,2024,Roguelike,"₩3,400",0%,34,2,36,6120000,27,1,28,4760000
1608660,Overhaul,2022,Roguelike,"₩12,500",0%,78,7,85,53125000,71,7,78,48750000
1638390,Indies' Lies,2023,Roguelike,"₩4,950",70%,578,177,755,186862500,477,159,636,157410000
2447120,Veiled Edge,2024,Roguelike,"₩13,200",19%,30,0,30,19800000,20,0,20,13200000
3144770,Ooze Keeper,2024,Roguelike,"₩7,800",0%,26,1,27,10530000,24,4,28,10920000
3752220,RiftGuard,2025,Roguelike,"₩1,100",0%,0,0,0,0,15,0,15,825000
2225870,Before The Dawn,2024,Roguelike,"₩5,600",0%,42,4,46,12880000,29,2,31,8680000
2050590,Fhtagn Simulator,2022,Roguelike,"₩8,500",0%,474,50,524,222700000,445,55,500,212500000
2491130,Split Square,2023,Roguelike,"₩5,600",0%,19,2,21,5880000,14,2,16,4480000
690560,I Am Overburdened,2017,Roguelike,"₩5,500",0%,135,19,154,42350000,115,19,134,36850000
701470,TTV2,2015,Roguelike,"₩1,100",0%,161,17,178,9790000,446,91,537,29535000
1964330,Madcap Mosaic,2022,Roguelike,"₩7,500",0%,66,4,70,26250000,65,3,68,25500000
1907000,Gloomgrave,2023,Roguelike,"₩5,600",0%,159,22,181,50680000,151,23,174,48720000
1389200,Cramped Room of Death,2023,Roguelike,"₩16,500",0%,59,3,62,51150000,57,3,60,49500000
3813260,连杀地牢（Dungeon Killing）,2025,Roguelike,"₩3,400",0%,0,0,0,0,11,1,12,2040000
3082690,Dead Soul TowerDefense:Shadow Labyrinth,2025,Roguelike,"₩8,800",19%,10,4,14,6160000,8,6,14,6160000
3161850,Boosted Survivors,2024,Roguelike,"₩1,100",0%,170,5,175,9625000,168,7,175,9625000
297120,Heavy Bullets,2014,Roguelike,"₩11,000",0%,1251,279,1530,841500000,1010,222,1232,677600000
396480,Battlevoid: Harbinger,2016,Roguelike,"₩10,500",0%,808,212,1020,535500000,718,191,909,477225000
274700,868-HACK,2015,Roguelike,"₩6,500",0%,102,12,114,37050000,94,12,106,34450000
2812610,Curtain Call,2024,Roguelike,"₩7,800",0%,133,19,152,59280000,112,20,132,51480000
249630,Delver,2018,Roguelike,"₩15,500",0%,2455,343,2798,2168450000,0,0,0,0
2387310,Magic Paper,2024,Roguelike,"₩14,900",0%,25,3,28,20860000,18,3,21,15645000
3566580,Legendary Heroes Survivors,2025,Roguelike,"₩3,400",0%,19,0,19,3230000,20,1,21,3570000
428750,Neon Chrome,2016,Roguelike,"₩16,500",0%,1055,100,1155,952875000,491,37,528,435600000
1226510,Trigon: Space Story,2022,Roguelike,"₩20,000",0%,1052,435,1487,1487000000,827,389,1216,1216000000
2995560,Wildkeepers Rising,2025,Roguelike,"₩11,000",0%,58,14,72,39600000,62,16,78,42900000
1114530,TTV3,2019,Roguelike,"₩1,100",0%,87,13,100,5500000,106,17,123,6765000
1072640,Beat Blast,2021,Roguelike,"₩12,500",0%,369,43,412,257500000,339,42,381,238125000
1520680,Tetra Cube,2021,Roguelike,"₩7,500",0%,48,8,56,21000000,42,7,49,18375000
1866880,Cultivation Story: Reincarnation,2023,Roguelike,"₩10,500",0%,1782,148,1930,1013250000,1763,153,1916,1005900000
1518220,Spells & Secrets,2023,Roguelike,"₩27,000",0%,219,54,273,368550000,170,51,221,298350000
1591690,DEATHRUN TV,2022,Roguelike,"₩15,500",0%,63,18,81,62775000,47,8,55,42625000
1591690,DEATHRUN TV,2022,Roguelike,"₩15,500",0%,63,18,81,62775000,47,8,55,42625000
1520680,Tetra Cube,2021,Roguelike,"₩7,500",0%,48,8,56,21000000,42,7,49,18375000
857980,Void Bastards,2019,Roguelike,"₩31,000",0%,4527,739,5266,8162300000,0,0,0,0
1973320,Road Defense: Outsiders,2023,Roguelike,"₩3,300",0%,123,25,148,24420000,120,23,143,23595000
3172400,Darkest Mine,2025,Roguelike,"₩5,600",0%,13,0,13,3640000,12,1,13,3640000
780670,Fantasy of Expedition,2020,Roguelike,"₩10,500",0%,547,134,681,357525000,484,129,613,321825000
318230,Convoy,2015,Roguelike,"₩16,000",0%,1131,307,1438,1150400000,866,244,1110,888000000
3048660,公主：东方与远征（Princess: The East and the Expedition）,2024,Roguelike,"₩4,500",0%,148,22,170,38250000,140,23,163,36675000
2683360,Error_Boy.exe,2025,Roguelike,"₩9,900",0%,17,0,17,8415000,10,0,10,4950000
688060,Odd Realm,2024,Roguelike,"₩21,500",0%,818,136,954,1025550000,759,134,893,959975000
3283230,Randotura,2024,Roguelike,"₩2,300",0%,18,0,18,2070000,20,0,20,2300000
2517560,Squidding Over It,2023,Roguelike,"₩5,600",0%,24,0,24,6720000,18,0,18,5040000
2288880,Acolyte of the Altar,2024,Roguelike,"₩21,500",0%,62,20,82,88150000,55,21,76,81700000
1267470,Warriors of the Nile,2020,Roguelike,"₩13,500",0%,1980,537,2517,1698975000,1867,526,2393,1615275000
2747820,Iconia Defenders,2024,Roguelike,"₩7,830",42%,17,2,19,7438500,9,2,11,4306500
939100,Darksburg,2020,Roguelike,"₩3,100",80%,1570,915,2485,385175000,1048,589,1637,253735000
486380,Shigatari,2017,Roguelike,"₩3,300",0%,269,7,276,45540000,252,8,260,42900000
610960,红石遗迹 - Red Obsidian Remnant,2017,Roguelike,"₩6,000",0%,701,133,834,250200000,568,108,676,202800000
1590160,Liberte,2023,Roguelike,"₩21,500",0%,121,58,179,192425000,95,51,146,156950000
2056490,Forrader Hero,2023,Roguelike,"₩2,250",50%,67,7,74,8325000,54,4,58,6525000
1490180,For Sparta,2021,Roguelike,"₩1,150",50%,32,5,37,2127500,22,4,26,1495000
2449080,Dungeon No Dungeon: Tyrant's Endgame,2024,Roguelike,"₩3,950",0%,61,3,64,12640000,24,2,26,5135000
2657310,Godrop,2024,Roguelike,"₩9,900",0%,298,14,312,154440000,257,16,273,135135000
1667700,Geometry Arena 2,2023,Roguelike,"₩6,700",0%,324,38,362,121270000,276,38,314,105190000
1235450,Treasure Drifter: Nian,2021,Roguelike,"₩1,800",60%,30,8,38,3420000,20,7,27,2430000
1235450,Treasure Drifter: Nian,2021,Roguelike,"₩1,800",60%,30,8,38,3420000,20,7,27,2430000
1590160,Liberte,2023,Roguelike,"₩21,500",0%,121,58,179,192425000,95,51,146,156950000
2657310,Godrop,2024,Roguelike,"₩9,900",0%,298,14,312,154440000,257,16,273,135135000
3631830,Dice To Pay,2025,Roguelike,"₩3,400",0%,0,0,0,0,15,0,15,2550000
2752720,Dice Player One,2024,Roguelike,"₩16,500",0%,458,39,497,410025000,399,40,439,362175000
2786160,Skeleton War,2024,Roguelike,"₩4,500",0%,83,2,85,19125000,75,2,77,17325000
676830,Xenomarine,2019,Roguelike,"₩10,500",0%,51,7,58,30450000,39,8,47,24675000
2003050,Perseus: Titan Slayer,2023,Roguelike,"₩8,900",0%,221,118,339,150855000,202,119,321,142845000
2100050,Spell Defender,2022,Roguelike,"₩3,300",0%,125,13,138,22770000,116,17,133,21945000
3095890,Mechanines Tower Defense,2024,Roguelike,"₩7,800",0%,35,1,36,14040000,32,1,33,12870000
1807730,Lab Bio-Terror,2021,Roguelike,"₩5,500",0%,14,4,18,4950000,10,0,10,2750000
2527880,Undead West,2024,Roguelike,"₩8,900",0%,25,3,28,12460000,19,3,22,9790000
704000,GUNHEAD,2023,Roguelike,"₩21,500",0%,146,43,189,203175000,97,43,140,150500000
531180,AIRHEART - Tales of broken Wings,2018,Roguelike,"₩15,900",0%,154,30,184,146280000,100,25,125,99375000
951430,Dead Age 2: The Zombie Survival RPG,2021,Roguelike,"₩2,920",85%,957,293,1250,182500000,825,261,1086,158556000
1861940,Monsters and Weapons,2022,Roguelike,"₩5,500",0%,19,4,23,6325000,16,4,20,5500000
1649630,Berserk Mode,2023,Roguelike,"₩8,500",0%,213,13,226,96050000,174,11,185,78625000
364790,Voyage to Farland,2015,Roguelike,"₩3,400",0%,18,6,24,4080000,10,1,11,1870000
2283940,Ancient Guardians: The Dragon,2025,Roguelike,"₩6,700",0%,11,1,12,4020000,15,1,16,5360000
3370500,MINE : FOREVER,2024,Roguelike,"₩3,400",0%,0,0,0,0,20,16,36,6120000
1698630,Sword of the Stars: The Pit 2,2021,Roguelike,"₩15,500",0%,48,10,58,44950000,39,9,48,37200000
2697430,Dexterous: Time to Steal,2024,Roguelike,"₩11,000",0%,9,0,9,4950000,10,0,10,5500000
1808320,Lake of Creatures,2024,Roguelike,"₩14,000",0%,34,5,39,27300000,35,13,48,33600000
877010,Beyond Contact,2023,Roguelike,"₩20,300",0%,729,281,1010,1025150000,645,264,909,922635000
619780,The Swords of Ditto: Mormo's Curse,2018,Roguelike,"₩16,500",0%,1462,855,2317,1911525000,1105,677,1782,1470150000
2751120,Dive The Depths,2025,Roguelike,"₩9,800",0%,84,21,105,51450000,63,21,84,41160000
1124080,Active DBG: Brave's Rage,2023,Roguelike,"₩19,500",0%,230,44,274,267150000,178,39,217,211575000
2098560,YouTuber Survivors,2024,Roguelike,"₩6,700",0%,33,1,34,11390000,26,1,27,9045000
363420,Leap of Fate,2016,Roguelike,"₩17,000",0%,405,58,463,393550000,286,39,325,276250000
1492250,44 Minutes in Nightmare,2021,Roguelike,"₩8,900",0%,44,5,49,21805000,41,5,46,20470000
515650,Straimium Immortaly,2016,Roguelike,"₩7,800",0%,152,15,167,65130000,137,15,152,59280000
1554970,Rogue Spirit,2023,Roguelike,"₩22,000",0%,135,30,165,181500000,87,28,115,126500000
2728950,Potty Knight Saga,2024,Roguelike,"₩6,700",0%,102,4,106,35510000,86,4,90,30150000
3057760,CROPS!,2024,Roguelike,"₩8,900",0%,180,22,202,89890000,173,24,197,87665000
1710490,Slime Killer,2021,Roguelike,"₩5,500",0%,6,0,6,1650000,9,1,10,2750000
1214330,World Seed Classic,2020,Roguelike,"₩6,500",0%,98,9,107,34775000,92,8,100,32500000
328760,SanctuaryRPG: Black Edition,2015,Roguelike,"₩8,500",0%,1435,134,1569,666825000,931,81,1012,430100000
3424020,Letterlike,2025,Roguelike,"₩8,900",0%,38,1,39,17355000,23,1,24,10680000
2452820,Skogdal,2025,Roguelike,"₩21,500",0%,52,2,54,58050000,58,2,60,64500000
1005120,Touhou Genso Wanderer -Lotus Labyrinth R-,2021,Roguelike,"₩29,000",0%,276,74,350,507500000,258,73,331,479950000
994220,NEOVERSE,2020,Roguelike,"₩19,500",0%,3155,588,3743,3649425000,0,0,0,0
442780,STRAFE: Gold Edition,2017,Roguelike,"₩16,500",0%,1744,663,2407,1985775000,1276,448,1724,1422300000
2430470,Vilde,2025,Roguelike,"₩17,500",0%,0,0,0,0,38,21,59,51625000
2231060,Druidwalker,2023,Roguelike,"₩3,800",0%,54,7,61,11590000,58,7,65,12350000
541200,GTTOD: Get To The Orange Door,2017,Roguelike,"₩21,500",0%,2899,382,3281,3527075000,0,0,0,0
547980,Equin: The Lantern,2016,Roguelike,"₩5,500",0%,53,5,58,15950000,42,5,47,12925000
1842510,Mechanibot,2022,Roguelike,"₩3,300",0%,57,5,62,10230000,45,5,50,8250000
924070,Arboria,2021,Roguelike,"₩14,340",0%,581,168,749,537033000,411,116,527,377859000
2892060,Card Toons,2025,Roguelike,"₩16,500",0%,10,3,13,10725000,11,4,15,12375000
2185180,Fantasy Madness: Bloodbath,2025,Roguelike,"₩7,800",0%,56,5,61,23790000,45,8,53,20670000
2892060,Card Toons,2025,Roguelike,"₩16,500",0%,10,3,13,10725000,11,4,15,12375000
327880,Sublevel Zero Redux,2015,Roguelike,"₩16,000",0%,446,66,512,409600000,371,65,436,348800000
2287150,Revenge of the Mage,2025,Roguelike,"₩6,700",0%,115,20,135,45225000,73,20,93,31155000
1842510,Mechanibot,2022,Roguelike,"₩3,300",0%,57,5,62,10230000,45,5,50,8250000
2231060,Druidwalker,2023,Roguelike,"₩3,800",0%,54,7,61,11590000,58,7,65,12350000
1945230,Diablo The Abyss,2023,Roguelike,"₩8,800",0%,180,35,215,94600000,171,35,206,90640000
1115580,Grand Brix Shooter,2019,Roguelike,"₩9,900",0%,76,5,81,40095000,54,2,56,27720000
2942700,Seed of Heroes,2024,Roguelike,"₩16,500",0%,137,35,172,141900000,133,42,175,144375000
1191840,Legend Creatures(传奇生物),2020,Roguelike,"₩5,500",0%,3536,386,3922,1078550000,3390,377,3767,1035925000
2814760,Immortals Must Die,2024,Roguelike,"₩5,600",0%,14,3,17,4760000,12,3,15,4200000
409450,The Fall of the Dungeon Guardians - Enhanced Edition,2015,Roguelike,"₩21,000",0%,538,104,642,674100000,493,101,594,623700000
3008800,Seconds Till Destruction,2025,Roguelike,"₩5,600",0%,0,0,0,0,19,0,19,5320000
2118500,Touhou Library Survivors,2022,Roguelike,"₩5,500",0%,110,14,124,34100000,109,13,122,33550000
1844130,Stellar Orphans,2024,Roguelike,"₩18,500",0%,85,30,115,106375000,82,32,114,105450000
3073820,Curse Rounds,2025,Roguelike,"₩4,500",0%,19,0,19,4275000,20,1,21,4725000
718590,Dark Devotion,2019,Roguelike,"₩5,120",75%,1762,582,2344,600064000,1360,454,1814,464384000
371430,Space Grunts,2016,Roguelike,"₩11,000",0%,61,13,74,40700000,29,7,36,19800000
757730,Shadowcrawl: The Dark Pilgrimage,2018,Roguelike,"₩6,500",0%,19,3,22,7150000,13,3,16,5200000
1144910,Space Gladiators,2021,Roguelike,"₩15,500",0%,401,42,443,343325000,360,40,400,310000000
334420,Out There: Ω Edition,2015,Roguelike,"₩4,000",75%,1274,416,1690,338000000,1006,336,1342,268400000
916040,SFD : Rogue TRPG,2018,Roguelike,"₩8,500",0%,86,13,99,42075000,76,14,90,38250000
546090,Trip to Vinelands,2015,Roguelike,"₩1,100",0%,197,27,224,12320000,517,98,615,33825000
384490,NECROPOLIS: BRUTAL EDITION,2016,Roguelike,"₩33,000",0%,3010,1623,4633,7644450000,0,0,0,0
333390,Tales of Aravorn: Seasons Of The Wolf,2015,Roguelike,"₩27,000",0%,58,13,71,95850000,50,13,63,85050000
1374230,Flame Keeper,2024,Roguelike,"₩6,610",0%,101,34,135,44617500,43,19,62,20491000
546090,Trip to Vinelands,2015,Roguelike,"₩1,100",0%,197,27,224,12320000,517,98,615,33825000
1374230,Flame Keeper,2024,Roguelike,"₩6,610",0%,101,34,135,44617500,43,19,62,20491000
2071430,Roots of Yggdrasil,2024,Roguelike,"₩21,500",0%,282,30,312,335400000,238,33,271,291325000
3530490,Fadedlands: The Reckless Squad,2025,Roguelike,"₩6,030",9%,0,0,0,0,24,0,24,7236000
333390,Tales of Aravorn: Seasons Of The Wolf,2015,Roguelike,"₩27,000",0%,58,13,71,95850000,50,13,63,85050000
3499910,Dachs Hunter,2025,Roguelike,"₩5,600",0%,0,0,0,0,11,0,11,3080000
718590,Dark Devotion,2019,Roguelike,"₩5,120",75%,1762,582,2344,600064000,1360,454,1814,464384000
2659970,Lucky Mayor,2023,Roguelike,"₩7,800",0%,79,21,100,39000000,71,23,94,36660000
1980350,Run Build Pew!,2022,Roguelike,"₩3,400",0%,399,144,543,92310000,384,142,526,89420000
573780,Xenon Valkyrie,2017,Roguelike,"₩10,500",0%,84,45,129,67725000,76,44,120,63000000
1409530,Neophyte,2022,Roguelike,"₩3,300",0%,590,40,630,103950000,567,49,616,101640000
2270750,Black Gunner Wukong,2024,Roguelike,"₩4,900",0%,420,5,425,104125000,370,8,378,92610000
3832630,Wheelchair Wizards,2025,Roguelike,Free,0%,0,0,0,0,161,7,168,0
1296450,Dust & Neon,2023,Roguelike,"₩21,500",0%,296,92,388,417100000,202,68,270,290250000
1074040,The Red Prison,2019,Roguelike,Free,0%,35,8,43,0,35,8,43,0
605450,In Death,2018,Roguelike,"₩31,000",0%,820,159,979,1517450000,759,155,914,1416700000
1144910,Space Gladiators,2021,Roguelike,"₩15,500",0%,401,42,443,343325000,360,40,400,310000000
324740,The Warlock of Firetop Mountain,2016,Roguelike,"₩21,500",0%,528,180,708,761100000,263,78,341,366575000
1929900,Touhou: Dreamland of Infinity,2022,Roguelike,"₩20,500",0%,86,16,102,104550000,70,17,87,89175000
3059390,Hexagod,2025,Roguelike,"₩8,900",0%,59,6,65,28925000,65,8,73,32485000
360030,XLarn,2015,Roguelike,"₩5,600",0%,31,14,45,12600000,27,8,35,9800000
2517810,The Last Flame: Prologue,2024,Roguelike,Free,0%,0,0,0,0,282,46,328,0
301840,City of Brass,2018,Roguelike,"₩21,500",0%,637,181,818,879350000,583,174,757,813775000
1619570,Death Roads: Tournament,2023,Roguelike,"₩16,500",0%,605,131,736,607200000,530,133,663,546975000
415030,One More Dungeon,2015,Roguelike,"₩5,600",0%,500,151,651,182280000,394,111,505,141400000
301840,City of Brass,2018,Roguelike,"₩21,500",0%,637,181,818,879350000,583,174,757,813775000
415030,One More Dungeon,2015,Roguelike,"₩5,600",0%,500,151,651,182280000,394,111,505,141400000
318600,The Flame in the Flood,2016,Roguelike,"₩16,000",0%,5443,1723,7166,5732800000,0,0,0,0
3052500,ColdRidge,2024,Roguelike,"₩11,000",0%,77,26,103,56650000,60,25,85,46750000
595140,Immortal Redneck,2017,Roguelike,"₩21,000",0%,2880,315,3195,3354750000,0,0,0,0
2955500,Space Horde Attack,2024,Roguelike,"₩7,800",0%,11,1,12,4680000,9,1,10,3900000
1182420,VED,2024,Roguelike,"₩27,000",0%,47,12,59,79650000,30,8,38,51300000
2816940,Bloody Heaven 2,2024,Roguelike,"₩5,600",0%,118,20,138,38640000,101,21,122,34160000
1074040,The Red Prison,2019,Roguelike,Free,0%,35,8,43,0,35,8,43,0
388620,DungeonUp,2015,Roguelike,"₩5,500",0%,391,88,479,131725000,321,71,392,107800000
360030,XLarn,2015,Roguelike,"₩5,600",0%,31,14,45,12600000,27,8,35,9800000
3060970,Gwihyang : Homecoming,2024,Roguelike,"₩6,900",0%,15,12,27,9315000,11,11,22,7590000
2713070,Few Nights More: Genesis,2023,Roguelike,Free,0%,0,0,0,0,210,53,263,0
3613610,Double Down,2025,Roguelike,Free,0%,0,0,0,0,49,7,56,0
2317960,Samurai Survivors,2023,Roguelike,"₩5,600",0%,43,5,48,13440000,39,5,44,12320000
1906150,Pixel Trouble,2022,Roguelike,"₩5,500",0%,13,2,15,4125000,10,1,11,3025000
323060,Tharsis,2016,Roguelike,"₩16,000",0%,1737,739,2476,1980800000,1010,413,1423,1138400000
2824730,Yawnoc,2024,Roguelike,"₩5,600",0%,56,0,56,15680000,55,1,56,15680000
1127110,Outpost,2020,Roguelike,Free,0%,664,94,758,0,666,99,765,0
1022610,Alchemic Dungeons DX,2019,Roguelike,"₩8,500",0%,18,2,20,8500000,18,2,20,8500000
508840,Broken Armor,2016,Roguelike,"₩1,100",0%,655,138,793,43615000,623,128,751,41305000
2787630,The Wrath of the Goose King,2024,Roguelike,"₩6,240",19%,20,0,20,6240000,17,0,17,5304000
1892750,Regulators,2025,Roguelike,"₩16,500",0%,32,0,32,26400000,35,0,35,28875000
1375930,Minesweeper: Collector,2020,Roguelike,"₩8,400",0%,105,9,114,47880000,105,10,115,48300000
2851110,Golden Warden,2025,Roguelike,"₩11,000",0%,34,2,36,19800000,35,3,38,20900000
3499540,COMBOLITE,2025,Roguelike,"₩7,800",0%,34,10,44,17160000,40,11,51,19890000
1828700,Celestial Project,2022,Roguelike,"₩11,000",0%,30,8,38,20900000,24,9,33,18150000
372080,Kramora's Shadow,2017,Roguelike,"₩5,500",0%,47,10,57,15675000,34,6,40,11000000
2875780,Staying Fresh,2024,Roguelike,"₩4,500",0%,19,0,19,4275000,17,0,17,3825000
355680,Overland,2019,Roguelike,"₩21,500",0%,384,136,520,559000000,336,118,454,488050000
1836880,Yumeiri,2022,Roguelike,"₩5,600",0%,31,2,33,9240000,28,2,30,8400000
2456330,Bloompunk,2023,Roguelike,Free,0%,0,0,0,0,66,12,78,0
3669450,Pantheion,2025,Roguelike,"₩7,920",19%,0,0,0,0,13,1,14,5544000
1607040,Evertried,2021,Roguelike,"₩21,500",0%,55,14,69,74175000,25,9,34,36550000
1489600,Nix Umbra,2021,Roguelike,"₩10,500",0%,82,11,93,48825000,63,11,74,38850000
2116520,Fried Panic,2022,Roguelike,Free,0%,0,0,0,0,43,7,50,0
1838790,Angry Rocketeer Frenzy,2021,Roguelike,"₩5,500",0%,11,4,15,4125000,9,1,10,2750000
238280,Legend of Dungeon,2013,Roguelike,"₩10,500",0%,1189,437,1626,853650000,873,340,1213,636825000
444940,UBERMOSH:BLACK,2016,Roguelike,"₩1,100",0%,306,59,365,20075000,571,85,656,36080000
2607260,Demon Corporation: Onboarding,2025,Roguelike,"₩7,800",0%,54,0,54,21060000,38,0,38,14820000
378720,Thea: The Awakening,2015,Roguelike,"₩21,000",0%,3296,526,3822,4013100000,0,0,0,0
929010,Swag and Sorcery,2019,Roguelike,"₩14,500",0%,1728,1460,3188,2311300000,0,0,0,0
363930,Dead Age,2016,Roguelike,"₩1,650",90%,4467,1008,5475,451687500,0,0,0,0
403940,Dungelot: Shattered Lands,2016,Roguelike,"₩11,000",0%,429,138,567,311850000,195,83,278,152900000
294040,Loot Hero DX,2015,Roguelike,"₩3,400",0%,1111,388,1499,254830000,230,89,319,54230000
1914580,Spirit Hunters: Infinite Horde,2023,Roguelike,"₩8,900",0%,1234,330,1564,695980000,1184,334,1518,675510000
2119580,Golden Record Retriever,2024,Roguelike,"₩17,500",0%,32,16,48,42000000,22,16,38,33250000
1789670,Me and my eldritch parasite,2022,Roguelike,"₩3,400",0%,17,0,17,2890000,17,1,18,3060000
1146880,RRRR3,2019,Roguelike,"₩1,100",0%,24,6,30,1650000,17,2,19,1045000
2060550,Fabular: Prologue,2022,Roguelike,Free,0%,0,0,0,0,67,4,71,0
2119580,Golden Record Retriever,2024,Roguelike,"₩17,500",0%,32,16,48,42000000,22,16,38,33250000
929010,Swag and Sorcery,2019,Roguelike,"₩14,500",0%,1728,1460,3188,2311300000,0,0,0,0
2321210,Neon Echo,2023,Roguelike,"₩16,500",0%,2290,1809,4099,3381675000,0,0,0,0
1229260,Monster Girls and the Mysterious Adventure,2020,Roguelike,"₩19,500",0%,122,17,139,135525000,116,17,133,129675000
1914580,Spirit Hunters: Infinite Horde,2023,Roguelike,"₩8,900",0%,1234,330,1564,695980000,1184,334,1518,675510000
1054800,变量 Variables,2019,Roguelike,"₩11,500",0%,874,131,1005,577875000,810,132,942,541650000
1120400,Terra Randoma,2024,Roguelike,"₩15,500",0%,138,14,152,117800000,118,16,134,103850000
2808270,Buckshot With Friends,2024,Roguelike,"₩4,500",0%,44,46,90,20250000,40,38,78,17550000
2027510,Monster Crawl,2024,Roguelike,"₩8,900",0%,15,0,15,6675000,14,0,14,6230000
2169300,Dizzy Rogues,2023,Roguelike,"₩4,500",0%,45,4,49,11025000,40,4,44,9900000
378720,Thea: The Awakening,2015,Roguelike,"₩21,000",0%,3296,526,3822,4013100000,0,0,0,0
363930,Dead Age,2016,Roguelike,"₩1,650",90%,4467,1008,5475,451687500,0,0,0,0
3040270,Bees vs Zombees,2024,Roguelike,"₩8,000",0%,77,5,82,32800000,74,3,77,30800000
1413210,The Cassir Simulator,2020,Roguelike,"₩1,100",0%,73,8,81,4455000,71,6,77,4235000
1564350,Bot Loop,2024,Roguelike,"₩21,500",0%,12,1,13,13975000,9,1,10,10750000
1354990,Dungeons of Voidria,2022,Roguelike,"₩13,500",0%,29,2,31,20925000,29,3,32,21600000
593700,Tower Fortress,2017,Roguelike,"₩5,600",0%,122,7,129,36120000,111,7,118,33040000
700100,Spooky Station,2019,Roguelike,"₩5,500",0%,344,53,397,109175000,303,41,344,94600000
434880,Hieroglyphika,2016,Roguelike,"₩11,000",0%,100,55,155,85250000,89,52,141,77550000
2834690,2048 - Dungeons,2025,Roguelike,"₩5,600",0%,0,0,0,0,14,0,14,3920000
595790,Hell is Other Demons,2019,Roguelike,"₩10,500",0%,296,23,319,167475000,267,23,290,152250000
2279220,Diceheart,2023,Roguelike,"₩13,500",0%,21,1,22,14850000,18,2,20,13500000
1721020,Loot Train,2021,Roguelike,Free,0%,0,0,0,0,31,5,36,0
490950,Frost,2016,Roguelike,"₩7,800",0%,134,17,151,58890000,109,13,122,47580000
2886470,Valefor,2024,Roguelike,"₩15,000",0%,106,45,151,113250000,88,42,130,97500000
2096620,Death or Treat,2023,Roguelike,"₩7,700",0%,69,26,95,36575000,33,20,53,20405000
2735630,Frostrain,2024,Roguelike,Free,0%,0,0,0,0,0,0,0,0
3818230,Maru Expedition: We can fly,2025,Roguelike,Free,0%,0,0,0,0,113,3,116,0
366910,The Long Journey Home,2017,Roguelike,"₩11,000",0%,1113,771,1884,1036200000,742,559,1301,715550000
1983120,Awakening of Legend,2022,Roguelike,Free,0%,0,0,0,0,15,1,16,0
2626860,Dragon Eclipse,2024,Roguelike,"₩14,500",0%,135,64,199,144275000,98,58,156,113100000
1304810,HANI,2021,Roguelike,"₩3,300",0%,20,2,22,3630000,19,1,20,3300000
3062680,Sculplings,2025,Roguelike,"₩7,800",0%,28,0,28,10920000,33,0,33,12870000
2323550,UDO,2024,Roguelike,"₩16,500",0%,12,1,13,10725000,12,1,13,10725000
308600,Skillshot City,2017,Roguelike,Free,0%,2028,411,2439,0,0,0,0,0
2673010,Sisyphus Paradox,2024,Roguelike,"₩9,900",0%,23,0,23,11385000,17,0,17,8415000
2598050,Foxcrate,2023,Roguelike,"₩5,600",0%,13,0,13,3640000,11,0,11,3080000
2354600,Renfield: Bring Your Own Blood,2023,Roguelike,"₩5,600",0%,654,168,822,230160000,544,154,698,195440000
2135870,WarpVector,2023,Roguelike,"₩5,600",0%,16,2,18,5040000,15,2,17,4760000
2055470,Neko Loop,2022,Roguelike,"₩21,500",0%,24,2,26,27950000,17,1,18,19350000
2549160,Core Trials,2025,Roguelike,"₩3,940",0%,21,3,24,4728000,21,3,24,4728000
2260050,Baalzebub,2023,Roguelike,Free,0%,11,2,13,0,10,2,12,0
2953030,Princess of Destruction | 滅ぼし姫,2024,Roguelike,"₩5,600",0%,27,2,29,8120000,31,2,33,9240000
400180,Okhlos: Omega,2016,Roguelike,"₩14,500",0%,657,201,858,622050000,489,138,627,454575000
2637960,Dawn Of Insolence,2024,Roguelike,"₩5,600",0%,14,3,17,4760000,12,3,15,4200000
2258480,Gunforged,2025,Roguelike,"₩9,900",0%,52,4,56,27720000,52,4,56,27720000
1295630,Helskate,2025,Roguelike,"₩27,000",0%,226,76,302,407700000,192,82,274,369900000
1373920,Sword Rogue,2020,Roguelike,Free,0%,432,18,450,0,427,22,449,0
399640,Flamebreak,2015,Roguelike,"₩10,500",0%,489,33,522,274050000,410,31,441,231525000
2497840,Dungeon Watchers,2024,Roguelike,"₩3,400",0%,12,0,12,2040000,12,0,12,2040000
2637960,Dawn Of Insolence,2024,Roguelike,"₩5,600",0%,14,3,17,4760000,12,3,15,4200000
2474750,Happy Poker,2025,Roguelike,"₩5,600",0%,44,2,46,12880000,24,3,27,7560000
1373920,Sword Rogue,2020,Roguelike,Free,0%,432,18,450,0,427,22,449,0
2151580,Infinite Tao,2023,Roguelike,"₩4,500",0%,688,175,863,194175000,663,176,839,188775000
676030,Eternal Starlight VR,2021,Roguelike,"₩16,500",0%,67,5,72,59400000,60,7,67,55275000
439880,Heroes of Loot 2,2016,Roguelike,"₩12,500",0%,33,10,43,26875000,18,3,21,13125000
727130,Between the Stars,2024,Roguelike,"₩32,000",0%,1724,577,2301,3681600000,1401,443,1844,2950400000
3048930,Duriano,2025,Roguelike,"₩7,800",0%,111,2,113,44070000,104,3,107,41730000
1494450,Oakenfold,2022,Roguelike,"₩19,900",0%,42,5,47,46765000,17,4,21,20895000
3120880,Food Fight Fiesta: Multi-Use Cards,2025,Roguelike,"₩11,000",0%,16,0,16,8800000,16,0,16,8800000
2258480,Gunforged,2025,Roguelike,"₩9,900",0%,52,4,56,27720000,52,4,56,27720000
1295630,Helskate,2025,Roguelike,"₩27,000",0%,226,76,302,407700000,192,82,274,369900000
1920410,The Sargosian Abyss,2022,Roguelike,"₩8,500",0%,15,2,17,7225000,15,1,16,6800000
1379600,Pandemic Train,2023,Roguelike,"₩14,500",0%,131,91,222,160950000,120,94,214,155150000
3349860,Dr. COG,2024,Roguelike,Free,0%,0,0,0,0,59,10,69,0
2409690,Kingmaker Academy: Warrior's Duels,2023,Roguelike,"₩1,100",0%,20,2,22,1210000,19,2,21,1155000
2920970,元卡牌2 MetaCard2 序章 Prologue,2024,Roguelike,Free,0%,0,0,0,0,16,2,18,0
2522160,Letter Lancers,2024,Roguelike,"₩9,900",0%,74,4,78,38610000,63,4,67,33165000
341390,Vulture for NetHack,2015,Roguelike,"₩5,600",0%,135,52,187,52360000,126,49,175,49000000
1932700,Entomophobia,2024,Roguelike,"₩4,670",0%,34,3,37,8639500,30,3,33,7705500
1491460,Tor Eternum,2022,Roguelike,"₩2,300",0%,57,16,73,8395000,41,10,51,5865000
2211390,Time Survivors,2024,Roguelike,"₩5,600",0%,173,97,270,75600000,162,100,262,73360000
2540810,Nyran Survivors,2024,Roguelike,"₩7,800",0%,42,7,49,19110000,25,4,29,11310000
2281650,An Ankou,2023,Roguelike,"₩5,600",0%,399,170,569,159320000,395,178,573,160440000
2389260,Aldro,2024,Roguelike,"₩5,600",0%,33,11,44,12320000,30,14,44,12320000
2526880,Defender Bros,2024,Roguelike,"₩12,500",0%,81,4,85,53125000,53,5,58,36250000
2389260,Aldro,2024,Roguelike,"₩5,600",0%,33,11,44,12320000,30,14,44,12320000
880830,Cavesweeper,2018,Roguelike,"₩5,500",0%,13,3,16,4400000,12,3,15,4125000
2971360,Metal Queen Dungeon,2024,Roguelike,"₩5,600",0%,27,4,31,8680000,26,4,30,8400000
1833540,STARS ERA: ABYSS FRONTIER,2024,Roguelike,"₩5,850",25%,26,2,28,8190000,19,2,21,6142500
3060130,Cosmic Call,2024,Roguelike,"₩11,000",0%,19,0,19,10450000,18,0,18,9900000
2404510,Lucky Hero,2023,Roguelike,"₩12,500",0%,81,12,93,58125000,65,12,77,48125000
3128280,Cats & Dice,2025,Roguelike,"₩8,900",0%,40,9,49,21805000,32,10,42,18690000
2213430,Barold: Inferno,2024,Roguelike,"₩4,450",50%,38,0,38,8455000,34,0,34,7565000
1145950,Vector Prospector,2020,Roguelike,"₩8,500",0%,13,2,15,6375000,11,2,13,5525000
340490,Subterrain,2016,Roguelike,"₩18,000",0%,1036,322,1358,1222200000,779,207,986,887400000
297210,Famaze,2014,Roguelike,Free,0%,305,77,382,0,310,87,397,0
2507040,Gunslinger Express,2024,Roguelike,"₩5,600",0%,16,2,18,5040000,15,3,18,5040000
339570,Enemy,2015,Roguelike,"₩15,500",0%,137,22,159,123225000,109,21,130,100750000
3046050,Dagger Froggy,2024,Roguelike,"₩5,600",0%,50,0,50,14000000,45,1,46,12880000
2746030,Deep Among the Swarm,2024,Roguelike,"₩9,900",0%,111,15,126,62370000,106,16,122,60390000
2168880,Rogue Blaster,2023,Roguelike,"₩5,600",0%,11,2,13,3640000,9,2,11,3080000
2621980,SD Dungeons,2025,Roguelike,"₩9,900",0%,11,7,18,8910000,10,7,17,8415000
3388220,Virion,2024,Roguelike,Free,0%,0,0,0,0,9,1,10,0
1612960,Balloon Flight,2021,Roguelike,"₩6,500",0%,52,2,54,17550000,48,2,50,16250000
207430,"Hack, Slash, Loot",2012,Roguelike,"₩6,700",0%,390,358,748,250580000,178,129,307,102845000
2568600,The Sentinel,2023,Roguelike,"₩1,100",0%,10,1,11,605000,10,1,11,605000
1487840,Chess Destroyer,2020,Roguelike,"₩2,300",0%,18,2,20,2300000,13,3,16,1840000
2908120,One Boss One Fight,2024,Roguelike,"₩11,000",0%,21,6,27,14850000,21,5,26,14300000
1000470,Drawngeon: Dungeons of Ink and Paper,2019,Roguelike,"₩5,600",0%,62,15,77,21560000,52,15,67,18760000
3398740,Tower Of Penguinaria,2025,Roguelike,Free,0%,0,0,0,0,15,1,16,0
727130,Between the Stars,2024,Roguelike,"₩32,000",0%,1724,577,2301,3681600000,1401,443,1844,2950400000
2197030,Big Survivor,2023,Roguelike,Free,0%,0,0,0,0,38,4,42,0
2393900,Story Of Infinity: Xia,2023,Roguelike,Free,0%,39,8,47,0,38,8,46,0
2196790,Jianghu Survivor,2023,Roguelike,"₩7,800",0%,1004,145,1149,448110000,931,139,1070,417300000
2507980,Meta-Ghost: The Breaking Show,2024,Roguelike,"₩19,500",0%,932,437,1369,1334775000,752,371,1123,1094925000
3095600,Miracle Heroes: Temporal Bounty Hunter,2024,Roguelike,"₩7,800",0%,92,2,94,36660000,83,3,86,33540000
2908120,One Boss One Fight,2024,Roguelike,"₩11,000",0%,21,6,27,14850000,21,5,26,14300000
2746030,Deep Among the Swarm,2024,Roguelike,"₩9,900",0%,111,15,126,62370000,106,16,122,60390000
882590,Outcast Tales: The First Journey,2024,Roguelike,Free,0%,0,0,0,0,200,35,235,0
1117670,GONNER2,2020,Roguelike,"₩14,500",0%,88,42,130,94250000,63,34,97,70325000
489220,Unforgiving Trials: The Darkest Crusade,2016,Roguelike,"₩1,100",0%,422,232,654,35970000,41,15,56,3080000
1059880,Devious Dungeon,2019,Roguelike,"₩8,900",0%,329,68,397,176665000,226,50,276,122820000
2791210,DeadNeverStop,2024,Roguelike,"₩2,300",0%,19,3,22,2530000,16,3,19,2185000
2667100,Project: NEO,2024,Roguelike,Free,0%,0,0,0,0,10,0,10,0
3609260,Idle Zombie Wave: Premium,2025,Roguelike,"₩8,900",0%,4,3,7,3115000,6,4,10,4450000
340490,Subterrain,2016,Roguelike,"₩18,000",0%,1036,322,1358,1222200000,779,207,986,887400000
1672920,FrankenStorm TD: Prologue,2021,Roguelike,Free,0%,0,0,0,0,310,46,356,0
492410,Rogues Like Us,2018,Roguelike,"₩6,700",0%,57,6,63,21105000,27,5,32,10720000
1000470,Drawngeon: Dungeons of Ink and Paper,2019,Roguelike,"₩5,600",0%,62,15,77,21560000,52,15,67,18760000
2218980,Sperma,2022,Roguelike,"₩2,300",0%,40,6,46,5290000,32,4,36,4140000
3730600,Aestheta,2025,Roguelike,"₩3,400",0%,0,0,0,0,79,16,95,16150000
3061550,RIOO,2024,Roguelike,"₩1,100",0%,8,2,10,550000,8,2,10,550000
722990,Dungeons of Hell,2017,Roguelike,"₩3,300",0%,35,4,39,6435000,28,3,31,5115000
1882040,Craft Hero,2022,Roguelike,"₩5,500",0%,326,62,388,106700000,285,67,352,96800000
1132090,Silk,2019,Roguelike,"₩11,500",0%,21,3,24,13800000,13,3,16,9200000
3647600,Midnight Riff,2025,Roguelike,Free,0%,0,0,0,0,31,3,34,0
3061550,RIOO,2024,Roguelike,"₩1,100",0%,8,2,10,550000,8,2,10,550000
772090,Once upon a Dungeon,2018,Roguelike,"₩5,500",0%,38,5,43,11825000,21,1,22,6050000
885780,Legion's Crawl,2018,Roguelike,"₩5,500",0%,31,9,40,11000000,30,9,39,10725000
3201630,Beast Brawl,2024,Roguelike,Free,0%,0,0,0,0,11,0,11,0
2375730,Mercenaries of the Kingdom: First Blood,2024,Roguelike,"₩14,500",0%,46,11,57,41325000,30,10,40,29000000
291190,Heroes of Steel RPG,2014,Roguelike,"₩11,000",0%,215,62,277,152350000,166,50,216,118800000
2522270,Rune Gate,2024,Roguelike,"₩11,000",0%,48,5,53,29150000,35,5,40,22000000
2656350,Untitled Rougelike Arcade Game,2024,Roguelike,Free,0%,0,0,0,0,12,1,13,0
1989560,Endless waves survival,2025,Roguelike,"₩2,300",0%,165,44,209,24035000,157,42,199,22885000
1209570,Cosmos,2020,Roguelike,"₩2,200",0%,12,2,14,1540000,10,2,12,1320000
943140,Sparklite,2019,Roguelike,"₩25,600",0%,480,133,613,784640000,327,98,425,544000000
2781720,Demoniac TV,2024,Roguelike,"₩3,400",0%,28,0,28,4760000,23,0,23,3910000
1936990,FROGUE,2024,Roguelike,"₩13,500",0%,36,1,37,24975000,26,1,27,18225000
2081860,The Van Game,2022,Roguelike,"₩5,600",0%,19,3,22,6160000,9,1,10,2800000
233740,Organ Trail: Director's Cut,2013,Roguelike,"₩5,500",0%,2704,364,3068,843700000,0,0,0,0
368680,Super Mutant Alien Assault,2016,Roguelike,"₩11,000",0%,147,25,172,94600000,88,10,98,53900000
1443100,RogueSlide,2022,Roguelike,"₩1,100",0%,30,3,33,1815000,20,3,23,1265000
1955640,Mystical Map,2024,Roguelike,"₩4,500",0%,14,3,17,3825000,12,2,14,3150000
2212500,Full Gear,2023,Roguelike,"₩5,600",0%,21,0,21,5880000,18,0,18,5040000
1678320,Heat Death,2022,Roguelike,"₩21,000",0%,63,2,65,68250000,60,2,62,65100000
2444010,Hector The Cat - Treasure Hunter,2023,Roguelike,"₩2,300",0%,13,0,13,1495000,10,0,10,1150000
2456160,Doors & Loot,2024,Roguelike,"₩13,500",0%,21,0,21,14175000,14,1,15,10125000
3730600,Aestheta,2025,Roguelike,"₩3,400",0%,0,0,0,0,79,16,95,16150000
1209570,Cosmos,2020,Roguelike,"₩2,200",0%,12,2,14,1540000,10,2,12,1320000
3300470,Songs of Rats,2025,Roguelike,"₩16,500",0%,31,6,37,30525000,31,6,37,30525000
2620530,Perfect Teams,2024,Roguelike,"₩21,500",0%,20,0,20,21500000,18,0,18,19350000
943140,Sparklite,2019,Roguelike,"₩25,600",0%,480,133,613,784640000,327,98,425,544000000
503620,Fictorum,2017,Roguelike,"₩10,500",0%,889,243,1132,594300000,791,223,1014,532350000
2447340,Grave Deceiver,2024,Roguelike,"₩6,700",0%,16,4,20,6700000,16,4,20,6700000
1651520,Holy Grain,2025,Roguelike,"₩16,500",0%,8,2,10,8250000,9,2,11,9075000
2269320,Natti,2023,Roguelike,"₩8,900",0%,71,44,115,51175000,64,44,108,48060000
368680,Super Mutant Alien Assault,2016,Roguelike,"₩11,000",0%,147,25,172,94600000,88,10,98,53900000
3157680,Card of Legend,2025,Roguelike,"₩9,000",0%,19,10,29,13050000,18,11,29,13050000
3308190,Ringer,2025,Roguelike,"₩11,000",0%,17,3,20,11000000,17,3,20,11000000
3081270,Gourds Up,2024,Roguelike,"₩5,600",0%,15,0,15,4200000,10,0,10,2800000
2242220,Forest Fire,2023,Roguelike,"₩4,350",35%,63,6,69,15007500,61,6,67,14572500
1457840,Fishticuffs,2020,Roguelike,"₩5,500",0%,11,0,11,3025000,11,0,11,3025000
2354040,Spaceship Survivors,2023,Roguelike,"₩5,600",0%,11,0,11,3080000,11,0,11,3080000
2933930,Tetra Dungeon,2024,Roguelike,"₩5,600",0%,43,3,46,12880000,23,3,26,7280000
2207480,HELLCARD: Prologue,2023,Roguelike,Free,0%,0,0,0,0,329,54,383,0
2960700,Beyond the Chiron Gate,2024,Roguelike,"₩11,000",0%,16,2,18,9900000,15,2,17,9350000
3828280,Deckstination,2025,Roguelike,Free,0%,0,0,0,0,48,1,49,0
1439460,Hellcraze,2021,Roguelike,Free,0%,19,0,19,0,18,0,18,0
233740,Organ Trail: Director's Cut,2013,Roguelike,"₩5,500",0%,2704,364,3068,843700000,0,0,0,0
2212410,Shadowkin,2024,Roguelike,"₩7,800",0%,65,24,89,34710000,42,20,62,24180000
2171010,The secret pyramid VR,2023,Roguelike,"₩8,900",0%,23,4,27,12015000,21,3,24,10680000
3349850,Balantica,2024,Roguelike,Free,0%,0,0,0,0,106,8,114,0
437550,Melon Simulator™,2025,Roguelike,"₩5,600",0%,78,12,90,25200000,59,11,70,19600000
3349840,InKing,2024,Roguelike,Free,0%,0,0,0,0,108,5,113,0
2207480,HELLCARD: Prologue,2023,Roguelike,Free,0%,0,0,0,0,329,54,383,0
2559500,Survivors of Mayhem,2024,Roguelike,"₩7,800",0%,15,0,15,5850000,15,0,15,5850000
2158810,Cosmic Coliseum,2025,Roguelike,"₩5,600",0%,36,2,38,10640000,41,3,44,12320000
576420,The Curse Of Yendor,2017,Roguelike,"₩11,000",0%,70,5,75,41250000,55,4,59,32450000
1886080,Tetraphobia,2024,Roguelike,"₩12,500",0%,11,0,11,6875000,11,0,11,6875000
1084480,Wanna Survive,2019,Roguelike,"₩12,500",0%,274,18,292,182500000,245,21,266,166250000
524640,Asura: Vengeance Edition,2017,Roguelike,"₩10,500",0%,585,101,686,360150000,469,83,552,289800000
603530,A Robot Named Fight!,2017,Roguelike,"₩14,500",0%,752,103,855,619875000,675,92,767,556075000
2113050,RUNGORE: Beginner Experience,2022,Roguelike,Free,0%,0,0,0,0,776,77,853,0
1151080,Legend of Keepers: Prologue,2019,Roguelike,Free,0%,2187,182,2369,0,0,0,0,0
2171010,The secret pyramid VR,2023,Roguelike,"₩8,900",0%,23,4,27,12015000,21,3,24,10680000
2212410,Shadowkin,2024,Roguelike,"₩7,800",0%,65,24,89,34710000,42,20,62,24180000
1439460,Hellcraze,2021,Roguelike,Free,0%,19,0,19,0,18,0,18,0
2211110,Brick Odyssey,2023,Roguelike,"₩13,500",0%,32,1,33,22275000,17,1,18,12150000
2674970,Devil Slot Machine,2024,Roguelike,"₩6,700",0%,21,3,24,8040000,9,3,12,4020000
2717450,Museum Mystery: Deckbuilding Card Game,2024,Roguelike,Free,0%,0,0,0,0,139,24,163,0
2127230,MOONPONG: Tales of Epic Lunacy,2022,Roguelike,"₩7,500",0%,55,3,58,21750000,43,3,46,17250000
842170,Hyperspace Dogfights,2018,Roguelike,"₩11,000",0%,118,14,132,72600000,96,13,109,59950000
2150180,Deep Dungeon,2022,Roguelike,"₩3,400",0%,12,3,15,2550000,12,2,14,2380000
1274980,Rogue Party 2,2020,Roguelike,"₩3,300",0%,41,3,44,7260000,25,2,27,4455000
2280440,Ogre Chambers DX,2023,Roguelike,Free,0%,0,0,0,0,104,12,116,0
2350810,Glory Room,2023,Roguelike,"₩1,100",0%,23,2,25,1375000,10,2,12,660000
1948290,Before The Last Hour,2022,Roguelike,"₩26,000",0%,29,13,42,54600000,23,9,32,41600000
1456630,Dawn of the Mexica,2020,Roguelike,"₩8,100",40%,26,5,31,12555000,25,5,30,12150000
1456630,Dawn of the Mexica,2020,Roguelike,"₩8,100",40%,26,5,31,12555000,25,5,30,12150000
2280440,Ogre Chambers DX,2023,Roguelike,Free,0%,0,0,0,0,104,12,116,0
2336160,bugTDX,2023,Roguelike,"₩3,400",0%,23,3,26,4420000,22,2,24,4080000
1149860,Arsenal Demon,2019,Roguelike,"₩5,600",0%,20,1,21,5880000,16,0,16,4480000
978790,Frantic Dimension,2018,Roguelike,Free,0%,58,6,64,0,15,1,16,0
524640,Asura: Vengeance Edition,2017,Roguelike,"₩10,500",0%,585,101,686,360150000,469,83,552,289800000
1084480,Wanna Survive,2019,Roguelike,"₩12,500",0%,274,18,292,182500000,245,21,266,166250000
1951660,We See You,2022,Roguelike,"₩7,800",0%,16,0,16,6240000,14,0,14,5460000
2022030,Watcher Of The Abyss,2024,Roguelike,"₩1,100",0%,13,3,16,880000,10,2,12,660000
2113770,In Woods,2024,Roguelike,"₩7,800",0%,145,21,166,64740000,144,28,172,67080000
431810,Rencounter,2016,Roguelike,"₩6,700",0%,259,104,363,121605000,162,66,228,76380000
884260,Akane,2018,Roguelike,"₩5,500",0%,2664,125,2789,766975000,0,0,0,0
1433870,Bricky to Me,2021,Roguelike,"₩3,400",0%,13,0,13,2210000,13,0,13,2210000
2979690,Quest Of Peril,2024,Roguelike,Free,0%,11,2,13,0,11,2,13,0
2083840,Her Name Was Fire,2022,Roguelike,"₩4,400",0%,209,75,284,62480000,200,74,274,60280000
2220320,Space Mercenary Defense Force,2023,Roguelike,"₩2,800",50%,16,3,19,2660000,9,1,10,1400000
2876720,Descent from Arkov's Tower,2024,Roguelike,"₩7,800",0%,0,0,0,0,17,1,18,7020000
364510,Transcendence,2015,Roguelike,"₩15,500",0%,187,26,213,165075000,174,26,200,155000000
1274230,Legend of Kendor,2022,Roguelike,"₩12,500",0%,23,7,30,18750000,22,7,29,18125000
2127230,MOONPONG: Tales of Epic Lunacy,2022,Roguelike,"₩7,500",0%,55,3,58,21750000,43,3,46,17250000
383230,Dungeon Souls,2016,Roguelike,"₩13,500",0%,1647,584,2231,1505925000,1015,303,1318,889650000
2062920,TTV4,2022,Roguelike,"₩1,100",0%,32,0,32,1760000,59,2,61,3355000
2960560,Union of Gnomes: Prologue,2024,Roguelike,Free,0%,0,0,0,0,236,52,288,0
3113890,Zombie Survivors,2024,Roguelike,"₩4,500",0%,16,0,16,3600000,15,0,15,3375000
3167520,Bricks Survivors,2025,Roguelike,"₩5,600",0%,28,0,28,7840000,24,1,25,7000000
239070,Hammerwatch,2013,Roguelike,"₩11,000",0%,5754,681,6435,3539250000,0,0,0,0
2062920,TTV4,2022,Roguelike,"₩1,100",0%,32,0,32,1760000,59,2,61,3355000
2252960,Flashback,2023,Roguelike,"₩1,100",0%,356,53,409,22495000,345,56,401,22055000
2166820,史莱姆冒险战SlimeWarfare,2023,Roguelike,"₩6,700",0%,23,1,24,8040000,18,1,19,6365000
2396300,My Life of Repayment,2023,Roguelike,Free,0%,0,0,0,0,14,3,17,0
740240,Snake Eyes Dungeon,2017,Roguelike,"₩5,600",0%,43,38,81,22680000,18,11,29,8120000
2918600,Clone War,2024,Roguelike,Free,0%,0,0,0,0,13,1,14,0
2451820,Brawl Tactics: Origins,2024,Roguelike,"₩11,620",25%,28,6,34,19754000,27,6,33,19173000
3113890,Zombie Survivors,2024,Roguelike,"₩4,500",0%,16,0,16,3600000,15,0,15,3375000
2490750,The Dungeon Tower,2023,Roguelike,"₩5,600",0%,14,0,14,3920000,10,0,10,2800000
2497850,NUNNA: Prologue,2023,Roguelike,Free,0%,0,0,0,0,15,0,15,0
976120,WARPZONE DRIFTER,2018,Roguelike,"₩1,100",0%,82,20,102,5610000,82,22,104,5720000
2998040,BLOODSAINT,2024,Roguelike,"₩1,100",0%,0,0,0,0,87,3,90,4950000
2150310,元素召唤 Summon Elemental,2023,Roguelike,"₩3,400",0%,51,6,57,9690000,44,6,50,8500000
1557540,Cutie Bear,2021,Roguelike,"₩5,500",0%,10,6,16,4400000,11,2,13,3575000
2991250,Frog 'n' Roll,2024,Roguelike,"₩4,500",0%,22,1,23,5175000,19,1,20,4500000
2870950,Splash Carnival,2024,Roguelike,Free,0%,0,0,0,0,19,4,23,0
1568030,Too Many Cooks,2023,Roguelike,"₩5,600",0%,18,0,18,5040000,15,0,15,4200000
1709040,The Endless Adventure,2021,Roguelike,"₩4,500",0%,13,10,23,5175000,12,5,17,3825000
1408710,Regain Earth: First Strike,2021,Roguelike,"₩13,500",0%,61,11,72,48600000,46,7,53,35775000
1334650,Hell Shuffle,2021,Roguelike,Free,0%,49,4,53,0,49,5,54,0
2086060,DIMENSIONAL SLAUGHTER,2022,Roguelike,"₩9,900",0%,92,24,116,57420000,62,17,79,39105000
928990,Undungeon,2021,Roguelike,"₩4,300",80%,237,131,368,79120000,154,79,233,50095000
3017540,Slice Of Ages,2024,Roguelike,Free,0%,0,0,0,0,14,1,15,0
704950,Scarlett's Dungeon,2017,Roguelike,"₩5,600",0%,37,15,52,14560000,26,11,37,10360000
2086060,DIMENSIONAL SLAUGHTER,2022,Roguelike,"₩9,900",0%,92,24,116,57420000,62,17,79,39105000
1439340,Kittens of Fear,2020,Roguelike,Free,0%,13,2,15,0,13,2,15,0
2018840,UNILOGUE,2022,Roguelike,Free,0%,18,1,19,0,18,1,19,0
2074710,Microbes and Machines,2022,Roguelike,"₩1,100",0%,34,7,41,2255000,34,6,40,2200000
1604840,Super Fowlst 2,2021,Roguelike,"₩4,400",0%,15,1,16,3520000,14,1,15,3300000
1426900,Dread Nautical,2020,Roguelike,"₩20,500",0%,23,9,32,32800000,12,8,20,20500000
2433820,SUPRACORE,2023,Roguelike,"₩5,600",0%,12,1,13,3640000,11,1,12,3360000
794760,ABYSS CRAWLERS plus,2018,Roguelike,"₩5,500",0%,76,6,82,22550000,71,5,76,20900000
1440150,Pixel Survivor - Pixel Up!,2023,Roguelike,"₩1,100",0%,19,5,24,1320000,18,4,22,1210000
1266820,Ultimate ADOM - Caverns of Chaos,2021,Roguelike,"₩20,500",0%,245,246,491,503275000,200,217,417,427425000
576130,State of Anarchy: Master of Mayhem,2017,Roguelike,"₩1,240",0%,481,88,569,35278000,321,57,378,23436000
220460,Cargo Commander,2012,Roguelike,"₩5,600",0%,764,161,925,259000000,539,118,657,183960000
253630,Steam Marines,2014,Roguelike,"₩20,500",0%,166,166,332,340300000,114,106,220,225500000
2259340,Don't Wake God,2023,Roguelike,Free,0%,0,0,0,0,24,4,28,0
957440,Swords and Sandals Pirates,2018,Roguelike,"₩5,460",30%,35,12,47,12831000,29,11,40,10920000
2126370,Wraithbinder,2024,Roguelike,"₩16,500",0%,20,0,20,16500000,13,0,13,10725000
2850100,Dungeon Exiles,2024,Roguelike,"₩5,600",0%,77,28,105,29400000,80,30,110,30800000
2388820,Eternal Survivor,2023,Roguelike,"₩1,100",0%,17,0,17,935000,12,0,12,660000
3422860,Mage at Stake,2025,Roguelike,Free,0%,0,0,0,0,14,3,17,0
407560,Killing Room,2016,Roguelike,"₩16,500",0%,990,433,1423,1173975000,885,361,1246,1027950000
2507400,Penny Blood: Hellbound,2024,Roguelike,"₩27,000",0%,87,11,98,132300000,59,10,69,93150000
1667770,Samurai Shampoo Classic,2021,Roguelike,Free,0%,0,0,0,0,156,19,175,0
401910,Darknet,2017,Roguelike,"₩16,000",0%,112,12,124,99200000,61,9,70,56000000
3017170,Luck Auto Chess,2024,Roguelike,"₩15,500",0%,27,7,34,26350000,21,7,28,21700000
3055000,Hell's Descent,2024,Roguelike,Free,0%,12,0,12,0,13,0,13,0
1608550,Firegirl: Hack 'n Splash Rescue DX,2021,Roguelike,"₩18,500",0%,206,91,297,274725000,114,53,167,154475000
3422860,Mage at Stake,2025,Roguelike,Free,0%,0,0,0,0,14,3,17,0
253630,Steam Marines,2014,Roguelike,"₩20,500",0%,166,166,332,340300000,114,106,220,225500000
1667770,Samurai Shampoo Classic,2021,Roguelike,Free,0%,0,0,0,0,156,19,175,0
2783850,Superation,2025,Roguelike,"₩5,600",0%,0,0,0,0,10,0,10,2800000
2388820,Eternal Survivor,2023,Roguelike,"₩1,100",0%,17,0,17,935000,12,0,12,660000
1952930,Soul Wargame,2023,Roguelike,"₩8,000",0%,111,22,133,53200000,82,22,104,41600000
764370,Realm of the Ghost King,2018,Roguelike,"₩3,300",0%,13,1,14,2310000,9,1,10,1650000
3055000,Hell's Descent,2024,Roguelike,Free,0%,12,0,12,0,13,0,13,0
2443160,Rat Catcher,2023,Roguelike,"₩1,100",0%,28,1,29,1595000,24,1,25,1375000
1668620,Castles on Clouds,2024,Roguelike,"₩3,400",0%,25,0,25,4250000,25,0,25,4250000
2315020,Froguelike,2024,Roguelike,"₩3,400",0%,165,5,170,28900000,151,5,156,26520000
2489460,Cropisle TD,2023,Roguelike,"₩2,300",0%,39,6,45,5175000,28,6,34,3910000
3017170,Luck Auto Chess,2024,Roguelike,"₩15,500",0%,27,7,34,26350000,21,7,28,21700000
338320,Pixel Heroes: Byte & Magic,2015,Roguelike,"₩11,000",0%,432,139,571,314050000,235,66,301,165550000
1869310,Paper Wizards,2022,Roguelike,Free,0%,0,0,0,0,46,9,55,0
1163740,Card Hog,2023,Roguelike,"₩6,700",0%,501,27,528,176880000,425,27,452,151420000
1849800,Cramit's Keep,2022,Roguelike,"₩5,500",0%,14,0,14,3850000,10,0,10,2750000
2507400,Penny Blood: Hellbound,2024,Roguelike,"₩27,000",0%,87,11,98,132300000,59,10,69,93150000
2278830,GunSuit Guardians,2023,Roguelike,"₩3,400",0%,207,26,233,39610000,182,27,209,35530000
2490160,NecroAttack！,2023,Roguelike,"₩11,000",0%,191,67,258,141900000,163,67,230,126500000
554710,Spell Cast,2022,Roguelike,"₩1,100",0%,39,19,58,3190000,31,17,48,2640000
1524350,ReversEstory,2021,Roguelike,"₩5,600",0%,71,10,81,22680000,64,9,73,20440000
3273740,Abyss Chaser,2025,Roguelike,"₩7,430",0%,13,0,13,4829500,12,0,12,4458000
2456130,Demon's Bane,2023,Roguelike,"₩3,400",0%,11,0,11,1870000,11,2,13,2210000
1524350,ReversEstory,2021,Roguelike,"₩5,600",0%,71,10,81,22680000,64,9,73,20440000
3072680,Made in Tower,2024,Roguelike,"₩2,300",0%,20,0,20,2300000,17,0,17,1955000
2704720,Orbius,2023,Roguelike,"₩3,400",0%,18,2,20,3400000,16,2,18,3060000
2669440,元卡牌2 - MetaCard2,2024,Roguelike,"₩7,800",0%,46,2,48,18720000,27,1,28,10920000
1538350,Unit Down,2021,Roguelike,"₩5,500",0%,25,0,25,6875000,14,0,14,3850000
2955410,Hell Miners,2024,Roguelike,Free,0%,0,0,0,0,12,1,13,0
542350,Castle of no Escape 2,2016,Roguelike,₩880,84%,333,103,436,19184000,246,86,332,14608000
2331920,HOLYHUNT,2024,Roguelike,"₩6,500",0%,16,1,17,5525000,15,1,16,5200000
981880,GrowRilla VR,2020,Roguelike,"₩16,500",0%,74,8,82,67650000,58,5,63,51975000
1622560,Interplanetary Gardener,2022,Roguelike,"₩5,600",0%,10,3,13,3640000,9,2,11,3080000
2325040,DETUNED,2023,Roguelike,"₩6,700",0%,16,1,17,5695000,13,1,14,4690000
2688600,Descent from Arkov's tower Prologue,2024,Roguelike,Free,0%,0,0,0,0,17,2,19,0
2761340,Beats of Betrayal,2024,Roguelike,"₩13,500",0%,31,0,31,20925000,31,0,31,20925000
2541310,The Cable Guy,2024,Roguelike,"₩8,900",0%,43,4,47,20915000,35,5,40,17800000
364300,Space Rogue,2016,Roguelike,"₩10,500",0%,289,159,448,235200000,239,152,391,205275000
3069320,Chimera,2024,Roguelike,"₩6,700",0%,19,3,22,7370000,17,4,21,7035000
1630690,Equin 2: The Warren Peace,2021,Roguelike,"₩10,500",0%,15,0,15,7875000,12,0,12,6300000
1611710,Geadows,2021,Roguelike,Free,0%,0,0,0,0,59,12,71,0
2484060,"I, Toaster",2023,Roguelike,Free,0%,0,0,0,0,47,7,54,0
3831220,Is this a Game yet?,2025,Roguelike,"₩1,840",19%,0,0,0,0,10,1,11,1012000
1518690,Nevermore: The Chamber Door,2022,Roguelike,"₩8,500",0%,51,7,58,24650000,34,7,41,17425000
2462090,Star Knight: Order of the Vortex,2024,Roguelike,"₩5,600",0%,13,0,13,3640000,10,0,10,2800000
2555830,Dino Tower Arena,2025,Roguelike,"₩4,500",0%,0,0,0,0,27,0,27,6075000
1693660,Cards of Patience,2021,Roguelike,"₩5,500",0%,19,3,22,6050000,16,4,20,5500000
2539180,Mayhem Survivors: Animals,2024,Roguelike,Free,0%,0,0,0,0,23,4,27,0
2555830,Dino Tower Arena,2025,Roguelike,"₩4,500",0%,0,0,0,0,27,0,27,6075000
2539180,Mayhem Survivors: Animals,2024,Roguelike,Free,0%,0,0,0,0,23,4,27,0
3826020,Stop Breaking My Castle!,2025,Roguelike,Free,0%,0,0,0,0,17,1,18,0
2001280,The Last City,2022,Roguelike,"₩5,500",0%,22,10,32,8800000,38,20,58,15950000
1915800,Sahara's Underworld,2022,Roguelike,"₩9,500",0%,13,1,14,6650000,12,0,12,5700000
2241390,Spelp,2023,Roguelike,"₩5,600",0%,51,6,57,15960000,48,6,54,15120000
880870,Donut Arena,2022,Roguelike,"₩5,600",0%,17,0,17,4760000,13,0,13,3640000
2480000,Nightshift Survival,2023,Roguelike,"₩3,400",0%,43,4,47,7990000,38,4,42,7140000
1693660,Cards of Patience,2021,Roguelike,"₩5,500",0%,19,3,22,6050000,16,4,20,5500000
295590,Hero Generations,2015,Roguelike,"₩6,500",0%,122,101,223,72475000,80,86,166,53950000
3410640,Rogue Worlds,2025,Roguelike,Free,0%,0,0,0,0,46,0,46,0
2235090,回溯勇者/Backdate Hero,2023,Roguelike,"₩3,400",0%,23,3,26,4420000,14,2,16,2720000
2591290,Tabletop Hero,2024,Roguelike,"₩9,900",0%,42,9,51,25245000,35,6,41,20295000
973060,恶魔迷宫 2 |Evil Maze 2 | 惡魔迷宮 2,2019,Roguelike,"₩11,000",0%,69,35,104,57200000,50,34,84,46200000
2354560,ClickeRogue,2024,Roguelike,"₩3,400",0%,19,5,24,4080000,18,6,24,4080000
1155420,Dino Zoo Transport Simulator,2019,Roguelike,"₩5,600",0%,83,33,116,32480000,42,13,55,15400000
326720,Instant Dungeon!,2014,Roguelike,"₩2,300",0%,153,23,176,20240000,122,20,142,16330000
3096270,NETHER DUNGEONS,2024,Roguelike,Free,0%,0,0,0,0,323,57,380,0
3347250,flood of zombies,2025,Roguelike,"₩3,400",0%,20,2,22,3740000,20,2,22,3740000
2998990,Tilemancer Dungeon,2025,Roguelike,"₩8,900",0%,17,0,17,7565000,16,0,16,7120000
2072360,Delicious Dungeon,2023,Roguelike,"₩8,900",0%,27,10,37,16465000,23,9,32,14240000
3190430,Terror Diversion,2025,Roguelike,"₩16,500",0%,5,4,9,7425000,5,5,10,8250000
2316700,Cursed Halls,2024,Roguelike,"₩3,900",50%,27,2,29,5655000,20,2,22,4290000
2455110,Yokai Art: Survival Prologue,2023,Roguelike,Free,0%,0,0,0,0,53,3,56,0
1827760,Dungeon Death,2021,Roguelike,"₩11,500",0%,11,2,13,7475000,8,2,10,5750000
392260,Rogue Wizards,2016,Roguelike,"₩16,000",0%,192,56,248,198400000,97,26,123,98400000
1664670,Refactor,2022,Roguelike,"₩5,600",0%,386,64,450,126000000,354,62,416,116480000
2271030,Tacape,2023,Roguelike,"₩7,800",0%,27,4,31,12090000,19,2,21,8190000
800550,DarkDIRE: The Advanced Set,2018,Roguelike,"₩4,400",0%,18,2,20,4400000,13,2,15,3300000
3159440,Cultivation Story: Infinite Sword Realm,2025,Roguelike,"₩13,200",19%,0,0,0,0,15,10,25,16500000
1076480,Dream Flash,2019,Roguelike,"₩7,500",0%,47,0,47,17625000,31,0,31,11625000
2396380,黑暗塔 (The Dark Tower),2023,Roguelike,"₩1,100",0%,15,3,18,990000,13,3,16,880000
2438770,Chores of Corruption,2023,Roguelike,"₩5,600",0%,23,1,24,6720000,13,1,14,3920000
1919720,Crimson Dawn,2023,Roguelike,"₩4,500",0%,237,132,369,83025000,196,131,327,73575000
685340,Delivery from the Pain:Survival / 末日方舟:生存,2019,Roguelike,"₩8,900",0%,807,193,1000,445000000,636,169,805,358225000
1141220,DemonCrawl,2019,Roguelike,"₩15,500",0%,950,254,1204,933100000,863,243,1106,857150000
294370,Crowntakers,2014,Roguelike,"₩11,000",0%,486,175,661,363550000,288,96,384,211200000
2817910,The Nightwatch,2024,Roguelike,"₩5,600",0%,27,4,31,8680000,27,4,31,8680000
801290,Diabolic,2018,Roguelike,"₩8,900",0%,321,62,383,170435000,255,45,300,133500000
2658490,The Dark Survivors,2024,Roguelike,"₩1,100",0%,15,5,20,1100000,12,5,17,935000
2696390,Guns And Draguns,2024,Roguelike,"₩14,500",0%,17,0,17,12325000,14,0,14,10150000
442210,Switchcars,2021,Roguelike,"₩9,500",0%,412,44,456,216600000,146,16,162,76950000
1598180,Seishin Destiny,2021,Roguelike,"₩5,500",0%,14,0,14,3850000,10,0,10,2750000
1537480,玉言·离光,2024,Roguelike,"₩7,800",0%,127,51,178,69420000,64,32,96,37440000
3813480,Game Tech Simulator,2025,Roguelike,"₩3,400",0%,0,0,0,0,10,1,11,1870000
2636410,Stranded,2024,Roguelike,"₩16,500",0%,28,5,33,27225000,18,5,23,18975000
310070,The Nightmare Cooperative,2014,Roguelike,"₩5,500",0%,64,65,129,35475000,13,8,21,5775000
2790020,Space Sprouts,2025,Roguelike,"₩12,500",0%,45,0,45,28125000,38,0,38,23750000
1632140,Girl Agent,2022,Roguelike,"₩3,400",0%,45,6,51,8670000,27,5,32,5440000
2534660,Alaca,2023,Roguelike,"₩5,600",0%,27,1,28,7840000,14,1,15,4200000
3108000,Only Trump: Up To Presidents!,2024,Roguelike,"₩6,900",0%,0,0,0,0,25,9,34,11730000
919370,Overdungeon,2019,Roguelike,"₩16,500",0%,2447,629,3076,2537700000,0,0,0,0
1559700,Dreamer,2021,Roguelike,"₩2,300",0%,27,2,29,3335000,27,1,28,3220000
280040,A Wizard's Lizard,2014,Roguelike,"₩10,500",0%,312,131,443,232575000,166,75,241,126525000
2959310,Warlords of the Deck,2024,Roguelike,"₩8,900",0%,48,8,56,24920000,41,12,53,23585000
311720,Sproggiwood,2014,Roguelike,"₩16,500",0%,467,117,584,481800000,252,67,319,263175000
2606550,Farmer Survivors,2024,Roguelike,"₩4,500",0%,29,7,36,8100000,21,3,24,5400000
2199060,Core Devourer,2024,Roguelike,"₩6,700",0%,79,21,100,33500000,57,25,82,27470000
1433430,Level 20,2020,Roguelike,"₩1,100",0%,15,0,15,825000,14,0,14,770000
269310,Infectonator: Survivors,2016,Roguelike,"₩11,000",0%,742,361,1103,606650000,640,315,955,525250000
959090,WayDown,2018,Roguelike,Free,0%,10,1,11,0,10,1,11,0
2323980,Dungeons & Jewels,2023,Roguelike,"₩5,600",0%,88,8,96,26880000,81,8,89,24920000
402120,Deathstate: Abyssal Edition,2015,Roguelike,"₩10,500",0%,303,49,352,184800000,240,46,286,150150000
2766770,这是一个正方形！（This Is A Square！）,2024,Roguelike,"₩4,500",0%,24,0,24,5400000,10,0,10,2250000
3178660,Blood Rising,2024,Roguelike,Free,0%,0,0,0,0,11,1,12,0
3393180,Sweep,2025,Roguelike,"₩7,800",0%,16,4,20,7800000,13,4,17,6630000
1650200,Scholar of the Arcane Arts,2025,Roguelike,"₩4,500",0%,31,2,33,7425000,22,3,25,5625000
1304090,Cannibal Crossing,2022,Roguelike,"₩20,500",0%,157,95,252,258300000,143,81,224,229600000
3160160,Six-Ear Macaque: Awakening,2025,Roguelike,"₩7,800",0%,98,0,98,38220000,89,0,89,34710000
2877790,Rogue Girl,2024,Roguelike,"₩2,300",0%,27,12,39,4485000,26,13,39,4485000
2963830,Skel Dungeon: Heroes Must Die!,2024,Roguelike,"₩9,900",0%,11,6,17,8415000,6,5,11,5445000
2375570,Champion's Chalice,2024,Roguelike,"₩11,000",0%,18,3,21,11550000,16,3,19,10450000
438440,Star Rogue,2016,Roguelike,Free,0%,26,3,29,0,26,3,29,0
1029980,UBERMOSH Vol.7,2019,Roguelike,"₩1,100",0%,160,24,184,10120000,263,54,317,17435000
3424920,DarkRanger,2025,Roguelike,"₩13,500",0%,0,0,0,0,25,9,34,22950000
2602290,TH3-M15 GUILD,2024,Roguelike,"₩6,700",0%,18,0,18,6030000,15,0,15,5025000
2027350,Wanderer,2022,Roguelike,"₩5,500",0%,17,7,24,6600000,37,11,48,13200000
1704120,IT Startup: Tech Fodder,2024,Roguelike,"₩6,600",40%,27,0,27,8910000,26,0,26,8580000
3019360,Hiragana Hero,2025,Roguelike,"₩11,000",0%,18,0,18,9900000,15,0,15,8250000
2455500,Time Survivors: Chapter 0,2023,Roguelike,Free,0%,0,0,0,0,133,31,164,0
2399310,Lhama Clicker Prologue,2023,Roguelike,Free,0%,0,0,0,0,83,8,91,0
2321770,The Druid,2023,Roguelike,Free,0%,0,0,0,0,109,19,128,0
2943390,MOON THIRST,2024,Roguelike,"₩32,000",0%,10,3,13,20800000,10,2,12,19200000
527990,Gladiator Trainer,2016,Roguelike,"₩2,300",0%,195,78,273,31395000,173,61,234,26910000
1289750,Operation Zeta,2022,Roguelike,"₩10,500",0%,16,1,17,8925000,10,0,10,5250000
2443090,Deathless: Survivors,2024,Roguelike,"₩11,000",0%,127,69,196,107800000,122,68,190,104500000
1987260,The Nine Tailed Celestial Fox,2024,Roguelike,"₩11,000",0%,19,3,22,12100000,11,3,14,7700000
2516980,Heroes & Redemption,2024,Roguelike,Free,0%,44,11,55,0,57,12,69,0
2849070,Soulkin,2025,Roguelike,"₩11,000",0%,32,3,35,19250000,22,3,25,13750000
2500680,Tiny Chaos,2024,Roguelike,"₩5,600",0%,38,7,45,12600000,31,3,34,9520000
3558190,GnollHack,2025,Roguelike,Free,0%,0,0,0,0,18,5,23,0
2155280,Defend Earth: Xenos Survivors,2023,Roguelike,"₩5,600",0%,45,7,52,14560000,33,4,37,10360000
2073490,To the Stars,2024,Roguelike,"₩16,500",0%,40,4,44,36300000,38,4,42,34650000
1499770,Echoes of Mayhem®,2023,Roguelike,"₩11,000",0%,15,2,17,9350000,10,1,11,6050000
3183360,NABI,2024,Roguelike,"₩2,700",0%,0,0,0,0,32,20,52,7020000
2814280,Cellfish,2024,Roguelike,"₩5,600",0%,39,7,46,12880000,40,9,49,13720000
2421480,Poly,2025,Roguelike,Free,0%,29,6,35,0,31,7,38,0
1535100,Nadir: A Grimdark Deckbuilder,2023,Roguelike,"₩19,900",0%,197,118,315,313425000,147,86,233,231835000
389160,Shadow Ninja: Apocalypse,2015,Roguelike,"₩1,700",0%,104,77,181,15385000,82,65,147,12495000
492290,Has-Been Heroes,2017,Roguelike,"₩21,000",0%,290,90,380,399000000,204,54,258,270900000
2171270,Legend of Feather,2022,Roguelike,"₩4,500",0%,36,11,47,10575000,27,9,36,8100000
2583760,Louma,2023,Roguelike,Free,0%,0,0,0,0,35,12,47,0
3613450,Coil's Containment,2025,Roguelike,"₩2,300",0%,16,0,16,1840000,14,0,14,1610000
2541990,Dash x Survivors,2024,Roguelike,"₩6,700",0%,27,1,28,9380000,23,1,24,8040000
2836750,Super Infection Massive Pathology,2025,Roguelike,"₩11,000",0%,0,0,0,0,13,1,14,7700000
3582020,EvilSlayer,2025,Roguelike,"₩4,500",0%,34,8,42,9450000,23,9,32,7200000
1147850,Brother Brother,2019,Roguelike,Free,0%,37,1,38,0,39,1,40,0
568400,Depths of Limbo,2017,Roguelike,Free,0%,56,19,75,0,55,19,74,0
2412280,Valiant Tactics,2025,Roguelike,"₩16,000",0%,0,0,0,0,11,2,13,10400000
2215340,Shishi : Timeless Prelude,2023,Roguelike,"₩21,500",0%,12,0,12,12900000,11,0,11,11825000
511540,MoonQuest,2020,Roguelike,"₩20,500",0%,81,27,108,110700000,58,21,79,80975000
343100,Overture,2015,Roguelike,"₩5,500",0%,949,303,1252,344300000,402,164,566,155650000
1253860,Neurodeck : Psychological Deckbuilder,2021,Roguelike,"₩14,500",0%,158,101,259,187775000,86,79,165,119625000
2318630,The Territory of Egg,2023,Roguelike,"₩3,400",0%,47,1,48,8160000,34,1,35,5950000
2027970,Sole Saga,2023,Roguelike,"₩7,800",0%,85,29,114,44460000,49,25,74,28860000
2290200,Neon City Survivor,2023,Roguelike,"₩5,600",0%,16,4,20,5600000,13,3,16,4480000
3503050,Dream fallen remake - village,2025,Roguelike,"₩5,600",0%,8,4,12,3360000,11,6,17,4760000
3025740,UNKILLABLE ROBOTS,2024,Roguelike,"₩32,000",0%,10,3,13,20800000,10,0,10,16000000
1243890,Sword of the Necromancer,2021,Roguelike,"₩15,500",0%,238,120,358,277450000,188,81,269,208475000
1895820,Greedventory,2023,Roguelike,"₩21,500",0%,187,46,233,250475000,156,47,203,218225000
644580,Slash or Die 2,2018,Roguelike,"₩6,700",0%,28,3,31,10385000,18,1,19,6365000
299600,Dragon Fin Soup,2015,Roguelike,"₩21,000",0%,168,125,293,307650000,87,60,147,154350000
290890,You Must Build A Boat,2015,Roguelike,"₩5,500",0%,862,187,1049,288475000,661,155,816,224400000
381900,Bard's Gold,2015,Roguelike,"₩8,500",0%,104,29,133,56525000,76,18,94,39950000
1891940,Dr. Science quest,2022,Roguelike,"₩5,500",0%,12,4,16,4400000,9,1,10,2750000
1243890,Sword of the Necromancer,2021,Roguelike,"₩15,500",0%,238,120,358,277450000,188,81,269,208475000
2362010,Impact,2023,Roguelike,"₩3,940",0%,13,3,16,3152000,11,3,14,2758000
2353680,Dice World,2023,Roguelike,"₩5,600",0%,13,1,14,3920000,11,1,12,3360000
381900,Bard's Gold,2015,Roguelike,"₩8,500",0%,104,29,133,56525000,76,18,94,39950000
1895820,Greedventory,2023,Roguelike,"₩21,500",0%,187,46,233,250475000,156,47,203,218225000
1891940,Dr. Science quest,2022,Roguelike,"₩5,500",0%,12,4,16,4400000,9,1,10,2750000
2574030,Snake Crush,2024,Roguelike,"₩4,500",0%,106,11,117,26325000,84,11,95,21375000
1000080,Zengeon,2019,Roguelike,"₩20,500",0%,1022,517,1539,1577475000,813,400,1213,1243325000
1995090,STEIIARIA,2022,Roguelike,"₩5,500",0%,16,3,19,5225000,11,5,16,4400000
2148060,Hack & Schlitz,2022,Roguelike,"₩2,300",0%,14,0,14,1610000,13,0,13,1495000
368610,The Enchanted Cave 2,2015,Roguelike,"₩10,500",0%,713,80,793,416325000,620,77,697,365925000
990640,Numgeon,2018,Roguelike,"₩5,600",0%,62,19,81,22680000,51,15,66,18480000
1880160,元卡牌MetaCard,2023,Roguelike,"₩6,700",0%,36,8,44,14740000,24,8,32,10720000
920680,Fate Hunters,2019,Roguelike,"₩15,500",0%,679,182,861,667275000,613,183,796,616900000
2608400,Regular Spacecraft - Defending the Mothership,2023,Roguelike,"₩1,100",0%,15,1,16,880000,15,1,16,880000
290890,You Must Build A Boat,2015,Roguelike,"₩5,500",0%,862,187,1049,288475000,661,155,816,224400000
226120,Weird Worlds: Return to Infinite Space,2013,Roguelike,"₩5,500",0%,397,209,606,166650000,124,37,161,44275000
2149430,Click To Sail,2022,Roguelike,"₩2,200",0%,40,10,50,5500000,35,10,45,4950000
2945350,Wukong's Pool,2024,Roguelike,"₩6,700",0%,18,2,20,6700000,10,2,12,4020000
2434090,Death Roads: Tournament Prologue,2023,Roguelike,Free,0%,30,8,38,0,31,8,39,0
1622030,Heard There Was A Chosen One,2021,Roguelike,Free,0%,0,0,0,0,13,0,13,0
550840,Fresh Body,2021,Roguelike,"₩10,160",0%,973,328,1301,660908000,0,0,0,0
1228320,Dungeon Looter,2024,Roguelike,"₩13,500",0%,70,19,89,60075000,58,19,77,51975000
255070,Abyss Odyssey,2014,Roguelike,"₩6,200",60%,1576,937,2513,779030000,846,416,1262,391220000
912550,Savage Vessels,2020,Roguelike,"₩13,500",0%,34,8,42,28350000,31,8,39,26325000
1531010,Collisus,2021,Roguelike,"₩5,500",0%,19,4,23,6325000,14,3,17,4675000
2780310,Silicon War:Blitz,2024,Roguelike,"₩5,600",0%,11,1,12,3360000,12,1,13,3640000
1302440,RogueJack: Roguelike Blackjack,2020,Roguelike,"₩5,600",0%,38,10,48,13440000,32,9,41,11480000
2148060,Hack & Schlitz,2022,Roguelike,"₩2,300",0%,14,0,14,1610000,13,0,13,1495000
2434090,Death Roads: Tournament Prologue,2023,Roguelike,Free,0%,30,8,38,0,31,8,39,0
1228320,Dungeon Looter,2024,Roguelike,"₩13,500",0%,70,19,89,60075000,58,19,77,51975000
2398660,The Dream Labyrinth,2024,Roguelike,"₩16,500",0%,35,8,43,35475000,35,8,43,35475000
1431150,LongPath,2020,Roguelike,"₩2,200",0%,9,2,11,1210000,9,2,11,1210000
3338600,The Last Experiment: A Memetric Story,2025,Roguelike,"₩13,500",0%,18,0,18,12150000,11,0,11,7425000
600610,The Hand of Merlin,2022,Roguelike,"₩28,000",0%,252,99,351,491400000,206,89,295,413000000
2719650,Project XSTING,2024,Roguelike,"₩8,900",0%,15,0,15,6675000,14,0,14,6230000
1117480,Dead Hand,2019,Roguelike,"₩26,000",0%,21,6,27,35100000,20,6,26,33800000
2560260,Oni Station,2023,Roguelike,"₩5,600",0%,13,2,15,4200000,12,1,13,3640000
418150,The Madness of Little Emma,2015,Roguelike,"₩9,900",0%,115,29,144,71280000,94,30,124,61380000
1037940,Dead Monarchy,2023,Roguelike,"₩10,500",0%,109,22,131,68775000,105,23,128,67200000
2490080,Last Hopeless,2023,Roguelike,"₩6,700",0%,21,0,21,7035000,21,0,21,7035000
338190,Just Get Through,2015,Roguelike,"₩5,600",0%,186,32,218,61040000,135,26,161,45080000
3862650,Stonehold,2025,Roguelike,Free,0%,0,0,0,0,9,1,10,0
719520,Spectro,2020,Roguelike,"₩15,500",0%,54,10,64,49600000,41,9,50,38750000
1452000,"It's Six Random Characters and a Single Floor Dungeon, That's the Whole Game",2020,Roguelike,"₩5,500",0%,12,4,16,4400000,11,4,15,4125000
1969430,Desert Revenant,2022,Roguelike,"₩15,500",0%,42,7,49,37975000,20,5,25,19375000
1632330,Calamity Eliminator,2021,Roguelike,"₩8,500",0%,62,23,85,36125000,57,22,79,33575000
1077090,Bucket Knight,2019,Roguelike,₩820,85%,37,8,45,1845000,33,7,40,1640000
3596030,Sweepin' XS,2025,Roguelike,"₩5,600",0%,0,0,0,0,15,0,15,4200000
2428020,The Abyss Within,2024,Roguelike,"₩5,600",0%,21,0,21,5880000,18,0,18,5040000
1410140,Load Roll Die,2021,Roguelike,"₩11,000",0%,13,2,15,8250000,9,2,11,6050000
2475020,Light Speed Ride Out,2023,Roguelike,"₩5,600",0%,18,1,19,5320000,18,1,19,5320000
1366260,Soul Device,2023,Roguelike,"₩5,600",0%,13,2,15,4200000,12,2,14,3920000
1730550,Panta Rhei - Guardian of Time,2025,Roguelike,"₩18,500",0%,0,0,0,0,14,0,14,12950000
1105660,Stay Safe: Labyrinth of the Mad,2019,Roguelike,"₩6,500",0%,32,10,42,13650000,25,9,34,11050000
3087810,Recesses,2024,Roguelike,"₩5,600",0%,57,2,59,16520000,52,1,53,14840000
3214070,Fair and Square,2025,Roguelike,Free,0%,0,0,0,0,22,4,26,0
338190,Just Get Through,2015,Roguelike,"₩5,600",0%,186,32,218,61040000,135,26,161,45080000
311480,Vertical Drop Heroes HD,2014,Roguelike,"₩7,500",0%,591,141,732,274500000,114,34,148,55500000
1037940,Dead Monarchy,2023,Roguelike,"₩10,500",0%,109,22,131,68775000,105,23,128,67200000
2726180,Die Erdnussbutter,2024,Roguelike,"₩1,100",0%,49,1,50,2750000,47,1,48,2640000
2331710,Sky Survivors,2023,Roguelike,"₩5,600",0%,33,3,36,10080000,23,3,26,7280000
719520,Spectro,2020,Roguelike,"₩15,500",0%,54,10,64,49600000,41,9,50,38750000
269690,RymdResa,2015,Roguelike,"₩13,500",0%,225,79,304,205200000,158,65,223,150525000
491510,Vanilla Bagel: The Roguelike,2016,Roguelike,"₩13,500",0%,25,13,38,25650000,23,11,34,22950000
3065920,Black Myth: Heaven,2024,Roguelike,Free,0%,33,11,44,0,35,14,49,0
1926660,OUTLANDER,2022,Roguelike,Free,0%,9,0,9,0,10,0,10,0
1078490,Seed Hunter 猎源,2020,Roguelike,"₩9,500",0%,257,118,375,178125000,170,87,257,122075000
2428310,天行镖客 (Sky Escort),2024,Roguelike,"₩11,000",0%,66,12,78,42900000,43,13,56,30800000
770070,Swords and Sandals 5 Redux: Maximus Edition,2018,Roguelike,"₩7,800",0%,120,70,190,74100000,118,70,188,73320000
2261040,NUMANUIN,2024,Roguelike,"₩5,600",0%,21,1,22,6160000,18,1,19,5320000
742530,Roguemance,2018,Roguelike,"₩7,500",0%,36,14,50,18750000,27,12,39,14625000
3417900,Mine & Slash,2025,Roguelike,"₩11,000",0%,13,2,15,8250000,7,3,10,5500000
1960330,Alchemia: Creatio Ex Nihilo,2025,Roguelike,"₩21,500",0%,21,2,23,24725000,17,3,20,21500000
1784630,Alice!,2022,Roguelike,"₩10,500",0%,40,12,52,27300000,34,12,46,24150000
3417900,Mine & Slash,2025,Roguelike,"₩11,000",0%,13,2,15,8250000,7,3,10,5500000
3443440,Dungeon Battles,2025,Roguelike,"₩2,300",0%,12,1,13,1495000,11,1,12,1380000
1264420,Archery Simulator,2023,Roguelike,"₩3,400",0%,24,1,25,4250000,14,1,15,2550000
1960330,Alchemia: Creatio Ex Nihilo,2025,Roguelike,"₩21,500",0%,21,2,23,24725000,17,3,20,21500000
1364710,Skycadia,2020,Roguelike,"₩10,500",0%,20,2,22,11550000,16,2,18,9450000
295870,The Dungeoning,2014,Roguelike,"₩4,400",0%,52,21,73,16060000,45,18,63,13860000
1989140,Tower of Spirit,2024,Roguelike,"₩5,600",0%,27,2,29,8120000,22,1,23,6440000
570980,Tale of Fallen Dragons,2017,Roguelike,"₩10,500",0%,419,65,484,254100000,306,58,364,191100000
1255050,Craft In Abyss,2021,Roguelike,"₩10,500",0%,45,9,54,28350000,33,5,38,19950000
1656880,Dungless,2021,Roguelike,"₩3,400",0%,19,8,27,4590000,15,5,20,3400000
2850970,The Great Couturier,2024,Roguelike,"₩2,800",50%,12,3,15,2100000,9,3,12,1680000
1928030,"Rightfully, Beary Arms",2023,Roguelike,"₩11,000",0%,25,0,25,13750000,18,0,18,9900000
3023170,Dice Player One: Trailer,2024,Roguelike,Free,0%,0,0,0,0,37,1,38,0
420920,Lost Labyrinth Extended Version,2015,Roguelike,"₩5,600",0%,39,23,62,17360000,35,21,56,15680000
600630,Spaceship Looter,2017,Roguelike,Free,0%,162,66,228,0,163,67,230,0
1309510,Glaze Cup: Journey to the West,2024,Roguelike,"₩16,500",0%,137,31,168,138600000,109,33,142,117150000
1325520,Mezmeratu,2020,Roguelike,"₩8,500",0%,12,4,16,6800000,12,3,15,6375000
306550,Runers,2014,Roguelike,"₩10,500",0%,227,57,284,149100000,180,48,228,119700000
2860270,Orbs of Chaos,2024,Roguelike,"₩5,600",0%,23,2,25,7000000,18,2,20,5600000
1847150,Touhou Genso Wanderer -FORESIGHT-,2024,Roguelike,"₩37,500",0%,146,158,304,570000000,129,158,287,538125000
3432500,Sin and Love,2025,Roguelike,"₩16,500",0%,162,53,215,177375000,148,69,217,179025000
2792960,METAL BEANS,2024,Roguelike,Free,0%,0,0,0,0,47,4,51,0
386710,C:\raft,2017,Roguelike,"₩4,500",0%,18,13,31,6975000,13,5,18,4050000
2570710,Let Him Cook,2024,Roguelike,"₩7,800",0%,39,0,39,15210000,32,0,32,12480000
1359730,Artifice: War Tactics,2024,Roguelike,"₩16,500",0%,12,8,20,16500000,10,6,16,13200000
640380,UBERMOSH Vol.5,2017,Roguelike,"₩1,100",0%,321,20,341,18755000,689,60,749,41195000
2570710,Let Him Cook,2024,Roguelike,"₩7,800",0%,39,0,39,15210000,32,0,32,12480000
1847150,Touhou Genso Wanderer -FORESIGHT-,2024,Roguelike,"₩37,500",0%,146,158,304,570000000,129,158,287,538125000
428350,Fear Equation,2016,Roguelike,"₩16,500",0%,70,23,93,76725000,50,17,67,55275000
1359730,Artifice: War Tactics,2024,Roguelike,"₩16,500",0%,12,8,20,16500000,10,6,16,13200000
1290090,The Wicked Days,2021,Roguelike,"₩20,500",0%,26,7,33,33825000,14,6,20,20500000
327510,WASTED,2016,Roguelike,"₩14,000",0%,899,272,1171,819700000,487,129,616,431200000
1209140,Peace Data,2020,Roguelike,"₩4,500",0%,193,21,214,48150000,166,20,186,41850000
1366520,Dungeon Limbus,2021,Roguelike,"₩15,500",0%,12,9,21,16275000,8,8,16,12400000
1183840,Dungeon of Rikka,2020,Roguelike,"₩5,500",0%,24,4,28,7700000,17,3,20,5500000
1418020,Tavern of Gods,2021,Roguelike,"₩9,320",0%,621,171,792,369072000,586,175,761,354626000
872040,Hovership Havoc,2019,Roguelike,"₩10,500",0%,24,7,31,16275000,12,6,18,9450000
429620,Dungeon Rushers,2016,Roguelike,"₩16,000",0%,758,460,1218,974400000,495,291,786,628800000
2330870,CD 2: Trap Master,2024,Roguelike,"₩16,500",0%,294,69,363,299475000,257,68,325,268125000
515010,A Duel Hand Disaster: Trackher,2024,Roguelike,"₩10,500",0%,31,2,33,17325000,11,0,11,5775000
2539880,C.A.R.D.S. RPG: The Misty Battlefield,2024,Roguelike,"₩42,000",0%,43,40,83,174300000,35,39,74,155400000
2320280,Nova Strike,2023,Roguelike,"₩11,000",0%,8,5,13,7150000,7,4,11,6050000
2146180,Cyclo Chambers,2023,Roguelike,"₩5,600",0%,114,22,136,38080000,106,22,128,35840000
1860600,the World According to Girl,2022,Roguelike,"₩10,500",0%,111,45,156,81900000,102,46,148,77700000
452920,Laser Disco Defenders,2016,Roguelike,"₩10,480",0%,43,10,53,27772000,9,2,11,5764000
332710,1Quest,2014,Roguelike,"₩4,400",0%,93,81,174,38280000,17,12,29,6380000
1355570,Dungeons & Guns,2020,Roguelike,"₩2,200",0%,17,2,19,2090000,14,2,16,1760000
3052700,Records of the Flycatcher,2024,Roguelike,Free,0%,0,0,0,0,28,1,29,0
738760,the Line,2017,Roguelike,"₩1,320",70%,21,17,38,2508000,13,10,23,1518000
2568050,BAR,2025,Roguelike,"₩6,700",0%,14,3,17,5695000,14,5,19,6365000
332710,1Quest,2014,Roguelike,"₩4,400",0%,93,81,174,38280000,17,12,29,6380000
1141760,Westale: Peelgrimage,2023,Roguelike,"₩5,600",0%,327,141,468,131040000,266,137,403,112840000
2723220,BoboInvasion,2024,Roguelike,Free,0%,12,3,15,0,11,4,15,0
1355570,Dungeons & Guns,2020,Roguelike,"₩2,200",0%,17,2,19,2090000,14,2,16,1760000
3052700,Records of the Flycatcher,2024,Roguelike,Free,0%,0,0,0,0,28,1,29,0
756020,Puppet Kings,2017,Roguelike,"₩10,500",0%,22,8,30,15750000,15,5,20,10500000
515570,UBERMOSH Vol.3,2016,Roguelike,"₩1,100",0%,274,34,308,16940000,606,60,666,36630000
1073490,Monster X Monster,2019,Roguelike,"₩3,300",0%,130,30,160,26400000,105,30,135,22275000
616640,B-12,2019,Roguelike,Free,0%,30,7,37,0,30,7,37,0
1833680,BeatRider,2024,Roguelike,"₩13,500",0%,48,16,64,43200000,17,16,33,22275000
2145190,ENERGY SURVIVORS,2023,Roguelike,"₩3,400",0%,28,7,35,5950000,28,6,34,5780000
1570830,Mori Carta,2024,Roguelike,"₩16,500",0%,57,22,79,65175000,50,21,71,58575000
2973520,Hero's Survival,2024,Roguelike,Free,0%,0,0,0,0,9,2,11,0
2961480,Duelite,2024,Roguelike,"₩7,800",0%,21,3,24,9360000,19,3,22,8580000
3333460,No Space For All,2024,Roguelike,"₩5,600",0%,35,1,36,10080000,28,0,28,7840000
446120,Bunker Punks,2018,Roguelike,"₩16,000",0%,313,123,436,348800000,218,81,299,239200000
1924010,Shapebreaker - Tower Defense Deckbuilder,2023,Roguelike,"₩5,600",0%,45,11,56,15680000,44,13,57,15960000
459680,Auro: A Monster-Bumping Adventure,2016,Roguelike,Free,0%,66,13,79,0,65,13,78,0
2447310,Knight Overloaded,2023,Roguelike,Free,0%,127,23,150,0,127,24,151,0
2145720,Petit Petit Petit,2023,Roguelike,"₩6,700",0%,13,9,22,7370000,10,9,19,6365000
1016730,Deck of Ashes,2020,Roguelike,"₩21,500",0%,756,291,1047,1125525000,596,256,852,915900000
2345550,Meow Legion,2024,Roguelike,"₩2,300",0%,11,0,11,1265000,10,0,10,1150000
2489670,The witch and the bottle of concepts,2024,Roguelike,"₩9,500",0%,37,20,57,27075000,31,20,51,24225000
887400,THE GREAT GEOMETRIC MULTIVERSE TOUR,2018,Roguelike,"₩1,100",0%,284,80,364,20020000,30,2,32,1760000
1409700,A Way To Die,2022,Roguelike,"₩8,050",0%,25,1,26,10465000,13,1,14,5635000
2369950,Blade of the Netherworld,2024,Roguelike,"₩7,800",0%,122,32,154,60060000,88,31,119,46410000
1953020,Lab Remnants,2022,Roguelike,"₩2,300",0%,18,1,19,2185000,18,1,19,2185000
1016730,Deck of Ashes,2020,Roguelike,"₩21,500",0%,756,291,1047,1125525000,596,256,852,915900000
2870150,Brawl To The West,2025,Roguelike,"₩9,900",0%,0,0,0,0,101,39,140,69300000
2837340,Milky Way TD SURVIVORS AUTOBATTLER RTS: Earth,2024,Roguelike,Free,0%,0,0,0,0,31,3,34,0
1555160,Frog story,2021,Roguelike,"₩5,500",0%,9,10,19,5225000,10,4,14,3850000
3346990,Ninja Vs. Zombies 3,2025,Roguelike,"₩5,600",0%,12,1,13,3640000,12,0,12,3360000
2997110,Slasher: Origins,2025,Roguelike,"₩5,000",0%,14,6,20,5000000,12,6,18,4500000
1411920,Get Ogre It,2020,Roguelike,"₩10,740",0%,24,5,29,15573000,14,5,19,10203000
3821350,Vengeance,2025,Roguelike,Free,0%,0,0,0,0,9,1,10,0
1420950,Spinning_Kid,2020,Roguelike,"₩1,100",0%,26,7,33,1815000,17,0,17,935000
1677580,My Master's A Moron,2022,Roguelike,"₩15,500",0%,24,5,29,22475000,16,5,21,16275000
2526010,Star Legacy VR,2023,Roguelike,Free,0%,0,0,0,0,26,5,31,0
2758280,Boldly Forward,2024,Roguelike,"₩4,500",0%,69,76,145,32625000,63,78,141,31725000
3265380,Island of Challenge,2025,Roguelike,"₩2,300",0%,13,1,14,1610000,12,1,13,1495000
1168870,Mists of Noyah,2022,Roguelike,"₩20,500",0%,508,256,764,783100000,360,212,572,586300000
2278550,Deck of the Dead,2023,Roguelike,Free,0%,0,0,0,0,36,11,47,0
1393570,Superbugs: Awaken,2022,Roguelike,"₩15,500",0%,164,24,188,145700000,128,11,139,107725000
1175430,Project Starship X,2020,Roguelike,"₩11,000",0%,88,5,93,51150000,64,3,67,36850000
1355620,Mage Rage,2022,Roguelike,"₩3,400",0%,16,4,20,3400000,13,4,17,2890000
2589470,Save Prinvess:Infinite Loop,2023,Roguelike,"₩6,700",0%,16,3,19,6365000,9,3,12,4020000
903780,Beast Agenda 2030,2019,Roguelike,"₩15,500",0%,16,2,18,13950000,8,2,10,7750000
566530,Mass Exodus Redux,2017,Roguelike,"₩7,800",0%,222,81,303,118170000,200,81,281,109590000
406920,Mutant Gate,2015,Roguelike,Free,0%,41,3,44,0,44,4,48,0
2194820,Koboo: The Tree Spirit - Prologue,2024,Roguelike,Free,0%,0,0,0,0,27,3,30,0
2194820,Koboo: The Tree Spirit - Prologue,2024,Roguelike,Free,0%,0,0,0,0,27,3,30,0
371220,VERLIES II,2015,Roguelike,"₩3,400",0%,79,56,135,22950000,65,42,107,18190000
2611750,Cosmic Cursor,2024,Roguelike,"₩5,000",0%,13,1,14,3500000,14,1,15,3750000
531780,Castle Explorer,2017,Roguelike,"₩10,500",0%,30,7,37,19425000,21,7,28,14700000
1848710,Ninja Soul,2022,Roguelike,"₩10,500",0%,130,33,163,85575000,89,31,120,63000000
485680,sphereFACE,2017,Roguelike,"₩5,600",0%,29,3,32,8960000,23,3,26,7280000
1501410,Dwarf Journey,2021,Roguelike,"₩11,000",0%,323,22,345,189750000,282,24,306,168300000
548370,Rezrog,2017,Roguelike,"₩11,000",0%,148,180,328,180400000,129,164,293,161150000
371530,Legends of Pixelia,2015,Roguelike,"₩1,650",70%,30,1,31,2557500,21,1,22,1815000
832650,Royal Adventure,2018,Roguelike,"₩7,500",0%,19,10,29,10875000,15,8,23,8625000
1888450,Shop-Like - The Rogue-Like Item Shop Experience,2023,Roguelike,"₩8,900",0%,34,9,43,19135000,29,8,37,16465000
913590,Dimension Drifter,2018,Roguelike,"₩13,500",0%,42,15,57,38475000,22,6,28,18900000
2839290,Enter The Lost Chamber,2024,Roguelike,"₩4,500",0%,21,0,21,4725000,14,0,14,3150000
349460,Lord of the Dark Castle,2015,Roguelike,"₩1,100",0%,120,42,162,8910000,71,31,102,5610000
2849230,Mask Around,2024,Roguelike,"₩8,900",0%,14,0,14,6230000,14,0,14,6230000
2086910,Verses of Enchantment,2023,Roguelike,"₩21,500",0%,28,7,35,37625000,22,7,29,31175000
698590,DemonsTier,2019,Roguelike,"₩10,500",0%,42,8,50,26250000,31,7,38,19950000
2403940,AutoHeroes,2024,Roguelike,"₩2,800",50%,13,10,23,3220000,8,10,18,2520000
2050450,THE MADMAN,2022,Roguelike,"₩13,500",0%,11,8,19,12825000,10,8,18,12150000
591000,Deep Sixed,2018,Roguelike,"₩6,500",0%,87,16,103,33475000,63,11,74,24050000
1144130,Smash Dungeon,2023,Roguelike,"₩7,800",0%,12,3,15,5850000,11,3,14,5460000
3822990,Stellar Witch,2025,Roguelike,Free,0%,0,0,0,0,84,0,84,0
373730,Way of Gold and Steel,2015,Roguelike,"₩9,500",0%,74,47,121,57475000,41,36,77,36575000
1907660,Monster Path,2023,Roguelike,"₩7,800",0%,14,5,19,7410000,13,4,17,6630000
1322600,Pizza Bike Rider,2020,Roguelike,"₩1,100",0%,47,6,53,2915000,32,4,36,1980000
3406600,Winter Quackdown,2025,Roguelike,"₩1,100",0%,12,1,13,715000,12,1,13,715000
2662810,Dungeon Minesweeper,2024,Roguelike,"₩7,640",0%,14,12,26,9932000,6,6,12,4584000
698590,DemonsTier,2019,Roguelike,"₩10,500",0%,42,8,50,26250000,31,7,38,19950000
3822990,Stellar Witch,2025,Roguelike,Free,0%,0,0,0,0,84,0,84,0
1322600,Pizza Bike Rider,2020,Roguelike,"₩1,100",0%,47,6,53,2915000,32,4,36,1980000
1888000,Bloody Rampage City,2022,Roguelike,"₩5,500",0%,11,4,15,4125000,16,8,24,6600000
2462570,Thor's Ascension: Nine Realms,2024,Roguelike,"₩8,900",0%,55,23,78,34710000,52,25,77,34265000
2352040,FatSheep Crisis,2023,Roguelike,"₩1,800",60%,111,34,145,13050000,102,34,136,12240000
591000,Deep Sixed,2018,Roguelike,"₩6,500",0%,87,16,103,33475000,63,11,74,24050000
1331420,Rogue Arrows,2022,Roguelike,"₩5,600",0%,33,9,42,11760000,32,9,41,11480000
2296870,Crimson Connect Origin,2023,Roguelike,"₩6,700",0%,25,22,47,15745000,25,22,47,15745000
1425370,Razenroth 2,2021,Roguelike,"₩5,600",0%,33,3,36,10080000,24,2,26,7280000
1582380,Midautumn,2023,Roguelike,"₩25,500",0%,16,5,21,26775000,9,4,13,16575000
745000,Card Crawl,2018,Roguelike,"₩3,300",0%,134,41,175,28875000,124,42,166,27390000
856990,A Long Way Down,2020,Roguelike,"₩18,500",0%,152,75,227,209975000,64,51,115,106375000
3218090,Off Trail,2024,Roguelike,Free,0%,42,5,47,0,43,5,48,0
1251210,Dungeon No Dungeon,2021,Roguelike,"₩7,500",0%,291,211,502,188250000,237,187,424,159000000
1997980,出牌吧冒险家 Go Poker,2024,Roguelike,"₩1,100",0%,16,2,18,990000,14,2,16,880000
2356390,Chaos Coming,2023,Roguelike,"₩2,300",0%,5,4,9,1035000,5,5,10,1150000
2184470,South Pole Bebop,2024,Roguelike,Free,0%,39,5,44,0,43,5,48,0
283040,Paper Dungeons,2015,Roguelike,"₩5,600",0%,47,45,92,25760000,11,13,24,6720000
444470,Moor,2019,Roguelike,"₩16,500",0%,18,6,24,19800000,13,4,17,14025000
1063960,Ritual: Spellcasting RPG,2019,Roguelike,"₩10,500",0%,26,4,30,15750000,11,3,14,7350000
3424740,Firework War,2025,Roguelike,Free,0%,0,0,0,0,37,2,39,0
374240,Eternal Step,2015,Roguelike,"₩10,500",0%,49,26,75,39375000,20,13,33,17325000
1425370,Razenroth 2,2021,Roguelike,"₩5,600",0%,33,3,36,10080000,24,2,26,7280000
1152450,Creeps Creeps? Creeps!,2020,Roguelike,"₩2,200",0%,32,4,36,3960000,27,2,29,3190000
616000,Riptale,2017,Roguelike,"₩6,500",0%,97,13,110,35750000,62,9,71,23075000
2836250,Soul Eater,2024,Roguelike,Free,0%,6,4,10,0,6,4,10,0
2750920,Flower Fight,2024,Roguelike,Free,0%,0,0,0,0,96,54,150,0
1386440,B67,2020,Roguelike,"₩9,500",0%,41,5,46,21850000,40,5,45,21375000
1733030,Knights of the Tiny Table,2021,Roguelike,"₩4,400",0%,23,6,29,6380000,15,6,21,4620000
1997980,出牌吧冒险家 Go Poker,2024,Roguelike,"₩1,100",0%,16,2,18,990000,14,2,16,880000
715660,信徒:献祭,2020,Roguelike,"₩8,500",0%,28,10,38,16150000,24,10,34,14450000
2095740,Survivor Of The Journey,2023,Roguelike,"₩4,500",0%,55,28,83,18675000,52,25,77,17325000
2395360,Slime Knight,2023,Roguelike,Free,0%,0,0,0,0,21,4,25,0
3374340,OPA: Super Janken,2025,Roguelike,Free,0%,0,0,0,0,6,5,11,0
3085620,Sky's The Limit MAH-JONG,2024,Roguelike,"₩9,900",0%,39,17,56,27720000,37,18,55,27225000
2141330,Magical Girl Survivors: Prologue,2022,Roguelike,Free,0%,0,0,0,0,38,26,64,0
2628230,Arcane Blast,2024,Roguelike,"₩11,000",0%,35,15,50,27500000,30,14,44,24200000
1090060,Weapon Hacker,2020,Roguelike,"₩10,500",0%,33,2,35,18375000,23,2,25,13125000
396640,TowerClimb,2015,Roguelike,"₩16,000",0%,353,32,385,308000000,266,33,299,239200000
1541710,Wyvern,2021,Roguelike,Free,0%,80,33,113,0,80,34,114,0
2109020,Koler,2023,Roguelike,"₩11,000",0%,18,6,24,13200000,16,6,22,12100000
798240,CRYEP,2018,Roguelike,"₩13,500",0%,22,5,27,18225000,15,0,15,10125000
279070,9th Dawn II,2016,Roguelike,"₩6,500",0%,132,28,160,52000000,129,28,157,51025000
2066490,Robot Resistors,2023,Roguelike,"₩1,100",0%,37,11,48,2640000,34,11,45,2475000
640970,In Game Adventure: Legend of Monsters,2017,Roguelike,Free,0%,103,34,137,0,102,34,136,0
496620,Monster Slayers,2017,Roguelike,"₩9,500",0%,975,256,1231,584725000,623,165,788,374300000
1840790,Metal Mutation,2023,Roguelike,"₩3,300",85%,57,21,78,12870000,39,17,56,9240000
932210,Nexoria: Dungeon Rogue Heroes,2020,Roguelike,"₩1,400",75%,45,17,62,4340000,36,17,53,3710000
750500,Socketeer,2018,Roguelike,"₩10,500",0%,22,8,30,15750000,22,8,30,15750000
2236590,Psionic Awake,2025,Roguelike,"₩5,600",0%,129,65,194,54320000,110,64,174,48720000
2090040,Odium,2022,Roguelike,Free,0%,0,0,0,0,13,4,17,0
1303870,Mischance,2021,Roguelike,"₩5,500",0%,11,3,14,3850000,8,3,11,3025000
1579890,Infinite World:Dice Team,2024,Roguelike,"₩4,500",0%,27,8,35,7875000,28,9,37,8325000
279070,9th Dawn II,2016,Roguelike,"₩6,500",0%,132,28,160,52000000,129,28,157,51025000
1466100,RavenWeald,2022,Roguelike,Free,0%,15,2,17,0,15,2,17,0
2107040,Rumple Town,2023,Roguelike,"₩3,400",0%,27,0,27,4590000,24,0,24,4080000
3016690,JACKPOISON,2024,Roguelike,"₩9,900",0%,11,14,25,12375000,11,14,25,12375000
2333710,不屈者传说 No Give up,2025,Roguelike,"₩5,600",0%,13,5,18,5040000,6,4,10,2800000
3698060,Popit Game,2025,Roguelike,Free,0%,0,0,0,0,17,5,22,0
2407240,Super Bear: Hunt for the lost beer,2023,Roguelike,"₩1,100",0%,19,9,28,1540000,9,4,13,715000
1591340,Night Blade,2021,Roguelike,"₩1,100",0%,26,12,38,2090000,10,9,19,1045000
448820,Planet in the Shadows,2016,Roguelike,"₩4,400",0%,20,9,29,6380000,16,7,23,5060000
3610940,Gunbot Diplomacy: Blast Off,2025,Roguelike,Free,0%,0,0,0,0,94,13,107,0
2999990,Rogue Tiles,2024,Roguelike,"₩5,600",0%,26,14,40,11200000,25,15,40,11200000
1611420,Sea Horizon,2022,Roguelike,"₩18,000",0%,140,35,175,157500000,106,32,138,124200000
1227260,Alder's Blood: Prologue,2020,Roguelike,Free,0%,110,32,142,0,109,33,142,0
1045010,Russia Roguelike,2020,Roguelike,"₩1,100",0%,74,9,83,4565000,64,10,74,4070000
428430,Endorlight,2016,Roguelike,"₩1,100",0%,924,549,1473,81015000,75,61,136,7480000
2128310,Ceaseless Night,2022,Roguelike,"₩20,300",0%,11,3,14,14210000,10,3,13,13195000
1071660,Ruine,2019,Roguelike,"₩5,500",0%,15,1,16,4400000,11,1,12,3300000
2009380,They Don't Sleep,2022,Roguelike,"₩3,400",0%,198,7,205,34850000,195,8,203,34510000
2114380,Dungeon Dungeon!,2024,Roguelike,"₩16,500",0%,13,5,18,14850000,8,5,13,10725000
1079000,Ord.,2019,Roguelike,Free,0%,225,16,241,0,227,17,244,0
2114380,Dungeon Dungeon!,2024,Roguelike,"₩16,500",0%,13,5,18,14850000,8,5,13,10725000
1126890,Urban Cards,2021,Roguelike,"₩16,500",0%,140,39,179,147675000,111,37,148,122100000
3396310,Shorebound,2025,Roguelike,"₩11,000",0%,20,3,23,12650000,7,3,10,5500000
2577320,CODEDOOR,2024,Roguelike,Free,0%,0,0,0,0,12,4,16,0
2128310,Ceaseless Night,2022,Roguelike,"₩20,300",0%,11,3,14,14210000,10,3,13,13195000
764580,RealmCraft,2018,Roguelike,"₩5,600",0%,37,11,48,13440000,33,10,43,12040000
2837330,Milky Way TD SURVIVORS AUTOBATTLER RTS,2024,Roguelike,"₩8,900",0%,18,3,21,9345000,16,3,19,8455000
1599530,Little adventure,2021,Roguelike,"₩11,500",0%,24,16,40,23000000,18,13,31,17825000
1419510,ULTRA LMAD,2023,Roguelike,Free,0%,0,0,0,0,26,7,33,0
1094960,Soul Scathe,2022,Roguelike,"₩20,500",0%,46,11,57,58425000,43,11,54,55350000
533050,Lazy Galaxy: Rebel Story,2018,Roguelike,"₩5,500",0%,34,5,39,10725000,25,5,30,8250000
1746820,HYDROGEN,2024,Roguelike,"₩6,700",0%,10,0,10,3350000,10,0,10,3350000
1162320,AVA: Dark History,2020,Roguelike,"₩2,950",0%,40,12,52,7670000,32,7,39,5752500
858680,Black Paradox,2019,Roguelike,"₩15,500",0%,86,41,127,98425000,58,23,81,62775000
2324380,Demons Infernalize,2024,Roguelike,Free,0%,33,17,50,0,33,17,50,0
2106170,Super Weapon Master 超级武器大师,2022,Roguelike,"₩4,400",0%,27,8,35,7700000,12,8,20,4400000
1598710,Wild world,2021,Roguelike,"₩1,100",0%,6,7,13,715000,11,3,14,770000
1980770,Floor44,2023,Roguelike,"₩8,300",0%,88,45,133,55195000,80,37,117,48555000
2482130,Final Resistance,2023,Roguelike,"₩4,500",0%,36,3,39,8775000,25,3,28,6300000
2686360,Oh Darling! I Hate To Tell You This...,2023,Roguelike,Free,0%,0,0,0,0,23,9,32,0
1134610,Dice Hero: The Unoriginal Story,2023,Roguelike,"₩5,600",0%,17,4,21,5880000,15,4,19,5320000
2955960,Brickorium,2024,Roguelike,Free,0%,0,0,0,0,10,0,10,0
2213990,My Last 20,2025,Roguelike,Free,0%,0,0,0,0,22,0,22,0
919220,Destiny or Fate,2019,Roguelike,"₩5,500",0%,269,209,478,131450000,78,54,132,36300000
529970,PositronX,2020,Roguelike,"₩25,000",0%,61,20,81,101250000,38,17,55,68750000
937530,Dungeon Crowley,2018,Roguelike,"₩19,500",0%,60,21,81,78975000,40,14,54,52650000
1069270,Rotatex,2019,Roguelike,"₩11,000",0%,22,11,33,18150000,14,1,15,8250000
2881360,Bloody Heaven 2 ：Prologue,2024,Roguelike,Free,0%,10,4,14,0,10,5,15,0
1440470,Synthetic Hazard,2020,Roguelike,Free,0%,21,13,34,0,22,13,35,0
1277100,Dungeon & Derision,2020,Roguelike,Free,0%,14,1,15,0,13,2,15,0
657090,Robothorium,2019,Roguelike,"₩16,000",0%,259,107,366,292800000,159,86,245,196000000
1566090,Malice & Greed,2021,Roguelike,"₩15,500",0%,52,12,64,49600000,41,14,55,42625000
1258800,Project Dagger,2022,Roguelike,"₩6,500",0%,14,4,18,5850000,11,5,16,5200000
356820,Nemo Dungeon,2019,Roguelike,"₩4,900",0%,50,9,59,14455000,20,0,20,4900000
917850,Elemental War - A Tower Defense Game,2019,Roguelike,"₩15,500",0%,20,6,26,20150000,16,6,22,17050000
2102330,The Reaper Survivors,2022,Roguelike,"₩2,300",0%,13,4,17,1955000,8,4,12,1380000
1885200,Rally: Endless Conquest,2024,Roguelike,"₩7,800",0%,37,2,39,15210000,35,2,37,14430000
851150,Burning Knight,2020,Roguelike,"₩15,500",0%,91,36,127,98425000,67,35,102,79050000
1765060,Hunted,2021,Roguelike,Free,0%,0,0,0,0,21,7,28,0
262810,Super Turbo Demon Busters!,2017,Roguelike,"₩12,500",0%,95,80,175,109375000,45,33,78,48750000
2088650,Mist Slayer,2023,Roguelike,"₩19,500",0%,254,123,377,367575000,198,106,304,296400000
905660,纸境英雄 Papercraft,2019,Roguelike,"₩18,500",0%,255,44,299,276575000,185,38,223,206275000
664750,Wrongworld,2018,Roguelike,"₩7,800",0%,475,31,506,197340000,424,27,451,175890000
349550,Mighty Dungeons,2015,Roguelike,"₩5,500",0%,53,35,88,24200000,44,28,72,19800000
3055780,PERMUTER,2024,Roguelike,"₩4,500",0%,18,0,18,4050000,18,0,18,4050000
778050,Revenge of the Headless,2018,Roguelike,"₩1,100",0%,43,12,55,3025000,28,10,38,2090000
2744410,Law of Dispute,2024,Roguelike,"₩5,600",0%,21,22,43,12040000,15,22,37,10360000
2769070,Ultimate Hero,2025,Roguelike,"₩11,000",0%,150,62,212,116600000,113,64,177,97350000
574640,Unalive,2017,Roguelike,"₩5,600",0%,276,75,351,98280000,123,50,173,48440000
664750,Wrongworld,2018,Roguelike,"₩7,800",0%,475,31,506,197340000,424,27,451,175890000
2316950,Monster Battle,2023,Roguelike,Free,0%,0,0,0,0,27,10,37,0
1440350,Staff Only,2020,Roguelike,"₩10,500",0%,18,1,19,9975000,10,1,11,5775000
2759160,Project Jeff,2024,Roguelike,₩550,50%,11,4,15,412500,9,3,12,330000
1858760,Gem Worlds,2023,Roguelike,"₩5,600",0%,11,0,11,3080000,11,0,11,3080000
973450,Ancient Abyss,2021,Roguelike,"₩15,500",0%,129,62,191,148025000,107,58,165,127875000
2774490,Dream Survivors,2024,Roguelike,"₩7,800",0%,13,5,18,7020000,12,5,17,6630000
1162480,DIMENSION REIGN - ROGUELIKE DECKBUILDER,2020,Roguelike,"₩18,460",45%,159,68,227,209521000,140,63,203,187369000
2240200,Final Fort,2023,Roguelike,"₩4,500",0%,27,7,34,7650000,26,7,33,7425000
1335300,The Warlin of Heroes,2020,Roguelike,"₩7,500",0%,17,8,25,9375000,15,7,22,8250000
2578800,Radio Silent,2023,Roguelike,"₩5,600",0%,14,0,14,3920000,13,0,13,3640000
891370,The Last Hex,2021,Roguelike,"₩12,500",0%,173,39,212,132500000,142,42,184,115000000
1266380,Super No Crying in Baseball,2020,Roguelike,Free,0%,11,2,13,0,13,2,15,0
1207320,Gray Zone,2022,Roguelike,"₩21,500",0%,48,20,68,73100000,31,17,48,51600000
2221090,Escape of Pig,2023,Roguelike,"₩5,600",0%,9,4,13,3640000,7,3,10,2800000
318570,Hunters Of The Dead,2014,Roguelike,"₩5,500",0%,103,61,164,45100000,77,41,118,32450000
2286830,Deep Blue Fantasy,2023,Roguelike,"₩9,900",0%,21,5,26,12870000,10,5,15,7425000
3094740,Second Rate Superheroes,2024,Roguelike,"₩5,600",0%,25,6,31,8680000,22,7,29,8120000
1186940,Underneath,2020,Roguelike,"₩4,400",0%,9,4,13,2860000,9,2,11,2420000
1078510,Alluris,2019,Roguelike,"₩10,500",0%,157,14,171,89775000,125,14,139,72975000
2133530,Graveyard Architect,2023,Roguelike,"₩3,400",0%,39,5,44,7480000,36,5,41,6970000
2186010,Shapebreaker - Prologue,2023,Roguelike,Free,0%,0,0,0,0,11,5,16,0
2445870,Fellowship,2023,Roguelike,"₩7,800",0%,10,8,18,7020000,9,6,15,5850000
2086840,Jumalien,2025,Roguelike,"₩11,000",0%,18,0,18,9900000,14,0,14,7700000
1934100,Ardor,2022,Roguelike,Free,0%,0,0,0,0,180,10,190,0
788700,ValeGuard,2018,Roguelike,"₩5,600",0%,119,53,172,48160000,98,52,150,42000000
321830,Cavern Kings,2014,Roguelike,"₩5,500",0%,150,70,220,60500000,99,58,157,43175000
529240,"Creature Clicker - Capture, Train, Ascend!",2017,Roguelike,Free,0%,280,293,573,0,285,296,581,0
1662220,GLIM,2021,Roguelike,Free,0%,0,0,0,0,51,13,64,0
719800,Last Encounter,2018,Roguelike,"₩15,500",0%,32,12,44,34100000,14,3,17,13175000
611190,ROGUE SHIFT,2023,Roguelike,"₩11,000",0%,26,5,31,17050000,15,4,19,10450000
295670,Hive Jump,2017,Roguelike,"₩20,500",0%,249,113,362,371050000,126,62,188,192700000
2086840,Jumalien,2025,Roguelike,"₩11,000",0%,18,0,18,9900000,14,0,14,7700000
3496500,Orb Tower,2025,Roguelike,"₩2,300",0%,122,5,127,14605000,141,7,148,17020000
2450480,Idle Magic Legend,2023,Roguelike,"₩6,700",0%,34,31,65,21775000,32,27,59,19765000
2133530,Graveyard Architect,2023,Roguelike,"₩3,400",0%,39,5,44,7480000,36,5,41,6970000
489260,Brut@l,2017,Roguelike,"₩16,000",0%,117,39,156,124800000,94,28,122,97600000
2523250,FatalZone: Outbreak,2023,Roguelike,Free,0%,0,0,0,0,223,74,297,0
1314170,dungeon & heros,2021,Roguelike,"₩6,500",0%,39,13,52,16900000,30,10,40,13000000
340830,Razenroth,2015,Roguelike,"₩5,600",0%,504,119,623,174440000,429,107,536,150080000
2158850,Spooky Halloween in the Voxel World (Remake),2022,Roguelike,"₩7,500",0%,16,0,16,6000000,12,0,12,4500000
806770,NoReload Heroes,2018,Roguelike,"₩8,500",0%,64,21,85,36125000,52,18,70,29750000
2343960,巫族 WITCH RACE,2023,Roguelike,"₩4,500",0%,7,4,11,2475000,6,4,10,2250000
2095890,Black Gunner Wukong: Prologue,2023,Roguelike,Free,0%,0,0,0,0,706,14,720,0
3177920,PUMPKIN PANIC,2024,Roguelike,Free,0%,0,0,0,0,0,0,0,0
1067760,Gallic Wars: Battle Simulator,2020,Roguelike,"₩5,600",0%,16,15,31,8680000,13,15,28,7840000
3492360,Agent Dunoz,2025,Roguelike,"₩4,500",0%,12,0,12,2700000,13,2,15,3375000
1027650,Supernova Tactics,2022,Roguelike,"₩11,000",0%,13,6,19,10450000,8,6,14,7700000
1047860,Dunrog,2020,Roguelike,"₩4,500",0%,26,16,42,9450000,11,7,18,4050000
265730,Frane: Dragons' Odyssey,2019,Roguelike,"₩6,750",50%,8,4,12,4050000,6,4,10,3375000
3177920,PUMPKIN PANIC,2024,Roguelike,Free,0%,0,0,0,0,0,0,0,0
3492360,Agent Dunoz,2025,Roguelike,"₩4,500",0%,12,0,12,2700000,13,2,15,3375000
265730,Frane: Dragons' Odyssey,2019,Roguelike,"₩6,750",50%,8,4,12,4050000,6,4,10,3375000
341510,Crayon Chronicles,2015,Roguelike,"₩4,400",0%,38,15,53,11660000,15,4,19,4180000
340750,Gunslugs 2,2015,Roguelike,"₩11,000",0%,19,18,37,20350000,5,7,12,6600000
321270,UNLOVED,2016,Roguelike,"₩5,500",0%,1454,525,1979,544225000,747,187,934,256850000
1094070,Fares,2019,Roguelike,"₩7,500",0%,12,1,13,4875000,11,1,12,4500000
3229860,Last Spirit Origin,2025,Roguelike,Free,0%,0,0,0,0,15,10,25,0
325880,Crystal Catacombs,2015,Roguelike,"₩8,500",0%,38,49,87,36975000,12,10,22,9350000
782570,Endless Road: Reborn,2018,Roguelike,"₩11,500",0%,391,127,518,297850000,317,111,428,246100000
961420,Vile,2019,Roguelike,"₩13,500",0%,35,5,40,27000000,25,5,30,20250000
2195650,Lucky Island,2024,Roguelike,"₩11,000",0%,11,5,16,8800000,7,5,12,6600000
230840,Daylight,2014,Roguelike,"₩5,500",0%,793,778,1571,432025000,546,485,1031,283525000
2136220,Andromeda Survivors,2022,Roguelike,"₩3,300",0%,41,8,49,8085000,37,8,45,7425000
756490,Next Hero,2018,Roguelike,"₩10,500",0%,27,20,47,24675000,20,9,29,15225000
431840,3DRPG,2016,Roguelike,"₩2,300",0%,158,98,256,29440000,105,56,161,18515000
530930,Soulblight,2018,Roguelike,"₩16,000",0%,68,114,182,145600000,25,25,50,40000000
496290,Deep Dark Dungeon,2018,Roguelike,"₩10,500",0%,30,20,50,26250000,22,15,37,19425000
2697390,Homebrew32,2024,Roguelike,"₩5,600",0%,28,1,29,8120000,23,1,24,6720000
2853180,Seal the Rift,2024,Roguelike,"₩15,500",0%,18,8,26,20150000,16,8,24,18600000
1615740,Machina Blade,2022,Roguelike,"₩12,500",0%,39,14,53,33125000,35,14,49,30625000
1041450,RRRR2,2019,Roguelike,"₩2,200",0%,17,5,22,2420000,14,1,15,1650000
3168820,Coreless: Prologue,2024,Roguelike,Free,0%,0,0,0,0,27,5,32,0
2428750,Saikyo Robots,2024,Roguelike,"₩5,600",0%,14,0,14,3920000,13,0,13,3640000
2077590,Sidestep Legends,2023,Roguelike,"₩5,600",0%,24,10,34,9520000,22,9,31,8680000
759160,Dungeons & Vampires,2018,Roguelike,"₩3,400",0%,38,34,72,12240000,14,17,31,5270000
1007430,SixCubes,2019,Roguelike,"₩2,200",0%,15,5,20,2200000,11,1,12,1320000
1144760,Vectrix,2019,Roguelike,Free,0%,8,7,15,0,9,7,16,0
529130,Expect The Unexpected,2016,Roguelike,"₩5,500",0%,59,30,89,24475000,45,23,68,18700000
1387570,Orbitect,2023,Roguelike,"₩11,000",0%,8,4,12,6600000,7,4,11,6050000
2858110,Meme Christmas,2024,Roguelike,"₩1,100",0%,19,1,20,1100000,16,0,16,880000
1351900,Dungeon Core,2023,Roguelike,"₩12,500",0%,44,10,54,33750000,37,10,47,29375000
2726350,Super Dash,2025,Roguelike,"₩2,800",50%,12,0,12,1680000,11,0,11,1540000
1188430,"Deep, In the  Forest",2020,Roguelike,"₩9,900",0%,40,20,60,29700000,25,19,44,21780000
980210,HordeCore,2022,Roguelike,"₩12,500",0%,94,48,142,88750000,73,37,110,68750000
3490820,Meme Survivors: Backrooms,2025,Roguelike,"₩1,100",0%,20,0,20,1100000,17,0,17,935000
622370,Freaky Awesome,2017,Roguelike,"₩10,500",0%,146,111,257,134925000,114,90,204,107100000
2448270,Mars Survivors,2023,Roguelike,"₩5,600",0%,43,22,65,18200000,40,21,61,17080000
2023500,"Deck of Life: No Turns, Individual Card Permadeath",2023,Roguelike,Free,0%,13,6,19,0,13,6,19,0
2955220,CARD QUEST,2024,Roguelike,"₩11,000",0%,75,21,96,52800000,50,22,72,39600000
2615010,Necromantic,2024,Roguelike,"₩7,800",0%,73,45,118,46020000,63,42,105,40950000
1209520,Smart Moves,2020,Roguelike,"₩5,600",0%,14,0,14,3920000,13,0,13,3640000
409360,Faron's Fate,2015,Roguelike,"₩1,100",0%,28,13,41,2255000,11,4,15,825000
2270120,HiveCorp,2025,Roguelike,"₩5,000",0%,33,12,45,11250000,20,14,34,8500000
345080,Flame Over,2015,Roguelike,"₩13,000",0%,126,46,172,111800000,97,43,140,91000000
2336730,Dungeon Survivors,2024,Roguelike,"₩5,600",0%,109,48,157,43960000,79,45,124,34720000
369560,The Story Goes On,2018,Roguelike,"₩5,500",0%,102,26,128,35200000,38,16,54,14850000
458700,Cursor Challenge,2016,Roguelike,"₩3,400",0%,24,16,40,6800000,16,10,26,4420000
409460,Blackfaun,2016,Roguelike,"₩5,500",0%,17,11,28,7700000,9,10,19,5225000
1619420,Diebrary,2023,Roguelike,"₩5,600",0%,28,12,40,11200000,16,9,25,7000000
1550080,LootLite,2021,Roguelike,"₩5,600",0%,29,6,35,9800000,13,6,19,5320000
2109700,Temple of Horror,2022,Roguelike,"₩10,500",0%,23,6,29,15225000,21,2,23,12075000
776540,aMAZE Untouchable,2018,Roguelike,"₩2,300",0%,53,46,99,11385000,38,23,61,7015000
561510,DragoDino,2017,Roguelike,"₩13,000",0%,18,3,21,13650000,9,2,11,7150000
536640,Grimm: Dark Legacy,2016,Roguelike,"₩15,500",0%,39,42,81,62775000,29,41,70,54250000
1920650,Contrablade: Stadium Rush,2022,Roguelike,"₩2,640",19%,30,12,42,5544000,27,13,40,5280000
655000,Masked Forces 2: Mystic Demons,2017,Roguelike,"₩5,500",0%,57,20,77,21175000,49,19,68,18700000
1812970,Immortal Tactics: War of the Eternals,2022,Roguelike,"₩15,500",0%,82,16,98,75950000,61,16,77,59675000
2013080,Unders_core,2022,Roguelike,"₩12,500",0%,16,8,24,15000000,15,8,23,14375000
2027570,Zombies Invasion,2022,Roguelike,"₩27,000",0%,14,13,27,36450000,10,12,22,29700000
1213390,Starship Inspector,2021,Roguelike,"₩4,400",0%,31,20,51,11220000,25,20,45,9900000
698870,Metaverse Keeper / 元能失控,2019,Roguelike,"₩15,500",0%,619,176,795,616125000,454,135,589,456475000
1599150,Warlike,2021,Roguelike,"₩4,400",0%,20,9,29,6380000,16,9,25,5500000
746000,Haxor,2019,Roguelike,"₩7,500",0%,15,7,22,8250000,6,5,11,4125000
1043150,Danger Gazers,2020,Roguelike,"₩11,000",0%,50,19,69,37950000,29,11,40,22000000
860660,To Hell with Hell,2020,Roguelike,"₩17,500",0%,56,28,84,73500000,18,19,37,32375000
1579100,Dungeon and Gravestone,2021,Roguelike,"₩26,000",0%,8,6,14,18200000,7,6,13,16900000
820020,Alder's Blood: Definitive Edition,2020,Roguelike,"₩20,500",0%,157,97,254,260350000,123,78,201,206025000
1981050,Defiled Survivors,2023,Roguelike,"₩2,300",0%,10,10,20,2300000,7,8,15,1725000
2597710,Rusty Ride,2023,Roguelike,Free,0%,0,0,0,0,19,5,24,0
257120,Not The Robots,2013,Roguelike,"₩11,000",0%,445,120,565,310750000,234,58,292,160600000
2658030,Clicker Arena,2024,Roguelike,"₩9,400",0%,57,47,104,48880000,50,46,96,45120000
453730,Borstal,2016,Roguelike,"₩3,300",0%,27,15,42,6930000,14,10,24,3960000
2614700,Infrared,2023,Roguelike,Free,0%,13,3,16,0,13,4,17,0
2369880,Dungeon Survival,2023,Roguelike,"₩4,500",0%,14,8,22,4950000,14,8,22,4950000
257120,Not The Robots,2013,Roguelike,"₩11,000",0%,445,120,565,310750000,234,58,292,160600000
1835930,燃爆英雄(Bomb Hero),2022,Roguelike,Free,0%,0,0,0,0,11,9,20,0
2107810,Marine Survivors,2022,Roguelike,"₩1,100",0%,20,17,37,2035000,13,15,28,1540000
2558240,Warlock The Bounty Hunter,2023,Roguelike,Free,0%,0,0,0,0,8,5,13,0
455100,Gerty,2019,Roguelike,"₩15,500",0%,38,7,45,34875000,25,5,30,23250000
2116770,Armoured Cavalry: Operation Varkiri,2023,Roguelike,"₩6,700",0%,33,9,42,14070000,25,9,34,11390000
3152460,Curtain Call: Chronicles of Heroes,2025,Roguelike,"₩6,700",0%,0,0,0,0,15,9,24,8040000
1082720,Click Legends,2019,Roguelike,"₩3,300",0%,20,17,37,6105000,20,17,37,6105000
3274770,The Gleaming Grill,2024,Roguelike,"₩8,900",0%,10,4,14,6230000,9,4,13,5785000
1620800,Helix,2021,Roguelike,Free,0%,15,3,18,0,14,4,18,0
1768530,MIYAMOTO S,2022,Roguelike,"₩9,500",0%,10,3,13,6175000,9,2,11,5225000
1511870,末日竟在我身边 - Zombies Everywhere,2021,Roguelike,₩550,50%,64,16,80,2200000,49,16,65,1787500
333760,Vintage Year,2015,Roguelike,"₩4,500",0%,82,21,103,23175000,42,5,47,10575000
686360,Dungeons & Treasure VR,2017,Roguelike,"₩21,500",0%,54,20,74,79550000,40,15,55,59125000
658830,Artificer: Science of Magic,2020,Roguelike,"₩10,500",0%,59,30,89,46725000,46,30,76,39900000
369110,The Swindle,2015,Roguelike,"₩16,000",0%,390,223,613,490400000,307,181,488,390400000
339250,Winged Sakura: Endless Dream,2017,Roguelike,"₩11,000",0%,22,8,30,16500000,21,7,28,15400000
2261750,Towers Deck,2023,Roguelike,"₩11,000",0%,30,10,40,22000000,20,9,29,15950000
227580,"10,000,000",2013,Roguelike,"₩5,500",0%,2076,227,2303,633325000,1587,176,1763,484825000
346340,Gran Vitreous,2015,Roguelike,"₩5,500",0%,26,8,34,9350000,22,5,27,7425000
593560,The Last Cargo,2017,Roguelike,"₩11,000",0%,16,13,29,15950000,14,10,24,13200000
872720,SuperMash,2021,Roguelike,"₩18,670",0%,30,15,45,42007500,10,7,17,15869500
2150910,Spellcats: Auto Card Tactics,2024,Roguelike,"₩11,000",0%,31,14,45,24750000,16,12,28,15400000
329770,4089: Ghost Within,2015,Roguelike,"₩6,700",0%,63,41,104,34840000,45,30,75,25125000
396260,World's Fastest Pizza,2016,Roguelike,"₩3,300",0%,44,3,47,7755000,36,3,39,6435000
396260,World's Fastest Pizza,2016,Roguelike,"₩3,300",0%,44,3,47,7755000,36,3,39,6435000
1177610,Katana Kata,2020,Roguelike,"₩16,500",0%,50,23,73,60225000,43,21,64,52800000
1021690,Game Studio Simulator（我要做游戏）,2019,Roguelike,"₩2,200",0%,145,34,179,19690000,115,34,149,16390000
376130,Illuminascii,2015,Roguelike,"₩12,500",0%,24,19,43,26875000,22,18,40,25000000
542660,Feral Fury,2017,Roguelike,"₩7,500",0%,106,25,131,49125000,78,23,101,37875000
1299750,Wizodd,2020,Roguelike,"₩5,500",0%,35,7,42,11550000,22,4,26,7150000
815290,Guards of the Gate,2019,Roguelike,"₩10,500",0%,28,13,41,21525000,19,10,29,15225000
305780,Echo of the Wilds,2014,Roguelike,"₩7,800",0%,149,45,194,75660000,109,29,138,53820000
1357410,Road Z : The Last Drive,2020,Roguelike,"₩5,600",0%,32,26,58,16240000,15,5,20,5600000
204390,Pineapple Smash Crew,2012,Roguelike,"₩10,500",0%,98,23,121,63525000,66,13,79,41475000
464620,Siralim 2,2016,Roguelike,"₩16,500",0%,416,35,451,372075000,394,34,428,353100000
1962560,Grim Horde,2022,Roguelike,"₩3,400",0%,36,33,69,11730000,34,33,67,11390000
358830,Good Robot,2016,Roguelike,"₩9,900",0%,217,42,259,128205000,134,17,151,74745000
384500,Zombie Party,2016,Roguelike,"₩10,500",0%,582,102,684,359100000,277,78,355,186375000
1133050,"Good Night, Knight",2021,Roguelike,"₩15,500",0%,38,14,52,40300000,32,14,46,35650000
463980,Solitairica,2016,Roguelike,"₩10,500",0%,414,125,539,282975000,315,89,404,212100000
2773160,Magic Caster,2024,Roguelike,"₩3,400",0%,18,0,18,3060000,14,0,14,2380000
458660,The Slimeking's Tower,2021,Roguelike,Free,0%,203,73,276,0,204,71,275,0
494780,MageWorks,2019,Roguelike,"₩11,000",0%,9,7,16,8800000,7,6,13,7150000
2900530,Nine Realms Prologue,2024,Roguelike,Free,0%,0,0,0,0,115,71,186,0
1131240,Dungeons of Edera,2022,Roguelike,"₩15,500",0%,714,331,1045,809875000,650,320,970,751750000
2071390,Chess: The Lost Pieces,2023,Roguelike,"₩8,900",0%,14,6,20,8900000,12,6,18,8010000
672460,Genetic Disaster,2017,Roguelike,"₩15,500",0%,62,37,99,76725000,36,18,54,41850000
559260,Wayward Souls,2019,Roguelike,"₩15,500",0%,164,56,220,170500000,136,41,177,137175000
708970,GOD STARFIGHTER,2020,Roguelike,"₩5,600",0%,30,6,36,10080000,29,5,34,9520000
2071390,Chess: The Lost Pieces,2023,Roguelike,"₩8,900",0%,14,6,20,8900000,12,6,18,8010000
1278760,TinyShot,2021,Roguelike,"₩11,000",0%,29,4,33,18150000,13,3,16,8800000
1248800,The Rule of Land: Pioneers,2023,Roguelike,"₩11,500",0%,225,103,328,188600000,195,101,296,170200000
2800770,Gnomber,2024,Roguelike,"₩3,400",0%,15,6,21,3570000,12,7,19,3230000
327670,Ironcast,2015,Roguelike,"₩15,500",0%,681,254,935,724625000,553,205,758,587450000
269990,Infinite Space III: Sea of Stars,2015,Roguelike,"₩5,500",0%,88,38,126,34650000,40,11,51,14025000
1095750,Faith of Fate,2020,Roguelike,"₩3,500",0%,21,2,23,4025000,15,1,16,2800000
1689090,CITY WARS: TOKYO REIGN,2022,Roguelike,"₩13,500",0%,22,9,31,20925000,15,8,23,15525000
739220,Ark Noir,2018,Roguelike,"₩10,500",0%,33,12,45,23625000,32,11,43,22575000
2084230,Layer Hunt,2024,Roguelike,Free,0%,0,0,0,0,8,7,15,0
530520,Aegis,2016,Roguelike,"₩3,300",0%,21,28,49,8085000,8,8,16,2640000
1954930,Stronghold’s Dungeon,2022,Roguelike,"₩8,900",0%,40,19,59,26255000,35,19,54,24030000
1121720,Monsters' Den Chronicles,2019,Roguelike,"₩6,700",0%,54,16,70,23450000,41,11,52,17420000
928410,Zombies In The Dark,2019,Roguelike,"₩1,100",0%,7,7,14,770000,4,6,10,550000
427910,Zavix Tower,2016,Roguelike,"₩10,500",0%,250,93,343,180075000,108,64,172,90300000
2294330,LastRo,2023,Roguelike,Free,0%,0,0,0,0,19,1,20,0
653210,Prisoner,2017,Roguelike,"₩3,400",0%,22,17,39,6630000,8,7,15,2550000
1232590,DREAMGATE,2020,Roguelike,"₩15,500",0%,69,25,94,72850000,60,24,84,65100000
970140,Reynard,2019,Roguelike,"₩9,500",0%,28,8,36,17100000,20,7,27,12825000
1321010,Labyrinth Legend,2020,Roguelike,"₩4,500",40%,41,7,48,10800000,38,5,43,9675000
1269710,Kainga: Seeds of Civilization,2022,Roguelike,"₩20,500",0%,582,154,736,754400000,474,150,624,639600000
871420,Lovecraft's Untold Stories,2019,Roguelike,"₩16,500",0%,681,236,917,756525000,511,144,655,540375000
2935650,Tortuga City,2025,Roguelike,"₩8,900",0%,11,1,12,5340000,10,1,11,4895000
507120,The Superfluous,2017,Roguelike,"₩5,600",0%,43,10,53,14840000,25,9,34,9520000
665740,Book Of Potentia 2,2017,Roguelike,Free,0%,85,27,112,0,84,28,112,0
1188970,Ether Loop,2020,Roguelike,"₩12,500",0%,219,94,313,195625000,177,83,260,162500000
222980,Dead Pixels,2012,Roguelike,"₩3,300",0%,2105,311,2416,398640000,1699,277,1976,326040000
663300,Enlightenment,2018,Roguelike,"₩13,000",0%,289,166,455,295750000,224,149,373,242450000
689700,Mad Crown,2018,Roguelike,"₩10,500",0%,119,30,149,78225000,88,28,116,60900000
2844450,Operation Marakudja,2024,Roguelike,Free,0%,23,7,30,0,23,7,30,0
2076810,Further Still: Survivors,2022,Roguelike,"₩4,400",0%,30,5,35,7700000,20,5,25,5500000
475960,Bombslinger,2018,Roguelike,"₩13,000",0%,105,29,134,87100000,85,25,110,71500000
640340,Serious Sam: Tormental,2022,Roguelike,"₩13,500",0%,185,57,242,163350000,137,43,180,121500000
722560,RAD,2019,Roguelike,"₩21,800",0%,694,240,934,1018060000,472,149,621,676890000
1128690,Plunge,2019,Roguelike,"₩8,500",0%,127,15,142,60350000,63,4,67,28475000
1022010,Oliver's Adventures in the Fairyland,2019,Roguelike,"₩5,500",0%,33,6,39,10725000,29,6,35,9625000
2112200,古巫竞技场 Ancient Witch Arena,2022,Roguelike,"₩3,300",0%,62,24,86,14190000,49,24,73,12045000
805920,Seek Etyliv,2018,Roguelike,"₩5,190",0%,52,13,65,16867500,47,13,60,15570000
580320,Ashworld,2017,Roguelike,"₩15,000",0%,16,12,28,21000000,11,11,22,16500000
1664010,Dungeon Crawler Daniel,2021,Roguelike,"₩5,600",0%,14,3,17,4760000,14,3,17,4760000
386100,Pylon: Rogue,2017,Roguelike,"₩16,000",0%,15,7,22,17600000,12,6,18,14400000
948470,Deadsiege,2020,Roguelike,"₩1,100",0%,23,24,47,2585000,19,22,41,2255000
732160,The Wild Age,2020,Roguelike,"₩13,500",0%,194,103,297,200475000,128,89,217,146475000
956060,Mittelborg: City of Mages,2019,Roguelike,"₩15,500",0%,72,41,113,87575000,44,31,75,58125000
1990730,Pylorus - Footsteps of Greed,2022,Roguelike,Free,0%,0,0,0,0,11,0,11,0
337280,Planetship,2015,Roguelike,"₩9,500",0%,45,22,67,31825000,33,19,52,24700000
1391540,Uberlaufer,2021,Roguelike,"₩11,370",0%,64,12,76,43206000,59,11,70,39795000
1608710,Gridform,2022,Roguelike,"₩11,000",0%,22,1,23,12650000,19,2,21,11550000
1363210,Live by the Sword: Tactics,2022,Roguelike,"₩16,500",0%,50,20,70,57750000,33,19,52,42900000
1080060,Axan Ships - Low Poly,2019,Roguelike,Free,0%,10,6,16,0,10,6,16,0
296930,Ascendant,2014,Roguelike,Free,0%,163,50,213,0,163,51,214,0
278620,TinyKeep,2014,Roguelike,"₩10,500",0%,271,143,414,217350000,168,86,254,133350000
264280,99 Levels To Hell,2014,Roguelike,"₩5,500",0%,367,237,604,166100000,199,139,338,92950000
3181670,Periodicity - Hats and scars,2024,Roguelike,"₩5,600",0%,13,2,15,4200000,10,1,11,3080000
391600,King Lucas,2016,Roguelike,"₩5,600",0%,98,49,147,41160000,53,32,85,23800000
299780,Noir Syndrome,2014,Roguelike,"₩5,600",0%,119,61,180,50400000,89,48,137,38360000
1245370,Puzzle Forge Dungeon,2021,Roguelike,"₩11,000",0%,31,11,42,23100000,17,7,24,13200000
531960,Bloody Walls,2016,Roguelike,Free,0%,1140,299,1439,0,1155,307,1462,0
816720,Bugs Must Die / 异星特勤队,2019,Roguelike,"₩10,880",0%,129,11,140,76160000,65,11,76,41344000
242880,"Sir, You Are Being Hunted",2014,Roguelike,"₩21,000",0%,3019,868,3887,4081350000,0,0,0,0
420790,StarBreak,2016,Roguelike,Free,0%,1009,270,1279,0,1003,283,1286,0
1228970,Elemental Abyss 元素之渊,2020,Roguelike,"₩10,500",0%,19,0,19,9975000,13,0,13,6825000
2952070,Nanika Game Online,2025,Roguelike,Free,0%,0,0,0,0,43,4,47,0
252570,Depths of Fear :: Knossos,2014,Roguelike,"₩5,600",0%,288,147,435,121800000,217,112,329,92120000
1265390,EllrLand,2020,Roguelike,Unknown,0%,38,28,66,0,38,28,66,0
1740010,Undead Menace,2021,Roguelike,"₩5,500",0%,6,3,9,2475000,11,2,13,3575000
1052080,Resistance is Fruitile,2019,Roguelike,"₩5,360",0%,17,0,17,4556000,10,0,10,2680000
2060670,Sue Shi Survival,2023,Roguelike,"₩5,600",0%,20,4,24,6720000,20,4,24,6720000
1221630,Drifting in Space,2020,Roguelike,"₩1,100",0%,10,2,12,660000,8,2,10,550000
445870,Phantom Trigger,2017,Roguelike,"₩3,300",80%,55,39,94,15510000,23,22,45,7425000
1520420,The Hopebringer,2024,Roguelike,₩780,86%,10,6,16,624000,6,4,10,390000
345140,Crystal Rift,2016,Roguelike,"₩10,500",0%,79,53,132,69300000,57,42,99,51975000
566860,VR Dungeon Knight,2017,Roguelike,"₩21,000",0%,1062,351,1413,1483650000,1002,334,1336,1402800000
801210,Spellsword Cards: Demontide,2019,Roguelike,"₩6,700",0%,52,29,81,27135000,47,30,77,25795000
392410,Toy Odyssey: The Lost and Found,2016,Roguelike,"₩16,000",0%,214,110,324,259200000,88,41,129,103200000
2601620,Ungate,2023,Roguelike,"₩10,200",0%,20,3,23,11730000,12,1,13,6630000
602480,Kartong - Death by Cardboard!,2018,Roguelike,"₩14,500",0%,61,8,69,50025000,44,8,52,37700000
1039350,StoneTide: Age of Pirates,2020,Roguelike,"₩10,500",0%,28,14,42,22050000,25,13,38,19950000
454030,Link,2016,Roguelike,"₩5,500",0%,28,20,48,13200000,21,15,36,9900000
300580,GALAK-Z,2015,Roguelike,"₩20,500",0%,395,146,541,554525000,191,54,245,251125000
342980,Destination Sol,2015,Roguelike,Free,0%,1071,285,1356,0,1074,285,1359,0
453960,Envy the Dead,2016,Roguelike,"₩3,400",0%,156,78,234,39780000,116,57,173,29410000
2160380,Dragonspire,2023,Roguelike,"₩5,600",0%,43,30,73,20440000,35,26,61,17080000
856210,bit Dungeon III,2019,Roguelike,"₩10,500",0%,145,54,199,104475000,108,32,140,73500000
905490,Deck Hunter,2019,Roguelike,"₩10,500",0%,227,96,323,169575000,205,96,301,158025000
1009350,Keepers Dungeon,2019,Roguelike,"₩4,400",0%,12,1,13,2860000,9,1,10,2200000
1174820,Tower Of Heresy,2020,Roguelike,Free,0%,11,2,13,0,11,2,13,0
1093790,Seals of the Bygone,2020,Roguelike,"₩13,500",0%,79,18,97,65475000,55,11,66,44550000
1241380,Reborn: in the Android Womb,2022,Roguelike,Free,0%,0,0,0,0,9,6,15,0
2018130,Desktopia: A Desktop Village Simulator,2022,Roguelike,"₩10,500",0%,150,58,208,109200000,142,55,197,103425000
336940,Basingstoke,2018,Roguelike,"₩36,000",0%,277,122,399,718200000,194,48,242,435600000
944120,Abalyte,2018,Roguelike,Free,0%,131,66,197,0,130,67,197,0
433600,A Legend of Luca,2016,Roguelike,"₩11,000",0%,163,41,204,112200000,139,39,178,97900000
2492410,Bootleg Steamer,2024,Roguelike,"₩16,500",0%,23,7,30,24750000,14,7,21,17325000
2386560,Carnage Cuisine,2024,Roguelike,Free,0%,9,4,13,0,11,5,16,0
1811940,Archipelago,2022,Roguelike,"₩5,500",0%,30,8,38,10450000,28,9,37,10175000
506870,Unexplored,2017,Roguelike,"₩10,500",0%,607,105,712,373800000,498,62,560,294000000
876220,Moss Destruction,2019,Roguelike,"₩2,200",0%,80,31,111,12210000,9,1,10,1100000
1199450,Dark Raider,2020,Roguelike,"₩1,100",0%,42,24,66,3630000,35,21,56,3080000
326150,Death Skid Marks,2014,Roguelike,Free,0%,706,67,773,0,710,70,780,0
1012610,Buoyancy,2019,Roguelike,"₩13,500",0%,465,329,794,535950000,436,342,778,525150000
2480740,Mushy Score,2024,Roguelike,"₩3,400",0%,11,0,11,1870000,11,0,11,1870000
1034060,Samosbor,2020,Roguelike,"₩1,100",0%,165,70,235,12925000,146,66,212,11660000
463270,Ghost 1.0,2016,Roguelike,"₩14,000",0%,1889,187,2076,1453200000,1702,189,1891,1323700000
1049220,Naxia,2019,Roguelike,"₩20,500",0%,63,49,112,114800000,53,44,97,99425000
413830,Overdosed - A Trip To Hell,2016,Roguelike,"₩7,500",0%,11,6,17,6375000,8,6,14,5250000
457520,Moustache Mountain,2016,Roguelike,"₩2,200",0%,111,43,154,16940000,80,26,106,11660000
698110,Reficul VR,2018,Roguelike,"₩20,500",0%,18,10,28,28700000,10,7,17,17425000
2436190,Survivors Will,2023,Roguelike,"₩2,300",0%,11,8,19,2185000,7,7,14,1610000
540100,Imprisoned Light,2016,Roguelike,"₩1,100",0%,133,74,207,11385000,113,64,177,9735000
1162130,Windbound,2020,Roguelike,"₩20,300",0%,653,450,1103,1119545000,586,390,976,990640000
2842150,Pair A Dice,2025,Roguelike,Free,0%,0,0,0,0,146,106,252,0
1805680,A Contusion,2022,Roguelike,"₩5,600",0%,10,2,12,3360000,10,2,12,3360000
1163560,SuperEpic: The Entertainment War,2019,Roguelike,"₩18,500",0%,72,33,105,97125000,57,25,82,75850000
531050,Far Beyond: A space odyssey VR,2016,Roguelike,"₩13,500",0%,118,53,171,115425000,101,54,155,104625000
358080,No Turning Back: The Pixel Art Action-Adventure Roguelike,2016,Roguelike,"₩3,400",0%,136,119,255,43350000,16,12,28,4760000
575840,NeverEnd,2017,Roguelike,"₩2,300",0%,63,63,126,14490000,18,8,26,2990000
307090,Fancy Skulls,2014,Roguelike,Free,0%,247,91,338,0,250,92,342,0
686090,Bloodlines of Prima,2020,Roguelike,Free,0%,39,35,74,0,38,36,74,0
328510,Monsters and Monocles,2016,Roguelike,"₩16,000",0%,73,25,98,78400000,37,21,58,46400000
1221990,Chronicle: Unit Eight,2020,Roguelike,"₩15,500",0%,33,7,40,31000000,14,7,21,16275000
295770,Rogue Shooter: The FPS Roguelike,2014,Roguelike,"₩5,500",0%,270,92,362,99550000,243,81,324,89100000
437570,GoNNER,2016,Roguelike,"₩11,000",0%,1075,243,1318,724900000,820,156,976,536800000
246110,MASSIVE CHALICE,2015,Roguelike,"₩21,000",0%,1347,510,1857,1949850000,882,326,1208,1268400000
342550,Phantasmal: Survival Horror Roguelike,2016,Roguelike,Free,0%,153,197,350,0,156,198,354,0
104100,Inside a Star-filled Sky,2011,Roguelike,"₩4,400",0%,65,31,96,21120000,56,27,83,18260000
501950,Rogue Islands,2017,Roguelike,Free,0%,65,30,95,0,65,30,95,0
705620,HELLMUT: The Badass from Hell,2018,Roguelike,"₩8,900",0%,38,10,48,21360000,23,10,33,14685000
1022710,Conglomerate 451,2020,Roguelike,"₩21,500",0%,155,84,239,256925000,91,51,142,152650000
485490,Dungeon Journey,2016,Roguelike,"₩2,300",0%,214,63,277,31855000,170,48,218,25070000
1044040,Survive the Blackout,2020,Roguelike,"₩8,900",0%,56,31,87,38715000,34,31,65,28925000
2757630,Lonely Knight - Idle Roguelike RPG,2024,Roguelike,Free,0%,0,0,0,0,199,77,276,0
1191680,境界 Dice&Fighter,2019,Roguelike,"₩4,400",0%,70,29,99,21780000,66,29,95,20900000
575830,rooMaze,2017,Roguelike,Free,0%,115,79,194,0,116,80,196,0
1584800,Dark Frame,2021,Roguelike,"₩1,100",0%,33,28,61,3355000,27,22,49,2695000
317610,Prophour23,2014,Roguelike,"₩10,500",0%,52,23,75,39375000,13,9,22,11550000
2481920,Lifeforms: Binary Fission,2024,Roguelike,"₩11,000",0%,22,6,28,15400000,19,6,25,13750000
577410,The Pit: Infinity,2019,Roguelike,"₩11,000",0%,190,100,290,159500000,148,84,232,127600000
1979200,Mortal Vessel,2024,Roguelike,"₩13,500",0%,17,0,17,11475000,14,0,14,9450000
840800,Outlaws of the Old West,2019,Roguelike,"₩20,500",0%,3715,2533,6248,6404200000,0,0,0,0
1074610,COLLAPSED,2019,Roguelike,"₩15,500",0%,132,50,182,141050000,95,42,137,106175000
508650,Signal Decay,2019,Roguelike,"₩15,000",0%,53,12,65,48750000,15,10,25,18750000
1149400,The Yellow King,2020,Roguelike,"₩9,900",0%,106,112,218,107910000,92,103,195,96525000
751820,Black Future '88,2019,Roguelike,"₩21,500",0%,527,204,731,785825000,363,127,490,526750000
2256260,Ends,2023,Roguelike,"₩3,400",0%,21,6,27,4590000,18,5,23,3910000
212800,Super Crate Box,2012,Roguelike,Free,0%,5770,716,6486,0,0,0,0,0
2055270,Tile Tale,2022,Roguelike,"₩5,500",0%,36,11,47,12925000,21,11,32,8800000
1372430,Spells and Fellas,2022,Roguelike,Free,0%,25,11,36,0,25,12,37,0
2507870,Mahjick - The Realm Taker,2023,Roguelike,"₩13,500",0%,25,5,30,20250000,26,4,30,20250000
249570,The Castle Doctrine,2014,Roguelike,"₩4,400",0%,185,192,377,82940000,115,147,262,57640000
3255510,Bolide,2025,Roguelike,Free,0%,2,0,2,0,10,1,11,0
979810,Grave Keeper,2019,Roguelike,"₩11,000",0%,44,55,99,54450000,33,37,70,38500000
2286110,Hyper Pop,2023,Roguelike,Free,0%,19,11,30,0,20,11,31,0
3094800,Risk the Dark,2025,Roguelike,"₩10,900",0%,6,0,6,3270000,0,0,0,0
3886190,Magic Cat,2025,Roguelike,"₩5,600",0%,0,0,0,0,0,0,0,0
3199890,Ô,2025,Roguelike,"₩9,900",0%,0,0,0,0,0,0,0,0
1401400,Lovecraft's Untold Stories 2,2022,Roguelike,"₩21,500",0%,60,89,149,160175000,47,74,121,130075000
3786930,Seoul Exorcist 1111,2025,Roguelike,"₩19,500",0%,0,0,0,0,0,0,0,0
3092280,Guardians Of Restoration,2025,Roguelike,"₩11,000",0%,1,0,1,550000,0,0,0,0
3461730,Meow Tower - Doomsguard,2025,Roguelike,"₩11,000",0%,0,0,0,0,0,0,0,0
2886700,Star Scum,2025,Roguelike,"₩16,500",0%,0,0,0,0,0,0,0,0
269590,Claustrophobia: The Downward Struggle,2014,Roguelike,"₩5,500",0%,87,115,202,55550000,28,47,75,20625000
1240530,Dungeon Warriors,2020,Roguelike,"₩3,300",0%,8,9,17,2805000,5,9,14,2310000
340030,Dungeon of gain,2016,Roguelike,"₩5,600",0%,20,59,79,22120000,14,32,46,12880000
1492870,堕星之乱,2021,Roguelike,"₩1,100",0%,15,8,23,1265000,5,8,13,715000
1051060,Cookie Invaders,2020,Roguelike,"₩16,500",0%,5,2,7,5775000,0,0,0,0
1709260,Dice Tourney,2021,Roguelike,"₩4,400",0%,7,12,19,4180000,7,12,19,4180000
3652900,Later Elevator,2025,Roguelike,"₩4,500",0%,0,0,0,0,0,0,0,0
3009410,Moor Rail,2025,Roguelike,"₩17,500",0%,0,0,0,0,0,0,0,0
2416920,Groob,2023,Roguelike,"₩2,300",0%,4,7,11,1265000,3,7,10,1150000
1922670,Banner of Blood,2024,Roguelike,"₩4,500",0%,9,13,22,4950000,7,12,19,4275000
1139870,The Dark Eye : Book of Heroes,2020,Roguelike,"₩11,000",0%,83,127,210,115500000,73,118,191,105050000
314290,Obludia,2014,Roguelike,"₩3,400",0%,35,38,73,12410000,9,15,24,4080000
2866960,Wizlite: Everybody loved RPGs,2024,Roguelike,"₩20,920",25%,10,23,33,34518000,10,24,34,35564000
3310900,Dungeon Tracer,2025,Roguelike,"₩4,760",15%,0,0,0,0,0,0,0,0
3620430,Astral Savior,2025,Roguelike,"₩8,900",0%,0,0,0,0,0,0,0,0
306000,Super Dungeon Bros,2016,Roguelike,"₩20,000",0%,52,74,126,126000000,19,31,50,50000000
1455130,Number One Rich,2020,Roguelike,"₩6,700",0%,7,12,19,6365000,7,11,18,6030000
3506970,Chess Hunt,2025,Roguelike,"₩3,400",0%,0,0,0,0,0,0,0,0
1855890,My Hotel,2024,Roguelike,"₩18,500",0%,40,49,89,82325000,11,24,35,32375000
629340,Possession,2019,Roguelike,"₩10,500",0%,15,1,16,8400000,0,0,0,0
2752250,Survival Odyssey,2024,Roguelike,"₩9,000",0%,27,18,45,20250000,8,13,21,9450000
3243710,KOTARO Survivor,2025,Roguelike,"₩4,500",0%,0,0,0,0,0,0,0,0
3212290,Bumble Rumble,2025,Roguelike,"₩8,900",0%,0,0,0,0,0,0,0,0
2527600,The Detective Reaper Invites,2024,Roguelike,"₩11,000",0%,39,35,74,40700000,22,34,56,30800000
3886130,Metamancer,2025,Roguelike,"₩16,500",0%,0,0,0,0,0,0,0,0
2350630,Dark Age Legends,2025,Roguelike,"₩8,900",0%,0,0,0,0,0,0,0,0
2091750,Cold Way,2022,Roguelike,₩680,80%,9,0,9,306000,0,0,0,0
514410,Gun Brothers,2020,Roguelike,"₩9,300",0%,34,59,93,43245000,20,53,73,33945000
3565670,Mythic Trials 2,2025,Roguelike,"₩2,300",0%,0,0,0,0,0,0,0,0
1201910,Cook Dungeon,2019,Roguelike,"₩2,300",0%,7,15,22,2530000,7,13,20,2300000
3689520,Bioprototype,2025,Roguelike,"₩5,600",0%,0,0,0,0,0,0,0,0
1106790,Red Horizon,2019,Roguelike,Free,0%,13,25,38,0,13,25,38,0
3061690,Bee Hero: Bug Blaster,2025,Roguelike,"₩16,500",0%,0,0,0,0,0,0,0,0
2100010,Breakthrough,2023,Roguelike,"₩5,600",0%,4,0,4,1120000,0,0,0,0
360510,Into the Stars,2016,Roguelike,"₩21,500",0%,218,312,530,569750000,149,243,392,421400000
360510,Into the Stars,2016,Roguelike,"₩21,500",0%,218,312,530,569750000,149,243,392,421400000
3365630,Heroes & Dice,2025,Roguelike,"₩12,500",0%,0,0,0,0,0,0,0,0
3842300,Hell Builder,2025,Roguelike,"₩4,480",19%,0,0,0,0,0,0,0,0
3157550,Rogumon,2025,Roguelike,"₩3,400",0%,0,0,0,0,0,0,0,0
3139930,VTBattle-VTubers aren't about the number of subscribers! It's about power!,2024,Roguelike,"₩9,900",0%,10,0,10,4950000,0,0,0,0
2736350,Home Path,2024,Roguelike,Free,0%,0,0,0,0,0,0,0,0
1539710,DeadBlitZ,2024,Roguelike,"₩27,000",0%,4,0,4,5400000,0,0,0,0
3449110,STELA BOSS,2025,Roguelike,"₩1,100",0%,0,0,0,0,0,0,0,0
2468440,WestHalla,2023,Roguelike,"₩11,000",0%,0,1,1,550000,0,0,0,0
3132780,Forestygian,2025,Roguelike,"₩9,900",40%,24,1,25,12375000,0,0,0,0
1408730,KindFolx,2025,Roguelike,"₩16,500",0%,0,0,0,0,0,0,0,0
3298910,Once a Pawn a King,2025,Roguelike,"₩10,800",19%,0,0,0,0,0,0,0,0
3722810,Elliot's Great Symphony,2025,Roguelike,"₩3,400",0%,0,0,0,0,0,0,0,0
3405580,Lunar Rebirth: Dungeon of Eternal Return,2025,Roguelike,"₩2,300",0%,5,0,5,575000,0,0,0,0
3365400,Dungeon Mana,2025,Roguelike,"₩3,400",0%,5,1,6,1020000,0,0,0,0
3830500,工地四重奏,2025,Roguelike,"₩4,500",0%,0,0,0,0,0,0,0,0
3007890,RnGesus Slayer,2025,Roguelike,"₩7,800",0%,0,0,0,0,0,0,0,0
2940560,Upstream Ante,2024,Roguelike,"₩9,900",40%,0,1,1,495000,0,0,0,0
2521530,Damocles Gaze,2023,Roguelike,"₩6,700",0%,5,1,6,2010000,0,0,0,0
1007970,This Side (Early Access Game),2019,Roguelike,"₩10,500",0%,0,13,13,6825000,0,10,10,5250000
2238860,Ninjas in the Dungeon,2023,Roguelike,"₩1,100",0%,2,0,2,110000,0,0,0,0
2706880,Lost Pages: Classic,2024,Roguelike,"₩9,900",0%,4,0,4,1980000,0,0,0,0
3234380,Once upon a Dungeon - Infinity,2025,Roguelike,"₩5,600",0%,10,0,10,2800000,0,0,0,0
3185720,像素旅人-Pixel Traveler,2025,Roguelike,"₩1,100",0%,2,1,3,165000,0,0,0,0
461400,Massive,2020,Roguelike,"₩9,300",0%,71,33,104,48360000,13,30,43,19995000
1964500,The Battle of Sacred Heart,2024,Roguelike,"₩7,800",0%,3,10,13,5070000,2,10,12,4680000
845110,Snakelike,2019,Roguelike,"₩10,500",0%,1,0,1,525000,0,0,0,0
2712470,Downfall,2024,Roguelike,"₩5,900",0%,11,1,12,3540000,0,0,0,0
931040,BreakHack,2018,Roguelike,"₩1,100",0%,2,2,4,220000,0,0,0,0
3167760,DUNGEON WALK3－奇妙な狂闘－,2025,Roguelike,"₩5,600",0%,0,0,0,0,0,0,0,0
1774200,Abeyance,2022,Roguelike,"₩20,500",0%,5,3,8,8200000,0,0,0,0
2463000,KERIBATO!,2024,Roguelike,"₩4,500",0%,3,1,4,900000,0,0,0,0
2773220,DUNGEON WALK2－混沌の神々－,2024,Roguelike,"₩5,600",0%,1,0,1,280000,0,0,0,0
3676310,Nova Survivors,2025,Roguelike,"₩1,100",0%,6,0,6,330000,0,0,0,0
3600730,Desktop Standing Card Plates,2025,Roguelike,₩550,50%,8,0,8,220000,0,0,0,0
3682760,Dead In Your TrackZ,2025,Roguelike,"₩9,900",0%,0,0,0,0,0,0,0,0
2927910,Honey Bee With Guns,2024,Roguelike,"₩4,120",75%,2,1,3,618000,0,0,0,0
2218270,SAMURAI Survivor -Undefeated Blade-,2023,Roguelike,"₩3,400",0%,9,16,25,4250000,8,15,23,3910000
2817270,Fountain,2024,Roguelike,"₩4,500",0%,4,3,7,1575000,0,0,0,0
2750890,Path of Soul,2024,Roguelike,"₩5,600",0%,0,0,0,0,0,0,0,0
1832760,DarkBlood -Reborn-,2022,Roguelike,"₩10,500",0%,6,2,8,4200000,0,0,0,0
3823340,Abyss Defence,2025,Roguelike,"₩1,100",0%,0,0,0,0,0,0,0,0
2979020,Clayers: Prologue,2025,Roguelike,"₩3,400",0%,9,1,10,1700000,0,0,0,0
2342320,Insane Escape,2025,Roguelike,"₩21,500",0%,3,3,6,6450000,0,0,0,0
2979020,Clayers: Prologue,2025,Roguelike,"₩3,400",0%,9,1,10,1700000,0,0,0,0
3010470,Particle,2024,Roguelike,"₩3,400",0%,1,1,2,340000,0,0,0,0
3350910,The Fourth Anno,2025,Roguelike,"₩3,400",0%,3,0,3,510000,0,0,0,0
2915360,Hide And Seek,2024,Roguelike,"₩2,300",0%,3,2,5,575000,0,0,0,0
3874760,Celestial Visitor,2025,Roguelike,"₩3,380",0%,0,0,0,0,0,0,0,0
1263120,Hecaton,2020,Roguelike,"₩2,300",0%,5,2,7,805000,0,0,0,0
3854560,Tronix Carnival Games,2025,Roguelike,Unknown,0%,0,0,0,0,0,0,0,0
3735020,The Between,2025,Roguelike,"₩4,500",0%,0,0,0,0,0,0,0,0
3650230,Fortune Paradox,2025,Roguelike,"₩1,960",65%,7,0,7,686000,0,0,0,0
3456480,魔法幸存者 Magic Survivors,2025,Roguelike,"₩2,300",0%,2,1,3,345000,0,0,0,0
3302460,Enerdusk,2025,Roguelike,"₩5,600",0%,3,0,3,840000,0,0,0,0
3304430,Vasrak Kingdom: Battle on the frontier,2025,Roguelike,"₩4,900",0%,8,0,8,1960000,0,0,0,0
1406490,Quester,2022,Roguelike,"₩10,500",0%,6,0,6,3150000,0,0,0,0
2750540,MasterQuest Fantasy,2024,Roguelike,"₩17,500",0%,8,1,9,7875000,0,0,0,0
3793840,Polygon War,2025,Roguelike,"₩2,300",0%,0,0,0,0,0,0,0,0
3266800,EndSeeker,2025,Roguelike,"₩6,700",0%,0,0,0,0,0,0,0,0
2352710,Shoot & Neon,2025,Roguelike,"₩3,400",0%,0,0,0,0,0,0,0,0
3149940,和！和！和！RogueXMahjong,2024,Roguelike,"₩1,100",0%,1,1,2,110000,0,0,0,0
1545880,Herman Electro,2021,Roguelike,"₩5,600",0%,5,0,5,1400000,0,0,0,0
2350190,Ascendant's Roguelike,2023,Roguelike,"₩1,100",0%,2,0,2,110000,0,0,0,0
3874190,Click Adventure,2025,Roguelike,₩660,40%,0,0,0,0,0,0,0,0
2388480,HatLand,2023,Roguelike,"₩4,500",0%,0,2,2,450000,0,0,0,0
2942160,Sentry System,2024,Roguelike,"₩8,900",0%,3,2,5,2225000,0,0,0,0
3376550,4X4 PROGRESS,2025,Roguelike,"₩6,700",0%,2,0,2,670000,0,0,0,0
1678340,Side Effect,2025,Roguelike,"₩8,500",0%,3,0,3,1275000,0,0,0,0
3843290,Beasts of Fortune,2025,Roguelike,"₩7,700",30%,0,0,0,0,0,0,0,0
3417350,Hero Hellspawn - Learn Arithmetic,2025,Roguelike,"₩3,400",0%,1,0,1,170000,0,0,0,0
3867530,Way to Town,2025,Roguelike,"₩2,300",0%,0,0,0,0,0,0,0,0
3057250,Pennylooter,2024,Roguelike,"₩3,400",0%,1,0,1,170000,0,0,0,0
2174370,Slugmania,2023,Roguelike,"₩2,300",0%,2,0,2,230000,0,0,0,0
2935380,Little Fire Girl Fights Final Boss / 小紅姐掉站终极Boss!,2024,Roguelike,"₩1,100",0%,0,1,1,55000,0,0,0,0
3293460,Static Black,2024,Roguelike,"₩2,300",0%,3,0,3,345000,0,0,0,0
2434720,Maces and Dices,2023,Roguelike,"₩7,800",0%,7,0,7,2730000,0,0,0,0
3293020,No More Enemies,2025,Roguelike,"₩5,360",0%,5,0,5,1340000,0,0,0,0
2557510,Disciples of Varahces,2024,Roguelike,"₩5,600",0%,1,0,1,280000,0,0,0,0
1054640,The Tower of Worth,2019,Roguelike,"₩7,500",0%,8,3,11,4125000,0,0,0,0
3293460,Static Black,2024,Roguelike,"₩2,300",0%,3,0,3,345000,0,0,0,0
2088750,Mystic Gate,2023,Roguelike,"₩11,000",0%,24,3,27,14850000,0,0,0,0
2818830,Ghost Ascension,2024,Roguelike,"₩1,100",0%,6,0,6,330000,0,0,0,0
2434720,Maces and Dices,2023,Roguelike,"₩7,800",0%,7,0,7,2730000,0,0,0,0
2584450,少女与机甲/Girls And Robots,2024,Roguelike,"₩5,600",0%,2,3,5,1400000,0,0,0,0
2117190,Spliced,2022,Roguelike,"₩7,500",0%,4,0,4,1500000,0,0,0,0
2940830,Streets of Handbags,2025,Roguelike,"₩4,500",0%,4,0,4,900000,0,0,0,0
1150540,Offcoast,2024,Roguelike,"₩16,500",0%,2,0,2,1650000,0,0,0,0
2431940,Time Knight VS. Zombies,2023,Roguelike,"₩7,800",0%,4,0,4,1560000,0,0,0,0
2471060,DIVINE SHOCK,2023,Roguelike,"₩5,000",0%,21,1,22,5500000,0,0,0,0
3367770,SHEOL INFERNO,2025,Roguelike,"₩16,500",0%,7,0,7,5775000,0,0,0,0
2940840,Stella,2025,Roguelike,"₩5,600",0%,0,0,0,0,0,0,0,0
1863720,Small Crystal,2022,Roguelike,"₩3,300",0%,0,0,0,0,0,0,0,0
2717690,Roll Over Princess,2024,Roguelike,"₩15,500",0%,2,1,3,2325000,0,0,0,0
2261420,BoxLoop 2,2023,Roguelike,"₩2,300",0%,1,0,1,115000,0,0,0,0
2062270,BoxLoop,2022,Roguelike,"₩1,100",0%,0,0,0,0,0,0,0,0
2261420,BoxLoop 2,2023,Roguelike,"₩2,300",0%,1,0,1,115000,0,0,0,0
3363700,Beyond the Bridge,2024,Roguelike,"₩5,600",0%,8,0,8,2240000,0,0,0,0
2161130,Rerun,2023,Roguelike,"₩5,600",0%,7,2,9,2520000,0,0,0,0
3330180,RANDOBOUNCE,2025,Roguelike,"₩5,600",0%,0,0,0,0,0,0,0,0
1580500,Cardlike,2022,Roguelike,"₩4,400",0%,1,0,1,220000,0,0,0,0
2919340,Project P,2024,Roguelike,Free,0%,0,0,0,0,0,0,0,0
2376740,200 DAYS Zombie Apocalypse,2023,Roguelike,"₩9,900",0%,3,5,8,3960000,0,0,0,0
3059290,Deep Dungeon Knight,2024,Roguelike,"₩56,000",0%,0,0,0,0,0,0,0,0
1869280,INTO THE CTHULHU MYTHOLOGY,2022,Roguelike,"₩3,300",0%,6,0,6,990000,0,0,0,0
3682080,Gambler’s Loop,2025,Roguelike,"₩2,300",0%,0,0,0,0,0,0,0,0
2307830,SharkKing,2023,Roguelike,"₩5,600",0%,4,0,4,1120000,0,0,0,0
3585220,Monster Mayhem,2025,Roguelike,"₩3,400",0%,0,0,0,0,0,0,0,0
2795120,烟花绘梦 Firework Survivor,2024,Roguelike,"₩2,300",0%,10,2,12,1380000,0,0,0,0
3682080,Gambler’s Loop,2025,Roguelike,"₩2,300",0%,0,0,0,0,0,0,0,0
3585220,Monster Mayhem,2025,Roguelike,"₩3,400",0%,0,0,0,0,0,0,0,0
3449860,Charta Dungeon - Ambidextrous,2025,Roguelike,"₩4,500",0%,4,1,5,1125000,0,0,0,0
2988470,Fool's Gambit,2024,Roguelike,"₩4,500",0%,4,0,4,900000,0,0,0,0
1225850,NonetEnsemble:MagicworkLabyrinth,2020,Roguelike,"₩20,500",0%,12,5,17,17425000,0,0,0,0
2307830,SharkKing,2023,Roguelike,"₩5,600",0%,4,0,4,1120000,0,0,0,0
3541730,Dark Crescent,2025,Roguelike,"₩2,300",0%,3,0,3,345000,0,0,0,0
1590390,ACE Overheat,2025,Roguelike,Unknown,0%,0,0,0,0,0,0,0,0
2091280,Veggies War,2022,Roguelike,"₩5,500",0%,6,1,7,1925000,0,0,0,0
3176790,Tesserarii: The Dice Rolling Roguelike,2025,Roguelike,"₩8,900",0%,3,0,3,1335000,0,0,0,0
3115890,CROAK CAFE : FROM POND TO PLATE,2025,Roguelike,Free,0%,0,0,0,0,0,0,0,0
2856490,Death From The Darkness,2024,Roguelike,"₩2,800",50%,4,7,11,1540000,0,0,0,0
2972770,Highway Hijinks,2024,Roguelike,"₩6,700",0%,6,1,7,2345000,0,0,0,0
2353800,Shapes & Shots - Prologue,2023,Roguelike,Free,0%,0,0,0,0,0,0,0,0
3055550,Security Simulator: Nightshift,2024,Roguelike,"₩8,900",0%,3,0,3,1335000,0,0,0,0
3732840,Slime Match Adventure,2025,Roguelike,"₩2,550",25%,0,0,0,0,0,0,0,0
3800820,Right & Left Column Battle,2025,Roguelike,Unknown,0%,0,0,0,0,0,0,0,0
1552260,Apsis Online,2023,Roguelike,"₩5,600",0%,1,0,1,280000,0,0,0,0
3780230,Desktop Clicker,2025,Roguelike,"₩3,400",0%,0,0,0,0,0,0,0,0
2764870,Geometry Survivor [0],2024,Roguelike,"₩5,600",0%,6,0,6,1680000,0,0,0,0
1707630,Dungeon Conqueror,2022,Roguelike,"₩4,500",0%,1,0,1,225000,0,0,0,0
2979620,"Spaceman Wakes Up In A New World, The Government Has Been Experimenting On People On the Moon and Created Crazy Vine Monsters",2024,Roguelike,"₩5,600",0%,1,0,1,280000,0,0,0,0
2363220,The Cube of World,2023,Roguelike,"₩2,300",0%,0,1,1,115000,0,0,0,0
3292920,Lucky Hand: Roguelike Deck Builder,2025,Roguelike,"₩8,900",0%,1,1,2,890000,0,0,0,0
3186370,Cadava,2024,Roguelike,"₩11,000",0%,1,0,1,550000,0,0,0,0
610710,Sea Of Secrets,2025,Roguelike,"₩5,600",0%,0,0,0,0,0,0,0,0
3186370,Cadava,2024,Roguelike,"₩11,000",0%,1,0,1,550000,0,0,0,0
3780230,Desktop Clicker,2025,Roguelike,"₩3,400",0%,0,0,0,0,0,0,0,0
1399030,Wacky Wizarding Dungeon,2021,Roguelike,"₩6,500",0%,1,0,1,325000,0,0,0,0
1824070,Rejoinder,2022,Roguelike,"₩5,500",0%,3,2,5,1375000,0,0,0,0
3292920,Lucky Hand: Roguelike Deck Builder,2025,Roguelike,"₩8,900",0%,1,1,2,890000,0,0,0,0
2621470,Endless Desert TD,2024,Roguelike,"₩6,700",0%,2,1,3,1005000,0,0,0,0
3248450,InvisibleHand,2024,Roguelike,"₩2,300",0%,0,2,2,230000,0,0,0,0
2937620,The Last Spin,2024,Roguelike,"₩5,600",0%,1,1,2,560000,0,0,0,0
610710,Sea Of Secrets,2025,Roguelike,"₩5,600",0%,0,0,0,0,0,0,0,0
1256220,幸存者 星星之火 | Survivor Spark,2020,Roguelike,"₩1,100",0%,14,2,16,880000,0,0,0,0
3565560,BOX KING,2025,Roguelike,"₩5,600",0%,0,0,0,0,0,0,0,0
3678880,Swarm Sweeper,2025,Roguelike,"₩3,400",0%,0,0,0,0,0,0,0,0
3565560,BOX KING,2025,Roguelike,"₩5,600",0%,0,0,0,0,0,0,0,0
3678880,Swarm Sweeper,2025,Roguelike,"₩3,400",0%,0,0,0,0,0,0,0,0
3551370,魔书射爆（Book Shooter）,2025,Roguelike,Unknown,0%,0,0,0,0,0,0,0,0
3738660,Nocturnal Survivors,2025,Roguelike,"₩3,400",0%,0,0,0,0,0,0,0,0
3396810,Gulls of Doom,2025,Roguelike,Unknown,0%,0,0,0,0,0,0,0,0
2607730,Leave Panda Away,2023,Roguelike,Free,0%,4,5,9,0,0,0,0,0
2774560,Foulbreaker,2024,Roguelike,"₩2,300",0%,6,0,6,690000,0,0,0,0
2233820,Vengeful Castle,2023,Roguelike,"₩7,990",0%,3,1,4,1598000,0,0,0,0
3480320,Ax Roguelike,2025,Roguelike,"₩5,600",0%,0,0,0,0,0,0,0,0
3221000,Fengdu Chronicles of battle,2024,Roguelike,"₩8,900",0%,9,3,12,5340000,0,0,0,0
2112140,CAPTROON,2022,Roguelike,"₩2,300",0%,9,0,9,1035000,0,0,0,0
3644040,Goblins & Gun Runnin’,2025,Roguelike,Free,0%,0,0,0,0,0,0,0,0
3184570,The Beast in the Silent Valley,2024,Roguelike,"₩3,400",0%,1,0,1,170000,0,0,0,0
2118550,FastRogue,2022,Roguelike,"₩6,690",0%,1,1,2,669000,0,0,0,0
3221000,Fengdu Chronicles of battle,2024,Roguelike,"₩8,900",0%,9,3,12,5340000,0,0,0,0
2233820,Vengeful Castle,2023,Roguelike,"₩7,990",0%,3,1,4,1598000,0,0,0,0
3102650,Micro Star Command,2024,Roguelike,"₩2,300",0%,8,0,8,920000,0,0,0,0
2574650,SHAPE HUNTER,2023,Roguelike,"₩2,300",0%,2,1,3,345000,0,0,0,0
3332490,Arpicos,2024,Roguelike,"₩5,600",0%,0,0,0,0,0,0,0,0
2909390,Wish you happiness,2024,Roguelike,"₩2,300",0%,0,0,0,0,0,0,0,0
3475770,Meta Card Backpack Legend,2025,Roguelike,Unknown,0%,0,0,0,0,0,0,0,0
2520960,DawnOfCombat,2023,Roguelike,Free,0%,4,1,5,0,0,0,0,0
2681340,Four Hunters Survivor,2023,Roguelike,"₩1,100",0%,1,1,2,110000,0,0,0,0
2846520,Dungeons & Cardboards,2024,Roguelike,"₩2,300",0%,3,1,4,460000,0,0,0,0
3378300,Final Resistance 2,2025,Roguelike,"₩4,500",0%,0,1,1,225000,0,0,0,0
2524720,Little Eden,2024,Roguelike,"₩5,600",0%,4,0,4,1120000,0,0,0,0
2209360,Reclamation of Xanthros,2025,Roguelike,"₩5,600",0%,0,0,0,0,0,0,0,0
3444180,梦镜—乌托邦Dream MirrorUtopia,2025,Roguelike,"₩3,400",0%,1,0,1,170000,0,0,0,0
3332490,Arpicos,2024,Roguelike,"₩5,600",0%,0,0,0,0,0,0,0,0
2688520,Hrumka,2024,Roguelike,"₩2,300",0%,0,0,0,0,0,0,0,0
3221940,LOST TIMES,2024,Roguelike,"₩56,000",0%,0,0,0,0,0,0,0,0
3817050,SlimeCraft,2025,Roguelike,"₩3,360",40%,0,0,0,0,0,0,0,0
3475770,Meta Card Backpack Legend,2025,Roguelike,Unknown,0%,0,0,0,0,0,0,0,0
3085010,Emoji Shooter,2025,Roguelike,"₩7,800",0%,24,0,24,9360000,0,0,0,0
2027040,WOE,2023,Roguelike,"₩5,500",0%,7,1,8,2200000,0,0,0,0
2556040,傀儡の宿 - Kairai Inn -,2023,Roguelike,"₩5,600",0%,7,0,7,1960000,0,0,0,0
2998060,Mental Math Madness,2024,Roguelike,"₩1,100",0%,0,1,1,55000,0,0,0,0
3182570,Three Against the Odds,2024,Roguelike,"₩7,800",0%,6,0,6,2340000,0,0,0,0
3707610,Delirium: Echoes of the Domino,2025,Roguelike,"₩9,900",0%,0,0,0,0,0,0,0,0
3182570,Three Against the Odds,2024,Roguelike,"₩7,800",0%,6,0,6,2340000,0,0,0,0
3707610,Delirium: Echoes of the Domino,2025,Roguelike,"₩9,900",0%,0,0,0,0,0,0,0,0
2512680,I'm Not Sleepy,2024,Roguelike,"₩11,000",0%,1,0,1,550000,0,0,0,0
3548220,CursorLublub,2025,Roguelike,"₩5,600",0%,0,0,0,0,0,0,0,0
2027040,WOE,2023,Roguelike,"₩5,500",0%,7,1,8,2200000,0,0,0,0
2385800,A Good Place To Die,2024,Roguelike,"₩2,300",0%,2,2,4,460000,0,0,0,0
2610030,Conqueror Of Time,2024,Roguelike,"₩11,000",0%,1,0,1,550000,0,0,0,0
2998060,Mental Math Madness,2024,Roguelike,"₩1,100",0%,0,1,1,55000,0,0,0,0
2701310,Shuffled Sky,2024,Roguelike,"₩19,500",0%,2,0,2,1950000,0,0,0,0
1398420,One Last Dungeon,2020,Roguelike,"₩5,500",0%,8,2,10,2750000,0,0,0,0
3106070,How Can a Joker Like Me Play Cards with a Beautiful Girl,2024,Roguelike,"₩3,400",0%,5,0,5,850000,0,0,0,0
3155780,The Valley: XuGu,2024,Roguelike,"₩7,800",0%,17,3,20,7800000,0,0,0,0
2473830,Endless Dreamland,2024,Roguelike,"₩1,100",0%,2,0,2,110000,0,0,0,0
3244360,Plant the Towers,2024,Roguelike,"₩3,400",0%,8,0,8,1360000,0,0,0,0
1398420,One Last Dungeon,2020,Roguelike,"₩5,500",0%,8,2,10,2750000,0,0,0,0
3277650,FIENDRISE,2025,Roguelike,"₩4,500",0%,7,0,7,1575000,0,0,0,0
3660330,Mythic Ascendancy,2025,Roguelike,"₩4,500",0%,4,0,4,900000,0,0,0,0
858070,Leviathan's Sword,2022,Roguelike,"₩15,500",0%,5,0,5,3875000,0,0,0,0
2374410,My Hero After the Fall,2023,Roguelike,"₩6,700",0%,11,2,13,4355000,0,0,0,0
3383940,Frak,2025,Roguelike,Free,0%,0,0,0,0,0,0,0,0
2620380,Art is Boom,2023,Roguelike,"₩4,500",0%,16,1,17,3825000,0,0,0,0
3696180,Lost World Survivor,2025,Roguelike,"₩5,600",0%,0,0,0,0,0,0,0,0
2723500,Gatebreakers,2025,Roguelike,"₩5,600",0%,0,0,0,0,0,0,0,0
1778200,Minigunner®,2023,Roguelike,"₩11,000",0%,12,0,12,6600000,0,0,0,0
858070,Leviathan's Sword,2022,Roguelike,"₩15,500",0%,5,0,5,3875000,0,0,0,0
3238920,Lexica,2024,Roguelike,"₩5,600",0%,6,0,6,1680000,0,0,0,0
2316840,CardShark,2023,Roguelike,"₩6,700",0%,4,1,5,1675000,0,0,0,0
3696180,Lost World Survivor,2025,Roguelike,"₩5,600",0%,0,0,0,0,0,0,0,0
1778200,Minigunner®,2023,Roguelike,"₩11,000",0%,12,0,12,6600000,0,0,0,0
3768430,Pinballers,2025,Roguelike,"₩6,700",0%,0,0,0,0,0,0,0,0
2472740,Chains of the Goddess,2023,Roguelike,"₩1,100",0%,5,1,6,330000,0,0,0,0
1523220,Overpower,2021,Roguelike,"₩10,500",0%,4,2,6,3150000,0,0,0,0
2470630,Bullet Town,2023,Roguelike,"₩5,600",0%,4,0,4,1120000,0,0,0,0
3450340,Henshin MyBro!,2025,Roguelike,"₩5,600",0%,16,2,18,5040000,0,0,0,0
2472740,Chains of the Goddess,2023,Roguelike,"₩1,100",0%,5,1,6,330000,0,0,0,0
1523220,Overpower,2021,Roguelike,"₩10,500",0%,4,2,6,3150000,0,0,0,0
3609980,"Yes, My Queen",2025,Roguelike,Unknown,0%,0,0,0,0,0,0,0,0
3348710,Freeky Faucets Arcade,2025,Roguelike,"₩5,600",0%,8,0,8,2240000,0,0,0,0
2558660,Brave Trial,2023,Roguelike,"₩2,930",0%,2,0,2,293000,0,0,0,0
2446200,Dice Mayor,2023,Roguelike,"₩4,500",0%,3,2,5,1125000,0,0,0,0
1795540,MudGate,2025,Roguelike,"₩11,000",0%,2,1,3,1650000,0,0,0,0
2312890,Endless Spaceship,2023,Roguelike,"₩1,100",0%,5,0,5,275000,0,0,0,0
2487950,Mecha Kucha Gacha Defence,2023,Roguelike,"₩5,600",0%,2,0,2,560000,0,0,0,0
2066730,Deep Space Survivor,2024,Roguelike,"₩5,600",0%,1,0,1,280000,0,0,0,0
1530020,Broken Dungeon,2021,Roguelike,"₩15,500",0%,6,2,8,6200000,0,0,0,0
2271280,ROGLE,2023,Roguelike,"₩5,600",0%,5,3,8,2240000,0,0,0,0
3845930,R.E.M. Rage,2025,Roguelike,"₩14,500",0%,0,0,0,0,0,0,0,0
2817780,Magical School Girls Battle Arena,2024,Roguelike,"₩2,300",0%,0,0,0,0,0,0,0,0
1954570,Death Dungeon,2022,Roguelike,"₩1,100",0%,2,1,3,165000,0,0,0,0
3348510,Tower Arena Survive,2025,Roguelike,"₩5,600",0%,0,0,0,0,0,0,0,0
2941930,Shape Survivor 图形幸存者,2024,Roguelike,"₩3,400",0%,7,0,7,1190000,0,0,0,0
1776800,KarmaCrown,2021,Roguelike,"₩3,300",0%,2,0,2,330000,0,0,0,0
3596000,Show Me The Money:Desktop Gold Rush,2025,Roguelike,"₩1,100",0%,0,0,0,0,0,0,0,0
2899160,AI Fantasy,2024,Roguelike,"₩5,600",0%,2,4,6,1680000,0,0,0,0
3030490,Direction!LevelUP!,2024,Roguelike,"₩2,300",0%,13,0,13,1495000,0,0,0,0
2660500,Devilish Blind Date,2023,Roguelike,"₩6,700",0%,15,1,16,5360000,0,0,0,0
2698680,Card Fuse,2023,Roguelike,"₩7,800",0%,7,0,7,2730000,0,0,0,0
2698680,Card Fuse,2023,Roguelike,"₩7,800",0%,7,0,7,2730000,0,0,0,0
2335740,Jeff: The Hungry Fish,2023,Roguelike,"₩1,100",0%,6,0,6,330000,0,0,0,0
2282910,Lair of goblins,2023,Roguelike,"₩8,900",0%,1,0,1,445000,0,0,0,0
3830130,Humanity's Last Hope,2025,Roguelike,"₩1,100",0%,0,0,0,0,0,0,0,0
2141900,Ravyne,2022,Roguelike,"₩3,400",0%,1,1,2,340000,0,0,0,0
1682750,RoguekiniZ,2023,Roguelike,"₩12,500",0%,1,1,2,1250000,0,0,0,0
2248420,Infinity Trials,2023,Roguelike,"₩3,400",0%,5,1,6,1020000,0,0,0,0
2265870,Virus Survivor,2023,Roguelike,"₩2,300",0%,1,1,2,230000,0,0,0,0
3760160,Dungeon Raid: Zero Floor,2025,Roguelike,Free,0%,0,0,0,0,0,0,0,0
1573500,Red Measures,2021,Roguelike,"₩3,400",0%,4,1,5,850000,0,0,0,0
3405340,Megabonk,2025,Roguelike,Unknown,0%,0,0,0,0,0,0,0,0
3759210,5 Min Space Battle,2025,Roguelike,"₩6,700",0%,0,0,0,0,0,0,0,0
3665740,Hope Town,2025,Roguelike,"₩5,900",0%,0,0,0,0,0,0,0,0
3474020,Tanne: Portals of Eternity,2025,Roguelike,"₩2,300",0%,3,1,4,460000,0,0,0,0
3370170,The underworld of brain damage,2024,Roguelike,"₩5,600",0%,0,0,0,0,0,0,0,0
3759210,5 Min Space Battle,2025,Roguelike,"₩6,700",0%,0,0,0,0,0,0,0,0
3496850,Living Cost,2025,Roguelike,"₩3,400",0%,0,0,0,0,0,0,0,0
1573500,Red Measures,2021,Roguelike,"₩3,400",0%,4,1,5,850000,0,0,0,0
3405340,Megabonk,2025,Roguelike,Unknown,0%,0,0,0,0,0,0,0,0
3151530,ChessRogue,2024,Roguelike,"₩1,100",0%,3,0,3,165000,0,0,0,0
3665740,Hope Town,2025,Roguelike,"₩5,900",0%,0,0,0,0,0,0,0,0
2710390,DANGER ZONE BOMBER,2023,Roguelike,"₩3,400",0%,1,1,2,340000,0,0,0,0
3656050,Aleato,2025,Roguelike,Unknown,0%,0,0,0,0,0,0,0,0
3330200,noSpellHero,2024,Roguelike,Free,0%,0,0,0,0,0,0,0,0
2191310,Project Survivor,2023,Roguelike,"₩3,400",0%,7,0,7,1190000,0,0,0,0
726450,Hero's Descent,2021,Roguelike,Free,0%,7,0,7,0,0,0,0,0
1952310,Signs of Birth,2024,Roguelike,"₩3,400",0%,0,0,0,0,0,0,0,0
1352470,Carrot Heart,2022,Roguelike,"₩8,500",0%,8,2,10,4250000,0,0,0,0
3330200,noSpellHero,2024,Roguelike,Free,0%,0,0,0,0,0,0,0,0
3343480,SeedGod,2025,Roguelike,Unknown,0%,0,0,0,0,0,0,0,0
2710390,DANGER ZONE BOMBER,2023,Roguelike,"₩3,400",0%,1,1,2,340000,0,0,0,0
3656050,Aleato,2025,Roguelike,Unknown,0%,0,0,0,0,0,0,0,0
1891030,Dummy Dungeon,2024,Roguelike,"₩7,800",0%,6,1,7,2730000,0,0,0,0
3135450,TowerUp: Breakout,2024,Roguelike,"₩2,300",0%,4,2,6,690000,0,0,0,0
3093220,Hope: a potato story,2025,Roguelike,"₩5,600",0%,0,0,0,0,0,0,0,0
2211960,Counterspell,2022,Roguelike,"₩1,100",0%,4,0,4,220000,0,0,0,0
2788990,Romantic Life,2024,Roguelike,"₩2,300",0%,5,4,9,1035000,0,0,0,0
3598190,Hamspater,2025,Roguelike,"₩2,300",0%,4,0,4,460000,0,0,0,0
2350050,Cosmic Survivor,2023,Roguelike,Free,0%,7,2,9,0,0,0,0,0
3582850,Orange You Glad i Didn't Say Banana,2025,Roguelike,Free,0%,0,0,0,0,0,0,0,0
3692890,Border Overload,2025,Roguelike,"₩1,100",0%,0,0,0,0,0,0,0,0
2788990,Romantic Life,2024,Roguelike,"₩2,300",0%,5,4,9,1035000,0,0,0,0
2719210,Slime Link,2023,Roguelike,"₩1,100",0%,2,1,3,165000,0,0,0,0
3658970,Antibored Evolution,2025,Roguelike,"₩9,350",15%,0,0,0,0,0,0,0,0
1705610,PushOps,2022,Roguelike,"₩2,200",0%,7,1,8,880000,0,0,0,0
726450,Hero's Descent,2021,Roguelike,Free,0%,7,0,7,0,0,0,0,0
1952310,Signs of Birth,2024,Roguelike,"₩3,400",0%,0,0,0,0,0,0,0,0
1352470,Carrot Heart,2022,Roguelike,"₩8,500",0%,8,2,10,4250000,0,0,0,0
2660120,Mr.Chip,2024,Roguelike,"₩1,100",0%,1,1,2,110000,0,0,0,0
1728430,I wanna go home,2022,Roguelike,"₩3,900",0%,10,3,13,2535000,0,0,0,0
1627290,Mess Cleanup,2021,Roguelike,"₩1,100",0%,1,0,1,55000,0,0,0,0
3341140,Qurtys,2025,Roguelike,"₩16,500",0%,0,1,1,825000,0,0,0,0
2664260,Rogue Survivalist,2023,Roguelike,"₩1,100",0%,0,0,0,0,0,0,0,0
2173300,Skull Survivor,2023,Roguelike,"₩4,500",0%,6,0,6,1350000,0,0,0,0
3167610,Deck of Destiny: Battleforge,2025,Roguelike,"₩3,300",40%,0,0,0,0,0,0,0,0
2660120,Mr.Chip,2024,Roguelike,"₩1,100",0%,1,1,2,110000,0,0,0,0
1627290,Mess Cleanup,2021,Roguelike,"₩1,100",0%,1,0,1,55000,0,0,0,0
1979990,Galactic Escape,2023,Roguelike,"₩11,000",0%,3,0,3,1650000,0,0,0,0
3837080,Lightcore Guardians,2025,Roguelike,"₩3,400",0%,0,0,0,0,0,0,0,0
2664260,Rogue Survivalist,2023,Roguelike,"₩1,100",0%,0,0,0,0,0,0,0,0
2085320,Meow Defence,2022,Roguelike,"₩3,400",0%,11,0,11,1870000,0,0,0,0
3447360,Requiem of Dread,2025,Roguelike,Free,0%,0,0,0,0,0,0,0,0
2837160,USG,2024,Roguelike,"₩5,600",0%,6,0,6,1680000,0,0,0,0
645240,Costumenaut,2017,Roguelike,"₩5,500",0%,7,0,7,1925000,0,0,0,0
1205650,i Have Powers!,2021,Roguelike,"₩1,100",0%,6,2,8,440000,0,0,0,0
1326290,BALROG,2021,Roguelike,"₩26,000",0%,4,1,5,6500000,0,0,0,0
2258960,Adventure with the Goddess,2023,Roguelike,"₩12,500",0%,5,3,8,5000000,0,0,0,0
3238250,ROGUE HANDS!,2025,Roguelike,"₩4,500",0%,3,0,3,675000,0,0,0,0
2569830,Vaccine Rebirth VR,2023,Roguelike,"₩2,300",0%,5,0,5,575000,0,0,0,0
3217300,Combat Survivors,2024,Roguelike,"₩1,100",0%,0,0,0,0,0,0,0,0
3255480,Riverside of Dice,2024,Roguelike,"₩5,600",0%,3,0,3,840000,0,0,0,0
1361630,Grandpurrents,2020,Roguelike,"₩6,500",0%,0,0,0,0,0,0,0,0
2258960,Adventure with the Goddess,2023,Roguelike,"₩12,500",0%,5,3,8,5000000,0,0,0,0
2092000,Calamity Sanctuary,2024,Roguelike,"₩3,400",0%,0,0,0,0,0,0,0,0
2308890,Sliding Swords,2023,Roguelike,"₩4,500",0%,1,0,1,225000,0,0,0,0
1205650,i Have Powers!,2021,Roguelike,"₩1,100",0%,6,2,8,440000,0,0,0,0
1326290,BALROG,2021,Roguelike,"₩26,000",0%,4,1,5,6500000,0,0,0,0
2902090,Tribute,2024,Roguelike,"₩1,100",0%,2,0,2,110000,0,0,0,0
2811720,I'm lost in space,2025,Roguelike,"₩4,500",0%,1,0,1,225000,0,0,0,0
1563460,Star Salvager,2024,Roguelike,"₩14,500",0%,10,1,11,7975000,0,0,0,0
2902090,Tribute,2024,Roguelike,"₩1,100",0%,2,0,2,110000,0,0,0,0
2811720,I'm lost in space,2025,Roguelike,"₩4,500",0%,1,0,1,225000,0,0,0,0
2655040,Separated Worlds,2024,Roguelike,"₩5,600",0%,1,0,1,280000,0,0,0,0
2065870,Prescience,2024,Roguelike,"₩13,500",0%,13,0,13,8775000,0,0,0,0
831350,Hovercraft Drive,2018,Roguelike,"₩5,500",0%,0,1,1,275000,0,0,0,0
2986390,Dead Room,2024,Roguelike,"₩3,400",0%,1,0,1,170000,0,0,0,0
1394940,Nak Sim: Fallen Warriors,2021,Roguelike,"₩13,500",0%,0,1,1,675000,0,0,0,0
2079460,Hill Dig: The Mysterious Signal,2023,Roguelike,"₩17,500",0%,5,0,5,4375000,0,0,0,0
3041130,BUILD SCRAP,2025,Roguelike,"₩7,700",30%,0,0,0,0,0,0,0,0
1947490,Death's Dungeon,2023,Roguelike,"₩5,500",0%,7,0,7,1925000,0,0,0,0
2459400,Nine Paradise: The Origin,2023,Roguelike,"₩4,500",0%,0,0,0,0,0,0,0,0
663530,Dragon's Lunch,2017,Roguelike,"₩5,500",0%,2,2,4,1100000,0,0,0,0
2200900,The Ranger: A Skyhopper Tale,2022,Roguelike,"₩4,500",0%,2,0,2,450000,0,0,0,0
1685550,Zombardment,2021,Roguelike,"₩3,400",0%,1,0,1,170000,0,0,0,0
1960650,Dash Around Madly,2022,Roguelike,"₩2,200",0%,1,0,1,110000,0,0,0,0
3159290,Generic Space Game,2024,Roguelike,"₩6,700",0%,1,0,1,335000,0,0,0,0
831350,Hovercraft Drive,2018,Roguelike,"₩5,500",0%,0,1,1,275000,0,0,0,0
2986390,Dead Room,2024,Roguelike,"₩3,400",0%,1,0,1,170000,0,0,0,0
2301600,TouhouTraveler,2023,Roguelike,"₩2,300",0%,0,0,0,0,0,0,0,0
2485170,Vicious Star: kill All,2023,Roguelike,"₩3,400",0%,3,3,6,1020000,0,0,0,0
1219420,Millions of Minions: An Underground Adventure,2020,Roguelike,"₩5,500",0%,8,1,9,2475000,0,0,0,0
3891840,Florida Survivor,2025,Roguelike,Unknown,0%,0,0,0,0,0,0,0,0
2803090,Spoils of a Starfighter,2024,Roguelike,"₩2,300",0%,2,0,2,230000,0,0,0,0
2735150,Tome Supreme,2024,Roguelike,"₩13,500",0%,1,0,1,675000,0,0,0,0
2584570,West of the Witchlands,2025,Roguelike,"₩5,600",0%,6,0,6,1680000,0,0,0,0
2522190,The Night Watch : Ranger Survival,2023,Roguelike,"₩1,100",0%,1,0,1,55000,0,0,0,0
3424090,JusTD,2025,Roguelike,"₩13,500",0%,5,0,5,3375000,0,0,0,0
3013900,Cat Good Work,2024,Roguelike,"₩2,040",40%,4,0,4,408000,0,0,0,0
2800620,The Dungeons Of Algoduul,2024,Roguelike,"₩5,600",0%,4,0,4,1120000,0,0,0,0
2522190,The Night Watch : Ranger Survival,2023,Roguelike,"₩1,100",0%,1,0,1,55000,0,0,0,0
2735150,Tome Supreme,2024,Roguelike,"₩13,500",0%,1,0,1,675000,0,0,0,0
2584570,West of the Witchlands,2025,Roguelike,"₩5,600",0%,6,0,6,1680000,0,0,0,0
2176200,Now you are the persecuted,2022,Roguelike,Free,0%,7,1,8,0,0,0,0,0
2558690,Ultimate Challenge,2023,Roguelike,"₩2,670",0%,1,0,1,133500,0,0,0,0
1116190,Flutter Bombs,2019,Roguelike,"₩10,500",0%,3,0,3,1575000,0,0,0,0
2804020,Rogue Gladius Survivors,2024,Roguelike,"₩5,600",0%,10,0,10,2800000,0,0,0,0
843590,GhostGame,2019,Roguelike,"₩8,500",0%,28,0,28,11900000,0,0,0,0
2963370,Marble Madness,2024,Roguelike,"₩5,600",0%,1,0,1,280000,0,0,0,0
3463910,Snow • Fall,2025,Roguelike,Unknown,0%,0,0,0,0,0,0,0,0
1864830,Emblem of Valor,2025,Roguelike,"₩7,800",0%,13,1,14,5460000,0,0,0,0
1116190,Flutter Bombs,2019,Roguelike,"₩10,500",0%,3,0,3,1575000,0,0,0,0
1874500,Mori,2022,Roguelike,"₩2,200",0%,2,0,2,220000,0,0,0,0
843590,GhostGame,2019,Roguelike,"₩8,500",0%,28,0,28,11900000,0,0,0,0
2804020,Rogue Gladius Survivors,2024,Roguelike,"₩5,600",0%,10,0,10,2800000,0,0,0,0
2309470,Galactic Gladiators,2023,Roguelike,"₩2,300",0%,0,1,1,115000,0,0,0,0
3641990,Mahjong Expedition,2025,Roguelike,"₩9,900",0%,6,0,6,2970000,0,0,0,0
2458410,Hex Racer,2024,Roguelike,"₩3,400",0%,7,0,7,1190000,0,0,0,0
3146730,Wizard Survivors,2024,Roguelike,"₩5,600",0%,7,0,7,1960000,0,0,0,0
3747530,Orbital Arena,2025,Roguelike,"₩2,300",0%,0,0,0,0,0,0,0,0
3424190,The Golden Tile,2025,Roguelike,Unknown,0%,0,0,0,0,0,0,0,0
3747530,Orbital Arena,2025,Roguelike,"₩2,300",0%,0,0,0,0,0,0,0,0
2458410,Hex Racer,2024,Roguelike,"₩3,400",0%,7,0,7,1190000,0,0,0,0
1367110,Child of Abyss,2020,Roguelike,"₩3,300",0%,2,3,5,825000,0,0,0,0
2150460,Fisher's Qualm,2023,Roguelike,"₩3,400",0%,2,1,3,510000,0,0,0,0
2509130,Princess Chessboard,2024,Roguelike,"₩3,400",0%,5,1,6,1020000,0,0,0,0
2999750,Tehnodrom,2024,Roguelike,"₩5,600",0%,1,5,6,1680000,0,0,0,0
2718470,Gems Of Evolution,2025,Roguelike,"₩1,100",0%,6,2,8,440000,0,0,0,0
3422580,Forest Smasher,2025,Roguelike,"₩6,700",0%,24,1,25,8375000,0,0,0,0
3323300,Crazy Dungeon,2024,Roguelike,"₩1,100",0%,4,0,4,220000,0,0,0,0
3320370,Little Adventure Tale,2025,Roguelike,"₩8,600",0%,0,1,1,430000,0,0,0,0
2713640,Skirmish Squad,2024,Roguelike,"₩1,990",0%,8,0,8,796000,0,0,0,0
1896140,RoguePG,2022,Roguelike,"₩1,100",0%,4,1,5,275000,0,0,0,0
3381320,Cave Crusade,2025,Roguelike,"₩7,800",0%,0,0,0,0,0,0,0,0
3449040,Machick 2,2025,Roguelike,Unknown,0%,0,0,0,0,0,0,0,0
3381320,Cave Crusade,2025,Roguelike,"₩7,800",0%,0,0,0,0,0,0,0,0
3320370,Little Adventure Tale,2025,Roguelike,"₩8,600",0%,0,1,1,430000,0,0,0,0
2315460,Nightsteel Survivors,2023,Roguelike,"₩3,400",0%,1,2,3,510000,0,0,0,0
2438340,Elemental Odyssey,2023,Roguelike,"₩4,500",0%,4,0,4,900000,0,0,0,0
2949320,Ratatan,2025,Roguelike,Unknown,0%,0,0,0,0,0,0,0,0
2473340,Pinball Arena,2023,Roguelike,"₩2,300",0%,7,0,7,805000,0,0,0,0
2888580,Bone Meal,2024,Roguelike,"₩12,500",0%,1,0,1,625000,0,0,0,0
2901990,lone.AI,2025,Roguelike,"₩3,400",0%,0,0,0,0,0,0,0,0
3229240,Roll a Dice,2025,Roguelike,"₩5,600",0%,2,0,2,560000,0,0,0,0
2438340,Elemental Odyssey,2023,Roguelike,"₩4,500",0%,4,0,4,900000,0,0,0,0
2949320,Ratatan,2025,Roguelike,Unknown,0%,0,0,0,0,0,0,0,0
1757970,Oasis: Dark Forest,2021,Roguelike,"₩3,400",0%,9,2,11,1870000,0,0,0,0
3082630,Cat Clash,2024,Roguelike,"₩5,600",0%,0,0,0,0,0,0,0,0
3156110,Tribe of Werewolves,2025,Roguelike,"₩3,400",0%,3,1,4,680000,0,0,0,0
2626690,Scroll Survival,2023,Roguelike,"₩4,500",0%,3,0,3,675000,0,0,0,0
2473110,Odyssey Moon,2023,Roguelike,"₩5,600",0%,2,1,3,840000,0,0,0,0
2313260,The Fog,2023,Roguelike,Free,0%,0,0,0,0,0,0,0,0
1076940,Contract Work,2019,Roguelike,"₩5,500",0%,3,0,3,825000,0,0,0,0
2137680,RKR - Rush Kill Repeat,2022,Roguelike,"₩3,400",0%,2,0,2,340000,0,0,0,0
2730480,Under The Mask,2024,Roguelike,"₩5,600",0%,13,1,14,3920000,0,0,0,0
3891810,BrainRot Battle,2025,Roguelike,"₩8,900",0%,0,0,0,0,0,0,0,0
3144510,Dumb Witchfinder,2024,Roguelike,"₩56,000",0%,1,1,2,5600000,0,0,0,0
1880080,The Baleful Tower,2024,Roguelike,"₩10,500",0%,3,0,3,1575000,0,0,0,0
1493050,Forest Battle 森林战斗,2020,Roguelike,"₩3,300",0%,7,0,7,1155000,0,0,0,0
2152300,Litha and the Sunhouse,2024,Roguelike,"₩16,500",0%,6,2,8,6600000,0,0,0,0
3652330,The Attack on Egg Harbor,2025,Roguelike,"₩8,900",0%,0,0,0,0,0,0,0,0
2471350,Balloons,2023,Roguelike,"₩5,600",0%,1,0,1,280000,0,0,0,0
2797080,Mercenary Squad Auto Chess,2025,Roguelike,"₩6,700",0%,5,3,8,2680000,0,0,0,0
3652330,The Attack on Egg Harbor,2025,Roguelike,"₩8,900",0%,0,0,0,0,0,0,0,0
1829250,The Wizardz Dungeon,2022,Roguelike,"₩2,130",0%,1,0,1,106500,0,0,0,0
3301870,Hydra Hide Land,2025,Roguelike,"₩3,400",0%,3,0,3,510000,0,0,0,0
2794280,Deck Defense,2025,Roguelike,"₩11,000",0%,0,0,0,0,0,0,0,0
1839780,Cat Dimension,2022,Roguelike,"₩1,040",89%,3,0,3,156000,0,0,0,0
2276620,The Undead War,2023,Roguelike,"₩3,400",0%,0,3,3,510000,0,0,0,0
3383020,Ghostbreaker Corps,2025,Roguelike,"₩1,100",0%,6,0,6,330000,0,0,0,0
3636730,Seedovia,2025,Roguelike,Unknown,0%,0,0,0,0,0,0,0,0
1839780,Cat Dimension,2022,Roguelike,"₩1,040",89%,3,0,3,156000,0,0,0,0
652760,Watchlist,2017,Roguelike,"₩2,200",0%,11,2,13,1430000,0,0,0,0
2574550,Culinary Survivors,2023,Roguelike,"₩5,600",0%,3,0,3,840000,0,0,0,0
863970,Survive the Rift,2021,Roguelike,"₩13,500",0%,9,1,10,6750000,0,0,0,0
2239470,Void Blitzing,2023,Roguelike,"₩6,700",0%,2,0,2,670000,0,0,0,0
3304820,Vespia: Shield of Aberration,2025,Roguelike,"₩9,900",0%,0,0,0,0,0,0,0,0
2603590,Runemancer,2023,Roguelike,"₩2,300",0%,4,0,4,460000,0,0,0,0
2774300,BlockArena,2024,Roguelike,"₩4,500",0%,1,0,1,225000,0,0,0,0
669310,Brave Path,2017,Roguelike,"₩5,500",0%,9,1,10,2750000,0,0,0,0
3026000,Broken Space Traveler,2024,Roguelike,"₩5,600",0%,8,1,9,2520000,0,0,0,0
2444900,Walpurgis Raid,2023,Roguelike,"₩5,600",0%,10,0,10,2800000,0,0,0,0
3603820,Kwyjibo Adventure,2025,Roguelike,Free,0%,0,0,0,0,0,0,0,0
3746260,Dungeon CompAInions,2025,Roguelike,Free,0%,0,0,0,0,0,0,0,0
3552390,Kiwi's Adventure,2025,Roguelike,Free,0%,0,0,0,0,0,0,0,0
2239470,Void Blitzing,2023,Roguelike,"₩6,700",0%,2,0,2,670000,0,0,0,0
3304820,Vespia: Shield of Aberration,2025,Roguelike,"₩9,900",0%,0,0,0,0,0,0,0,0
1831290,与我签订契约，成为救世勇者吧！,2022,Roguelike,"₩4,400",0%,5,1,6,1320000,0,0,0,0
2774300,BlockArena,2024,Roguelike,"₩4,500",0%,1,0,1,225000,0,0,0,0
2517150,Vagneria,2024,Roguelike,"₩5,600",0%,10,5,15,4200000,0,0,0,0
669310,Brave Path,2017,Roguelike,"₩5,500",0%,9,1,10,2750000,0,0,0,0
2424040,MARONIA,2024,Roguelike,"₩1,100",0%,0,0,0,0,0,0,0,0
2010740,Roomli,2022,Roguelike,"₩3,400",0%,4,1,5,850000,0,0,0,0
590820,Pixel Stories of Dungeon,2018,Roguelike,"₩1,100",0%,9,3,12,660000,0,0,0,0
2792900,Roguelike Chess,2024,Roguelike,"₩2,300",0%,2,0,2,230000,0,0,0,0
3402160,Prisoners of Ulag'Bol: A Dungeon Crawling Deckbuilder,2025,Roguelike,"₩11,000",0%,3,0,3,1650000,0,0,0,0
1542010,Mariuccha Alchemy Queen,2021,Roguelike,Free,0%,5,0,5,0,0,0,0,0
2279180,Death Nomad,2024,Roguelike,"₩11,000",0%,7,3,10,5500000,0,0,0,0
2854030,Chicken Boy's Counterattack,2024,Roguelike,"₩3,400",0%,6,0,6,1020000,0,0,0,0
2710460,Berserk High,2025,Roguelike,"₩16,500",0%,1,0,1,825000,0,0,0,0
2400420,Land of the Survivors,2024,Roguelike,"₩3,400",0%,13,3,16,2720000,0,0,0,0
2941410,Truck,2024,Roguelike,"₩3,400",0%,2,0,2,340000,0,0,0,0
3152290,Echoes Of Spellcraft,2025,Roguelike,"₩15,500",0%,28,3,31,24025000,0,0,0,0
2427220,Tyrannical Chickens,2024,Roguelike,"₩1,100",0%,1,0,1,55000,0,0,0,0
2366240,Unsung Ballads,2024,Roguelike,"₩11,000",0%,1,0,1,550000,0,0,0,0
3091990,Rogue Rhythm,2025,Roguelike,"₩8,900",0%,3,0,3,1335000,0,0,0,0
2967790,Solitary Sentinel,2025,Roguelike,"₩7,800",0%,0,0,0,0,0,0,0,0
1410770,Five fold tower,2024,Roguelike,"₩5,600",0%,7,1,8,2240000,0,0,0,0
1308980,Dungeon Throne,2020,Roguelike,"₩4,400",0%,7,1,8,1760000,0,0,0,0
1544480,Book of the Old,2021,Roguelike,"₩10,500",0%,9,0,9,4725000,0,0,0,0
1626180,Squad Killer,2021,Roguelike,"₩5,500",0%,1,0,1,275000,0,0,0,0
3241680,云梦之音 The Melody of Yunmeng,2024,Roguelike,"₩3,400",0%,1,0,1,170000,0,0,0,0
2985410,UnderKingdom,2024,Roguelike,"₩3,400",0%,0,0,0,0,0,0,0,0
2906660,Conquer Lands,2025,Roguelike,Unknown,0%,0,0,0,0,0,0,0,0
2372450,Rootin' Tootin' Lootin' & Shootin',2024,Roguelike,"₩9,900",0%,5,0,5,2475000,0,0,0,0
2967790,Solitary Sentinel,2025,Roguelike,"₩7,800",0%,0,0,0,0,0,0,0,0
3152290,Echoes Of Spellcraft,2025,Roguelike,"₩15,500",0%,28,3,31,24025000,0,0,0,0
2268720,Mullet Hell,2023,Roguelike,"₩3,400",0%,7,1,8,1360000,0,0,0,0
2076730,Mud Way,2022,Roguelike,"₩1,100",0%,1,1,2,110000,0,0,0,0
3817830,Ominigun,2025,Roguelike,"₩2,300",0%,0,0,0,0,0,0,0,0
645200,Lethal Running,2022,Roguelike,"₩5,600",0%,11,5,16,4480000,0,0,0,0
1327370,Frag,2020,Roguelike,"₩6,500",0%,7,2,9,2925000,0,0,0,0
3206420,FUEL & FURY,2024,Roguelike,"₩11,000",0%,2,0,2,1100000,0,0,0,0
3817830,Ominigun,2025,Roguelike,"₩2,300",0%,0,0,0,0,0,0,0,0
1842300,Uncolored Bob II,2021,Roguelike,"₩3,300",0%,4,0,4,660000,0,0,0,0
2867890,So Many Zombies,2025,Roguelike,"₩11,000",0%,6,2,8,4400000,0,0,0,0
2397830,Hexa Puzzle Saga,2023,Roguelike,"₩1,100",0%,7,1,8,440000,0,0,0,0
1373450,Misplaced,2020,Roguelike,"₩6,500",0%,3,0,3,975000,0,0,0,0
1429260,Robot Rogue,2020,Roguelike,"₩1,100",0%,0,0,0,0,0,0,0,0
2801030,Recipiente,2024,Roguelike,"₩2,300",0%,0,0,0,0,0,0,0,0
3540510,loopmayor,2025,Roguelike,"₩3,400",0%,0,0,0,0,0,0,0,0
2677460,WarShip,2023,Roguelike,"₩2,300",0%,0,0,0,0,0,0,0,0
1425670,Shadow Eclipse,2024,Roguelike,"₩5,600",0%,7,0,7,1960000,0,0,0,0
2883490,Gladiatory,2024,Roguelike,"₩3,400",0%,0,2,2,340000,0,0,0,0
2883490,Gladiatory,2024,Roguelike,"₩3,400",0%,0,2,2,340000,0,0,0,0
2288470,Aethermancer,2025,Roguelike,Unknown,0%,0,0,0,0,0,0,0,0
2620610,Dungeons of Mysteria,2023,Roguelike,"₩6,700",0%,11,3,14,4690000,0,0,0,0
3219990,Nebula Strike,2025,Roguelike,"₩4,500",0%,0,0,0,0,0,0,0,0
3951010,UPGRADES & ENEMIES,2025,Roguelike,Unknown,0%,0,0,0,0,0,0,0,0
3951010,UPGRADES & ENEMIES,2025,Roguelike,Unknown,0%,0,0,0,0,0,0,0,0
3896030,Freelancers: Rogue Skies,2025,Roguelike,Unknown,0%,0,0,0,0,0,0,0,0
2078710,Mage Lords of Brams,2023,Roguelike,"₩5,600",0%,0,1,1,280000,0,0,0,0
2822640,CrabbleUp,2024,Roguelike,"₩11,000",0%,1,0,1,550000,0,0,0,0
1125370,Space Grunts 2,2020,Roguelike,"₩11,000",0%,5,1,6,3300000,0,0,0,0
1237900,Legion's Crawl 2,2020,Roguelike,"₩10,500",0%,4,1,5,2625000,0,0,0,0
1653860,Battle Rollers,2021,Roguelike,"₩5,600",0%,2,0,2,560000,0,0,0,0
1125370,Space Grunts 2,2020,Roguelike,"₩11,000",0%,5,1,6,3300000,0,0,0,0
2350880,FuryDough,2024,Roguelike,"₩2,300",0%,0,0,0,0,0,0,0,0
1181510,OS Omega: Retro Shooter,2020,Roguelike,"₩5,950",0%,4,2,6,1785000,0,0,0,0
2259360,C.I.E.B The Backrooms,2023,Roguelike,"₩11,000",0%,6,0,6,3300000,0,0,0,0
1237900,Legion's Crawl 2,2020,Roguelike,"₩10,500",0%,4,1,5,2625000,0,0,0,0
3569570,Project Dreamscape,2025,Roguelike,Free,0%,0,0,0,0,0,0,0,0
3215240,Probability Dungeon,2025,Roguelike,"₩11,000",0%,5,0,5,2750000,0,0,0,0
2569850,BlindSpell,2024,Roguelike,"₩2,300",0%,1,0,1,115000,0,0,0,0
2673170,深层宝藏 Deep Treasure,2024,Roguelike,"₩3,400",0%,1,0,1,170000,0,0,0,0
2350000,Space Hero: Intergalactic Titan,2025,Roguelike,"₩3,400",0%,4,1,5,850000,0,0,0,0
1677650,CubeCube,2021,Roguelike,"₩2,200",0%,6,1,7,770000,0,0,0,0
1670050,Washed Up,2021,Roguelike,"₩1,100",0%,0,0,0,0,0,0,0,0
2742500,Beetle Nest,2024,Roguelike,"₩16,500",0%,6,0,6,4950000,0,0,0,0
2584160,AlphaBit,2023,Roguelike,Unknown,0%,0,0,0,0,0,0,0,0
3712860,Wonder of Blue,2025,Roguelike,Unknown,0%,0,0,0,0,0,0,0,0
2412110,Rogue Labyrinth,2025,Roguelike,Unknown,0%,0,0,0,0,0,0,0,0
2650080,Idiots' Fantasy,2024,Roguelike,"₩10,380",0%,1,0,1,519000,0,0,0,0
2694960,Omnimancer,2024,Roguelike,"₩5,490",0%,0,0,0,0,0,0,0,0
3181240,Magic Overflow,2024,Roguelike,"₩4,500",0%,1,1,2,450000,0,0,0,0
1181510,OS Omega: Retro Shooter,2020,Roguelike,"₩5,950",0%,4,2,6,1785000,0,0,0,0
1677650,CubeCube,2021,Roguelike,"₩2,200",0%,6,1,7,770000,0,0,0,0
924020,Spellrune: Realm of Portals,2018,Roguelike,"₩10,500",0%,12,31,43,22575000,11,31,42,22050000
2584160,AlphaBit,2023,Roguelike,Unknown,0%,0,0,0,0,0,0,0,0
3712860,Wonder of Blue,2025,Roguelike,Unknown,0%,0,0,0,0,0,0,0,0
2412110,Rogue Labyrinth,2025,Roguelike,Unknown,0%,0,0,0,0,0,0,0,0
2468820,Cubic Survivor,2023,Roguelike,"₩2,300",0%,3,3,6,690000,0,0,0,0
2650080,Idiots' Fantasy,2024,Roguelike,"₩10,380",0%,1,0,1,519000,0,0,0,0
363510,STAR-BOX: RPG Adventures in Space,2015,Roguelike,"₩5,500",0%,43,43,86,23650000,16,32,48,13200000
3835010,Eternal Hunt,2025,Roguelike,"₩5,600",0%,0,0,0,0,0,0,0,0
1194490,Dethcube,2020,Roguelike,"₩4,400",0%,7,3,10,2200000,0,0,0,0
3835010,Eternal Hunt,2025,Roguelike,"₩5,600",0%,0,0,0,0,0,0,0,0
1957790,进击的僵尸,2022,Roguelike,"₩1,100",0%,0,0,0,0,0,0,0,0
1533650,Knight Throde,2021,Roguelike,"₩1,100",0%,7,1,8,440000,0,0,0,0
3414840,CardAttack-Gabee's Roads,2025,Roguelike,"₩19,500",0%,1,0,1,975000,0,0,0,0
2994940,STEM Defense,2024,Roguelike,"₩11,000",0%,1,0,1,550000,0,0,0,0
1258840,Stimuli,2020,Roguelike,"₩5,500",0%,6,1,7,1925000,0,0,0,0
2483630,God of Stickfights,2024,Roguelike,"₩5,600",0%,4,0,4,1120000,0,0,0,0
2391640,Binding of Elements,2024,Roguelike,"₩7,800",0%,10,1,11,4290000,0,0,0,0
3008020,Survivor Company,2024,Roguelike,"₩5,600",0%,0,1,1,280000,0,0,0,0
1993440,Times Dungeon,2024,Roguelike,"₩11,000",0%,0,2,2,1100000,0,0,0,0
2664970,Cube Survivor,2024,Roguelike,"₩4,500",0%,1,0,1,225000,0,0,0,0
2860420,Breaking Bound,2024,Roguelike,"₩1,100",0%,0,1,1,55000,0,0,0,0
2368570,Bomb Bomb Bomb,2023,Roguelike,"₩7,800",0%,0,0,0,0,0,0,0,0
2506020,The Last Windmill,2023,Roguelike,"₩3,400",0%,6,2,8,1360000,0,0,0,0
2959760,Crazy World of Caleb,2024,Roguelike,"₩2,300",0%,2,1,3,345000,0,0,0,0
2557640,Ronshade,2023,Roguelike,"₩1,100",0%,2,0,2,110000,0,0,0,0
3542650,Magic Typo,2025,Roguelike,"₩9,900",0%,0,0,0,0,0,0,0,0
3810920,Glazed Mirror : Myriad Cards,2025,Roguelike,"₩4,500",0%,0,0,0,0,0,0,0,0
3660140,Rush Rush Red Shoes,2025,Roguelike,"₩3,400",0%,0,0,0,0,0,0,0,0
1231270,Dead's Prison Watcher,2020,Roguelike,"₩2,200",0%,2,0,2,220000,0,0,0,0
3642430,Rogue Shapes,2025,Roguelike,"₩2,300",0%,0,0,0,0,0,0,0,0
1508860,Minforiga,2021,Roguelike,"₩5,500",0%,2,1,3,825000,0,0,0,0
1724670,明途之境,2021,Roguelike,"₩5,500",0%,2,0,2,550000,0,0,0,0
2119390,Discvivors,2022,Roguelike,"₩3,300",0%,4,0,4,660000,0,0,0,0
3195660,The Last Strand,2025,Roguelike,"₩16,420",0%,8,0,8,6568000,0,0,0,0
3553970,Dungeon Story,2025,Roguelike,"₩2,300",0%,4,1,5,575000,0,0,0,0
1231270,Dead's Prison Watcher,2020,Roguelike,"₩2,200",0%,2,0,2,220000,0,0,0,0
3105690,高温计划 Heat Plan,2024,Roguelike,"₩1,100",0%,1,0,1,55000,0,0,0,0
2607480,Two Moon : Space Rabbit,2023,Roguelike,"₩1,100",0%,1,0,1,55000,0,0,0,0
2076490,Endless Chaos: Hordes of the Afterlife,2022,Roguelike,"₩5,500",0%,1,2,3,825000,0,0,0,0
2671550,Spellz: Mastery or Death,2023,Roguelike,"₩14,500",0%,10,0,10,7250000,0,0,0,0
1576300,Dr Iwan: Evolution,2021,Roguelike,"₩7,500",0%,5,2,7,2625000,0,0,0,0
3311980,One of the Many,2025,Roguelike,"₩2,300",0%,0,0,0,0,0,0,0,0
2084260,Magefall,2022,Roguelike,"₩4,500",0%,1,0,1,225000,0,0,0,0
2879340,Bunny Roulette,2025,Roguelike,"₩4,500",0%,1,0,1,225000,0,0,0,0
3084740,Command Deck,2025,Roguelike,Unknown,0%,0,0,0,0,0,0,0,0
3872380,Tank Rectangle,2025,Roguelike,Free,0%,0,0,0,0,0,0,0,0
2916670,Neon Village,2025,Roguelike,Unknown,0%,0,0,0,0,0,0,0,0
1609170,Gunmancer,2021,Roguelike,"₩7,800",0%,5,0,5,1950000,0,0,0,0
3586740,Ellentis,2025,Roguelike,"₩15,500",0%,1,0,1,775000,0,0,0,0
1466400,Edge Of Dead: Under A Uranium Sky,2023,Roguelike,"₩12,500",0%,15,3,18,11250000,0,0,0,0
2263330,The Crimson Kingdom,2023,Roguelike,"₩5,600",0%,4,1,5,1400000,0,0,0,0
2227520,Hookscrap,2023,Roguelike,"₩1,100",0%,5,0,5,275000,0,0,0,0
3332000,Fallen Depths,2024,Roguelike,"₩5,600",0%,9,0,9,2520000,0,0,0,0
1021370,Slave RPG,2019,Roguelike,"₩5,600",0%,4,0,4,1120000,0,0,0,0
3347610,DreamBreaker,2025,Roguelike,"₩11,000",0%,0,0,0,0,0,0,0,0
2143660,Electron Flux,2023,Roguelike,"₩16,500",0%,2,0,2,1650000,0,0,0,0
3764530,Vulcard,2025,Roguelike,"₩13,500",0%,0,0,0,0,0,0,0,0
3204720,Veilwalkers,2025,Roguelike,"₩8,900",0%,0,0,0,0,0,0,0,0
2927520,Tower of Nod,2024,Roguelike,"₩5,600",0%,3,0,3,840000,0,0,0,0
2384230,MEATGUN,2023,Roguelike,"₩5,600",0%,3,0,3,840000,0,0,0,0
2124560,Jump Journey,2022,Roguelike,"₩1,100",0%,1,1,2,110000,0,0,0,0
2501400,Let's Fight!  Box,2023,Roguelike,"₩1,100",0%,1,0,1,55000,0,0,0,0
2393030,Solo Hunt,2023,Roguelike,"₩4,500",0%,0,2,2,450000,0,0,0,0
1988980,Boo! - The Mystery Story,2025,Roguelike,Unknown,0%,0,0,0,0,0,0,0,0
3217480,Waystones,2025,Roguelike,Unknown,0%,0,0,0,0,0,0,0,0
1031770,Воин Хинора,2019,Roguelike,"₩2,200",0%,9,2,11,1210000,0,0,0,0
1273940,Fight with love - deckbuilder datingsim,2021,Roguelike,"₩14,500",0%,4,7,11,7975000,0,0,0,0
1481630,Command Line Pilot,2021,Roguelike,"₩2,300",0%,14,0,14,1610000,0,0,0,0
1793680,The Holy Chalice,2022,Roguelike,"₩3,300",0%,3,0,3,495000,0,0,0,0
2122080,Last Second,2022,Roguelike,"₩3,300",0%,1,0,1,165000,0,0,0,0
3480760,Soda Splash,2025,Roguelike,Free,0%,0,0,0,0,0,0,0,0
2795760,Duck Dash,2024,Roguelike,"₩2,300",0%,2,1,3,345000,0,0,0,0
3194600,Disaster Blaster,2025,Roguelike,"₩10,790",0%,9,0,9,4855500,0,0,0,0
2913260,Holy Stone Mage,2024,Roguelike,"₩2,300",0%,2,2,4,460000,0,0,0,0
2081290,Battle Survival in Space,2023,Roguelike,"₩2,200",0%,1,0,1,110000,0,0,0,0
3805340,Realms Road,2025,Roguelike,Free,0%,0,0,0,0,0,0,0,0
2795760,Duck Dash,2024,Roguelike,"₩2,300",0%,2,1,3,345000,0,0,0,0
3194600,Disaster Blaster,2025,Roguelike,"₩10,790",0%,9,0,9,4855500,0,0,0,0
3082750,Dice Dice Dice,2024,Roguelike,"₩3,400",0%,1,0,1,170000,0,0,0,0
1335350,Kaapelipeli: The Cable Game,2020,Roguelike,Free,0%,5,1,6,0,0,0,0,0
2642070,Block Strategy,2024,Roguelike,"₩12,500",0%,2,2,4,2500000,0,0,0,0
3038840,Dark Hunter,2024,Roguelike,"₩4,500",0%,4,0,4,900000,0,0,0,0
1588500,Rogue Sweeper,2023,Roguelike,"₩6,700",0%,2,1,3,1005000,0,0,0,0
2605990,Tactics Below,2023,Roguelike,"₩14,500",0%,2,0,2,1450000,0,0,0,0
2258790,Activate: 激活,2023,Roguelike,"₩2,300",0%,3,1,4,460000,0,0,0,0
1331040,Card Apocalypse,2020,Roguelike,"₩5,500",0%,8,5,13,3575000,0,0,0,0
1985160,Principle of Karma,2023,Roguelike,"₩9,180",0%,3,0,3,1377000,0,0,0,0
477010,10 Minute Tower,2016,Roguelike,"₩17,400",0%,4,4,8,6960000,0,0,0,0
3082750,Dice Dice Dice,2024,Roguelike,"₩3,400",0%,1,0,1,170000,0,0,0,0
1827060,Tower of Ascension,2022,Roguelike,"₩2,200",0%,4,4,8,880000,0,0,0,0
3230230,Just Desserts,2024,Roguelike,"₩5,600",0%,2,0,2,560000,0,0,0,0
3919140,Sous Raccoon,2025,Roguelike,"₩9,900",9%,0,0,0,0,0,0,0,0
3773810,龙门Longmen,2025,Roguelike,"₩3,400",0%,0,0,0,0,0,0,0,0
2605990,Tactics Below,2023,Roguelike,"₩14,500",0%,2,0,2,1450000,0,0,0,0
3884500,TYPE,2025,Roguelike,Unknown,0%,0,0,0,0,0,0,0,0
3149250,Chicken Defense War - Tower Defense,2025,Roguelike,"₩6,700",0%,7,4,11,3685000,0,0,0,0
3773810,龙门Longmen,2025,Roguelike,"₩3,400",0%,0,0,0,0,0,0,0,0
3114090,League of Abyss,2024,Roguelike,"₩2,300",0%,0,0,0,0,0,0,0,0
477010,10 Minute Tower,2016,Roguelike,"₩17,400",0%,4,4,8,6960000,0,0,0,0
1008970,Cavyrn,2019,Roguelike,"₩5,500",0%,1,1,2,550000,0,0,0,0
854680,DeepLands,2020,Roguelike,"₩7,800",0%,4,2,6,2340000,0,0,0,0
1341120,Oops! Zombie Swarm,2024,Roguelike,"₩2,300",0%,5,0,5,575000,0,0,0,0
3856180,Harmonic Convergence,2025,Roguelike,Unknown,0%,0,0,0,0,0,0,0,0
3093400,Knightica,2025,Roguelike,Unknown,0%,0,0,0,0,0,0,0,0
3503990,Plumbum,2025,Roguelike,"₩11,000",0%,0,0,0,0,0,0,0,0
2118940,Wander Vyrosa,2023,Roguelike,Free,0%,3,1,4,0,0,0,0,0
2948870,Ant Attack,2024,Roguelike,"₩1,100",0%,4,2,6,330000,0,0,0,0
2050890,ZombWave,2022,Roguelike,"₩1,100",0%,0,0,0,0,0,0,0,0
1810460,Super Puzzle Cross,2023,Roguelike,"₩16,500",0%,8,0,8,6600000,0,0,0,0
2948870,Ant Attack,2024,Roguelike,"₩1,100",0%,4,2,6,330000,0,0,0,0
3100640,Hexeract,2024,Roguelike,"₩4,500",0%,4,2,6,1350000,0,0,0,0
2948020,1000 Seconds,2025,Roguelike,"₩3,400",0%,2,0,2,340000,0,0,0,0
2654290,Rogues of Europa,2023,Roguelike,"₩2,300",0%,1,0,1,115000,0,0,0,0
3503990,Plumbum,2025,Roguelike,"₩11,000",0%,0,0,0,0,0,0,0,0
3363240,かいがらの夢,2024,Roguelike,"₩4,290",0%,1,1,2,429000,0,0,0,0
2353840,A Storm Unsung,2024,Roguelike,"₩11,000",0%,2,0,2,1100000,0,0,0,0
3383290,Eternal Night Glory,2025,Roguelike,Free,0%,0,0,0,0,0,0,0,0
2959000,Shining Hero,2025,Roguelike,"₩3,400",0%,17,0,17,2890000,0,0,0,0
2127660,Zimmer,2022,Roguelike,"₩3,400",0%,7,1,8,1360000,0,0,0,0
1284430,Nazi Labs,2020,Roguelike,"₩3,300",0%,6,5,11,1815000,0,0,0,0
1933580,MindSweeper,2022,Roguelike,"₩10,500",0%,2,0,2,1050000,0,0,0,0
2778230,Labyrinthian Lockdown,2024,Roguelike,"₩4,500",0%,3,1,4,900000,0,0,0,0
3040150,Zenith Armada,2024,Roguelike,"₩8,900",0%,4,2,6,2670000,0,0,0,0
2324670,Police Heroes,2023,Roguelike,"₩3,400",0%,1,0,1,170000,0,0,0,0
1707410,Aspect,2022,Roguelike,"₩5,500",0%,8,0,8,2200000,0,0,0,0
1269540,Slash Roll,2020,Roguelike,"₩3,300",0%,6,2,8,1320000,0,0,0,0
522080,Gemstone Keeper,2017,Roguelike,"₩7,800",0%,7,5,12,4680000,0,0,0,0
2490300,Deep Nest,2023,Roguelike,"₩5,600",0%,4,1,5,1400000,0,0,0,0
1718340,极简地牢 Simple Killer,2022,Roguelike,"₩5,500",0%,13,0,13,3575000,0,0,0,0
3210160,16BitSurvivors,2025,Roguelike,"₩5,000",0%,4,1,5,1250000,0,0,0,0
606030,Meganoid,2017,Roguelike,"₩12,500",0%,9,5,14,8750000,0,0,0,0
3514760,meYOUw,2025,Roguelike,"₩2,300",0%,0,0,0,0,0,0,0,0
3144400,Gold's Dungeon,2025,Roguelike,"₩4,500",0%,7,1,8,1800000,0,0,0,0
3604960,Legacy of Shadows 影の遺産,2025,Roguelike,"₩9,900",0%,0,0,0,0,0,0,0,0
3210160,16BitSurvivors,2025,Roguelike,"₩5,000",0%,4,1,5,1250000,0,0,0,0
3059270,Sugar Rush,2024,Roguelike,"₩5,600",0%,4,0,4,1120000,0,0,0,0
3153760,Zombies & Survivors,2025,Roguelike,"₩2,300",0%,0,0,0,0,0,0,0,0
3539690,Bomb Around,2025,Roguelike,"₩5,600",0%,6,1,7,1960000,0,0,0,0
2108410,Attack on King VR: Reloaded,2023,Roguelike,"₩11,000",0%,7,0,7,3850000,0,0,0,0
3147240,SuperNovem,2024,Roguelike,"₩8,900",0%,1,1,2,890000,0,0,0,0
2746490,Chronicle Survivors,2024,Roguelike,"₩7,800",0%,3,8,11,4290000,0,0,0,0
2440550,Dungeon Rebound,2023,Roguelike,"₩1,100",0%,4,10,14,770000,0,0,0,0
1255680,Hand Cannon Virtuoso,2020,Roguelike,"₩17,500",0%,10,0,10,8750000,0,0,0,0
2340170,Melon Knight,2023,Roguelike,"₩5,600",0%,8,1,9,2520000,0,0,0,0
2734740,冒险小子 Adventure boy,2024,Roguelike,"₩3,400",0%,0,1,1,170000,0,0,0,0
2724140,SUS,2024,Roguelike,"₩1,100",0%,2,1,3,165000,0,0,0,0
2338040,Cards Survivors,2024,Roguelike,"₩11,000",0%,7,3,10,5500000,0,0,0,0
1255680,Hand Cannon Virtuoso,2020,Roguelike,"₩17,500",0%,10,0,10,8750000,0,0,0,0
2340170,Melon Knight,2023,Roguelike,"₩5,600",0%,8,1,9,2520000,0,0,0,0
2746490,Chronicle Survivors,2024,Roguelike,"₩7,800",0%,3,8,11,4290000,0,0,0,0
3280340,Ohjata,2025,Roguelike,"₩4,500",0%,4,0,4,900000,0,0,0,0
831950,Infinite Survival,2018,Roguelike,"₩4,400",0%,5,6,11,2420000,0,0,0,0
2746490,Chronicle Survivors,2024,Roguelike,"₩7,800",0%,3,8,11,4290000,0,0,0,0
3280340,Ohjata,2025,Roguelike,"₩4,500",0%,4,0,4,900000,0,0,0,0
831950,Infinite Survival,2018,Roguelike,"₩4,400",0%,5,6,11,2420000,0,0,0,0
1919920,眼球大師 Eyeball Master,2022,Roguelike,"₩2,200",0%,11,0,11,1210000,0,0,0,0
3837100,The CodFather,2025,Roguelike,Free,0%,0,0,0,0,0,0,0,0
3713260,Unity to survive,2025,Roguelike,Free,0%,0,0,0,0,0,0,0,0
2419870,Where is Mr Cloud,2023,Roguelike,"₩3,400",0%,2,4,6,1020000,0,0,0,0
1333420,Silenthead: Ducks hunt,2020,Roguelike,"₩13,500",0%,6,3,9,6075000,0,0,0,0
2796240,Hammer Knight,2024,Roguelike,"₩3,400",0%,1,1,2,340000,0,0,0,0
2863780,The Territory of Egg 2,2024,Roguelike,"₩5,600",0%,10,2,12,3360000,0,0,0,0
3244140,Zombie Survivors - Eternal Nightfall,2024,Roguelike,"₩1,100",0%,4,0,4,220000,0,0,0,0
1792170,Molecoole,2022,Roguelike,"₩4,500",0%,3,2,5,1125000,0,0,0,0
1792170,Molecoole,2022,Roguelike,"₩4,500",0%,3,2,5,1125000,0,0,0,0
1109170,Happy Grumps,2020,Roguelike,"₩11,000",0%,5,0,5,2750000,0,0,0,0
2472180,Gash,2023,Roguelike,Free,0%,5,2,7,0,0,0,0,0
2792660,Katana's Path,2024,Roguelike,"₩3,400",0%,9,0,9,1530000,0,0,0,0
2806840,Arcane Array Arena,2024,Roguelike,"₩2,300",0%,2,0,2,230000,0,0,0,0
3043960,Stop Them All,2024,Roguelike,"₩3,400",0%,0,0,0,0,0,0,0,0
3429050,Stellar Shapers,2025,Roguelike,"₩11,000",0%,0,0,0,0,0,0,0,0
1542820,Roguely,2021,Roguelike,"₩6,500",0%,6,0,6,1950000,0,0,0,0
2376450,Lighthouse Of The Souls (LOTS),2025,Roguelike,Unknown,0%,0,0,0,0,0,0,0,0
1363200,Wings Of Legends,2020,Roguelike,"₩10,500",0%,4,0,4,2100000,0,0,0,0
1378790,Red River,2025,Roguelike,"₩3,400",0%,0,0,0,0,0,0,0,0
2798340,County Courier,2024,Roguelike,"₩1,100",0%,1,1,2,110000,0,0,0,0
3101710,War of the Gods: Prologue,2024,Roguelike,Free,0%,0,0,0,0,0,0,0,0
2908840,Slime Mayhem,2024,Roguelike,Free,0%,3,5,8,0,0,0,0,0
1909260,Looping Bravery,2022,Roguelike,"₩2,520",55%,13,0,13,1638000,0,0,0,0
2702340,Bomber Festival,2025,Roguelike,"₩1,100",0%,10,0,10,550000,0,0,0,0
1848860,Ember Crusade IV,2022,Roguelike,"₩8,500",0%,4,1,5,2125000,0,0,0,0
2908840,Slime Mayhem,2024,Roguelike,Free,0%,3,5,8,0,0,0,0,0
2544500,Get Them Boats: Orca Revenge,2023,Roguelike,"₩1,100",0%,4,1,5,275000,0,0,0,0
2665030,Code Has Price,2024,Roguelike,"₩4,500",0%,6,2,8,1800000,0,0,0,0
1893890,Skedaddle Out The Dungeon,2022,Roguelike,Free,0%,3,2,5,0,0,0,0,0
3037940,Chaos Caster,2025,Roguelike,"₩5,300",0%,11,2,13,3445000,0,0,0,0
3061700,Bestion,2024,Roguelike,"₩2,300",0%,2,0,2,230000,0,0,0,0
3669050,Void Resurgence,2025,Roguelike,"₩2,720",19%,0,0,0,0,0,0,0,0
2999180,King's Subsidy,2025,Roguelike,Unknown,0%,0,0,0,0,0,0,0,0
3054470,Rogue Zodiacs,2025,Roguelike,"₩21,500",0%,6,0,6,6450000,0,0,0,0
3417340,The Rogue of Nexus,2025,Roguelike,"₩5,600",0%,1,0,1,280000,0,0,0,0
2702340,Bomber Festival,2025,Roguelike,"₩1,100",0%,10,0,10,550000,0,0,0,0
2367570,Slime mutation,2023,Roguelike,"₩1,100",0%,4,0,4,220000,0,0,0,0
1326220,Dynarog,2020,Roguelike,Free,0%,4,1,5,0,0,0,0,0
1245730,Chuck Meowrris,2020,Roguelike,Free,0%,5,0,5,0,0,0,0,0
2337230,Survivors of the Mare Vitalis,2023,Roguelike,"₩4,500",0%,9,1,10,2250000,0,0,0,0
3239570,Pix'Hard,2024,Roguelike,"₩5,600",0%,5,0,5,1400000,0,0,0,0
969340,The Dungeon Paradox,2025,Roguelike,"₩28,850",0%,4,0,4,5770000,0,0,0,0
2457280,Errships,2024,Roguelike,"₩11,000",0%,3,0,3,1650000,0,0,0,0
1948150,Moonphase Pass,2022,Roguelike,"₩8,500",0%,4,1,5,2125000,0,0,0,0
2999180,King's Subsidy,2025,Roguelike,Unknown,0%,0,0,0,0,0,0,0,0
2367570,Slime mutation,2023,Roguelike,"₩1,100",0%,4,0,4,220000,0,0,0,0
2058360,Turf Wars: A Snail Escape,2023,Roguelike,"₩6,700",0%,6,0,6,2010000,0,0,0,0
3669050,Void Resurgence,2025,Roguelike,"₩2,720",19%,0,0,0,0,0,0,0,0
3417340,The Rogue of Nexus,2025,Roguelike,"₩5,600",0%,1,0,1,280000,0,0,0,0
1326220,Dynarog,2020,Roguelike,Free,0%,4,1,5,0,0,0,0,0
1245730,Chuck Meowrris,2020,Roguelike,Free,0%,5,0,5,0,0,0,0,0
2802600,MOE MOE DAIUNDOUKAI,2024,Roguelike,"₩1,100",0%,1,1,2,110000,0,0,0,0
1948150,Moonphase Pass,2022,Roguelike,"₩8,500",0%,4,1,5,2125000,0,0,0,0
2208330,Last Knight,2022,Roguelike,"₩4,500",0%,0,0,0,0,0,0,0,0
969340,The Dungeon Paradox,2025,Roguelike,"₩28,850",0%,4,0,4,5770000,0,0,0,0
969340,The Dungeon Paradox,2025,Roguelike,"₩28,850",0%,4,0,4,5770000,0,0,0,0
2457280,Errships,2024,Roguelike,"₩11,000",0%,3,0,3,1650000,0,0,0,0
2370950,Zombie Exterminator,2023,Roguelike,"₩2,300",0%,3,2,5,575000,0,0,0,0
2264770,Spellsphere,2023,Roguelike,"₩1,100",0%,2,0,2,110000,0,0,0,0
3006990,Life of Kanji Island,2024,Roguelike,"₩13,620",0%,0,2,2,1362000,0,0,0,0
1371000,AnotherOne,2020,Roguelike,"₩3,300",0%,1,0,1,165000,0,0,0,0
1651260,Oftalmogarden,2021,Roguelike,"₩8,500",0%,3,0,3,1275000,0,0,0,0
2609150,Monsters and Spirits,2023,Roguelike,"₩1,100",0%,0,1,1,55000,0,0,0,0
2256160,Survive Now,2023,Roguelike,Free,0%,7,2,9,0,0,0,0,0
3376950,Rabolut: Escape From Hell,2025,Roguelike,Free,0%,1,0,1,0,0,0,0,0
2802600,MOE MOE DAIUNDOUKAI,2024,Roguelike,"₩1,100",0%,1,1,2,110000,0,0,0,0
689300,Monsteria,2017,Roguelike,"₩8,500",0%,5,0,5,2125000,0,0,0,0
689300,Monsteria,2017,Roguelike,"₩8,500",0%,5,0,5,2125000,0,0,0,0
1315940,Gravity Oddity,2023,Roguelike,"₩16,500",0%,5,0,5,4125000,0,0,0,0
1285410,World Of Mana,2023,Roguelike,"₩5,600",0%,1,0,1,280000,0,0,0,0
2409160,Treasure Mountain,2023,Roguelike,"₩4,500",0%,0,0,0,0,0,0,0,0
1418670,Fire survival,2024,Roguelike,"₩6,880",0%,3,4,7,2408000,0,0,0,0
2691420,Magic Labyrinth 3D,2023,Roguelike,"₩3,400",0%,0,0,0,0,0,0,0,0
2169250,Throw Wizard,2022,Roguelike,"₩1,100",0%,1,0,1,55000,0,0,0,0
2691420,Magic Labyrinth 3D,2023,Roguelike,"₩3,400",0%,0,0,0,0,0,0,0,0
1821530,Break Through The Illusion,2022,Roguelike,"₩1,100",0%,2,0,2,110000,0,0,0,0
2329160,Cards and Guns,2024,Roguelike,"₩7,800",0%,13,0,13,5070000,0,0,0,0
1505500,Fluffy Gore,2021,Roguelike,"₩2,300",0%,7,1,8,920000,0,0,0,0
2499730,幽灵小镇 Spooky Town,2023,Roguelike,"₩4,500",0%,1,0,1,225000,0,0,0,0
3013910,Limelight,2024,Roguelike,"₩2,300",0%,2,1,3,345000,0,0,0,0
1709660,Archie,2021,Roguelike,"₩2,200",0%,2,1,3,330000,0,0,0,0
3149810,BlowHI,2024,Roguelike,"₩8,900",0%,3,0,3,1335000,0,0,0,0
2112810,何必江湖 Why To JiangHu,2023,Roguelike,"₩4,500",0%,0,0,0,0,0,0,0,0
3170140,Piece Yourself Up,2024,Roguelike,Free,0%,0,0,0,0,0,0,0,0
3250760,Redshift,2024,Roguelike,"₩4,500",0%,1,0,1,225000,0,0,0,0
3037550,Grove Grown Guardians,2024,Roguelike,"₩5,600",0%,3,0,3,840000,0,0,0,0
3252940,Tradiecraft Tool Trials,2024,Roguelike,"₩6,700",0%,2,0,2,670000,0,0,0,0
949840,ICARUS84,2024,Roguelike,"₩15,500",0%,2,0,2,1550000,0,0,0,0
2946150,Skizz,2024,Roguelike,"₩3,400",0%,1,0,1,170000,0,0,0,0
3907500,Gran Theft Lure,2025,Roguelike,Unknown,0%,0,0,0,0,0,0,0,0
3863460,No Sweet Looks,2025,Roguelike,Unknown,0%,0,0,0,0,0,0,0,0
3885240,HEGGO,2025,Roguelike,Free,0%,0,0,0,0,0,0,0,0
949840,ICARUS84,2024,Roguelike,"₩15,500",0%,2,0,2,1550000,0,0,0,0
2946150,Skizz,2024,Roguelike,"₩3,400",0%,1,0,1,170000,0,0,0,0
3907500,Gran Theft Lure,2025,Roguelike,Unknown,0%,0,0,0,0,0,0,0,0
3863460,No Sweet Looks,2025,Roguelike,Unknown,0%,0,0,0,0,0,0,0,0
3885240,HEGGO,2025,Roguelike,Free,0%,0,0,0,0,0,0,0,0
2702030,Demons are coming!,2024,Roguelike,"₩5,600",0%,3,0,3,840000,0,0,0,0
3377900,Dice Clash World,2025,Roguelike,"₩11,000",0%,3,0,3,1650000,0,0,0,0
2163230,Witch Guild Survivor,2023,Roguelike,"₩4,500",0%,3,0,3,675000,0,0,0,0
3829300,Forest Rites,2025,Roguelike,Free,0%,0,0,0,0,0,0,0,0
1830100,Space Survival,2021,Roguelike,"₩5,500",0%,1,0,1,275000,0,0,0,0
2920950,Galandrix,2024,Roguelike,"₩1,100",0%,6,0,6,330000,0,0,0,0
3152900,Touhou Fantasy,2024,Roguelike,"₩4,500",0%,1,0,1,225000,0,0,0,0
3274940,Liar's Dice,2024,Roguelike,"₩3,400",0%,1,1,2,340000,0,0,0,0
1222840,Super Squash,2020,Roguelike,Free,0%,6,1,7,0,0,0,0,0
2567950,Gem Wizard,2023,Roguelike,"₩2,300",0%,4,1,5,575000,0,0,0,0
2344570,Mugen RPG,2025,Roguelike,"₩3,400",0%,0,0,0,0,0,0,0,0
2796980,Magic Card：CZ12,2024,Roguelike,"₩3,400",0%,0,0,0,0,0,0,0,0
2002720,CubeShooter,2022,Roguelike,"₩2,200",0%,7,2,9,990000,0,0,0,0
1830100,Space Survival,2021,Roguelike,"₩5,500",0%,1,0,1,275000,0,0,0,0
2920950,Galandrix,2024,Roguelike,"₩1,100",0%,6,0,6,330000,0,0,0,0
2567950,Gem Wizard,2023,Roguelike,"₩2,300",0%,4,1,5,575000,0,0,0,0
788200,The Little Slime,2018,Roguelike,"₩7,500",0%,4,2,6,2250000,0,0,0,0
2436350,18 Levels of Hells,2023,Roguelike,"₩9,900",0%,1,1,2,990000,0,0,0,0
2099910,Infinity Pinball,2022,Roguelike,"₩11,000",0%,4,3,7,3850000,0,0,0,0
3315670,Necro Blade,2024,Roguelike,Free,0%,0,0,0,0,0,0,0,0
3861590,A Hundred Years of Love and Death,2025,Roguelike,Free,0%,0,0,0,0,0,0,0,0
2918960,Feed The Gods,2024,Roguelike,"₩5,600",0%,4,0,4,1120000,0,0,0,0
2205550,Familegion,2025,Roguelike,"₩2,400",0%,4,0,4,480000,0,0,0,0
1646240,FukTopia 2,2022,Roguelike,"₩27,000",0%,1,2,3,4050000,0,0,0,0
3319270,Armada: Last Light,2025,Roguelike,"₩11,000",0%,2,2,4,2200000,0,0,0,0
2450950,天规天条 Rule,2023,Roguelike,"₩21,500",0%,0,0,0,0,0,0,0,0
958690,The Sky Climber,2018,Roguelike,"₩2,200",0%,8,2,10,1100000,0,0,0,0
3538850,Entropy Architects,2025,Roguelike,"₩8,900",0%,2,2,4,1780000,0,0,0,0
2842070,Rockhopper,2024,Roguelike,"₩3,400",0%,3,1,4,680000,0,0,0,0
3797300,Dicey Words,2025,Roguelike,"₩8,900",0%,0,0,0,0,0,0,0,0
3092440,TerraCube,2024,Roguelike,"₩2,300",0%,0,0,0,0,0,0,0,0
3682910,A game about cards,2025,Roguelike,Unknown,0%,0,0,0,0,0,0,0,0
1872870,United Assault - World War 2,2023,Roguelike,"₩16,500",0%,3,6,9,7425000,0,0,0,0
1527960,The Help Desk,2021,Roguelike,"₩3,400",0%,2,0,2,340000,0,0,0,0
2446170,Hero Trial,2023,Roguelike,"₩5,600",0%,5,0,5,1400000,0,0,0,0
1646240,FukTopia 2,2022,Roguelike,"₩27,000",0%,1,2,3,4050000,0,0,0,0
2842070,Rockhopper,2024,Roguelike,"₩3,400",0%,3,1,4,680000,0,0,0,0
3682910,A game about cards,2025,Roguelike,Unknown,0%,0,0,0,0,0,0,0,0
3634880,Western Death,2025,Roguelike,Unknown,0%,0,0,0,0,0,0,0,0
3538850,Entropy Architects,2025,Roguelike,"₩8,900",0%,2,2,4,1780000,0,0,0,0
2431210,No One's Escaped,2024,Roguelike,"₩3,400",0%,0,0,0,0,0,0,0,0
3135200,Legacy of Defense,2025,Roguelike,Unknown,0%,0,0,0,0,0,0,0,0
3797300,Dicey Words,2025,Roguelike,"₩8,900",0%,0,0,0,0,0,0,0,0
1872870,United Assault - World War 2,2023,Roguelike,"₩16,500",0%,3,6,9,7425000,0,0,0,0
2138930,Dodge The Missionaries,2022,Roguelike,Free,0%,5,1,6,0,0,0,0,0
2396830,Boxed Tower: Actual Tower Defense,2023,Roguelike,Free,0%,0,0,0,0,0,0,0,0
2733670,Meowhiss the snake,2024,Roguelike,"₩3,400",0%,5,0,5,850000,0,0,0,0
3634880,Western Death,2025,Roguelike,Unknown,0%,0,0,0,0,0,0,0,0
2852490,Hunting with Dad,2024,Roguelike,"₩2,300",0%,2,1,3,345000,0,0,0,0
3246080,Day Day Up,2024,Roguelike,"₩2,300",0%,0,0,0,0,0,0,0,0
1212960,Knight Dice,2020,Roguelike,"₩3,300",0%,8,4,12,1980000,0,0,0,0
2990670,Risk & Riches,2025,Roguelike,"₩8,800",19%,5,0,5,2200000,0,0,0,0
3554750,Reincarnation in Another World,2025,Roguelike,"₩6,700",0%,5,2,7,2345000,0,0,0,0
251590,Soul Saga,2020,Roguelike,"₩15,500",0%,12,37,49,37975000,12,24,36,27900000
3519780,Queen's Cards,2025,Roguelike,"₩6,700",0%,0,0,0,0,0,0,0,0
1569380,Triple Dungeon,2021,Roguelike,"₩5,500",0%,3,1,4,1100000,0,0,0,0
1884140,Dungeon Castle,2022,Roguelike,"₩1,100",0%,2,0,2,110000,0,0,0,0
3186420,Cannon Island,2024,Roguelike,"₩4,500",0%,3,0,3,675000,0,0,0,0
3530230,End Chess Arrow,2025,Roguelike,Free,0%,0,0,0,0,0,0,0,0
1389030,End Reach,2020,Roguelike,"₩4,400",0%,5,0,5,1100000,0,0,0,0
2101180,Underworld Re: Card,2022,Roguelike,"₩21,500",0%,3,5,8,8600000,0,0,0,0
2315990,孵化之地 wild eclosion,2023,Roguelike,"₩7,800",0%,3,3,6,2340000,0,0,0,0
2886100,Cubint,2024,Roguelike,"₩3,400",0%,2,0,2,340000,0,0,0,0
3554750,Reincarnation in Another World,2025,Roguelike,"₩6,700",0%,5,2,7,2345000,0,0,0,0
1480690,Pangea,2021,Roguelike,"₩7,500",0%,5,1,6,2250000,0,0,0,0
2266130,勇士末路 The End of Warriors,2023,Roguelike,"₩4,500",0%,10,0,10,2250000,0,0,0,0
2711190,Hyperspace Deck Command,2025,Roguelike,Unknown,0%,0,0,0,0,0,0,0,0
3135250,Deckception,2024,Roguelike,"₩5,600",0%,5,0,5,1400000,0,0,0,0
2526510,Ultimate Chump,2024,Roguelike,"₩1,150",50%,0,0,0,0,0,0,0,0
2682910,The Spellswapper,2023,Roguelike,"₩5,600",0%,4,0,4,1120000,0,0,0,0
1290480,KaveXplorer,2020,Roguelike,"₩3,300",0%,5,1,6,990000,0,0,0,0
2955600,Paranoid,2024,Roguelike,"₩5,600",0%,4,0,4,1120000,0,0,0,0
843990,Bullet Hell ADVANCED,2018,Roguelike,"₩99,780",0%,7,3,10,49890000,0,0,0,0
2343090,Porkotyler's Captain Dodger,2023,Roguelike,"₩5,600",0%,4,1,5,1400000,0,0,0,0
1896510,Nova Slash: Unparalleled Power,2022,Roguelike,"₩1,100",0%,4,2,6,330000,0,0,0,0
1066660,Are You A Wizard,2020,Roguelike,"₩10,500",0%,0,0,0,0,0,0,0,0
1884140,Dungeon Castle,2022,Roguelike,"₩1,100",0%,2,0,2,110000,0,0,0,0
3186420,Cannon Island,2024,Roguelike,"₩4,500",0%,3,0,3,675000,0,0,0,0
1909760,Hexa Td - Free Game,2024,Roguelike,Free,0%,6,0,6,0,0,0,0,0
901000,Serenade of the Sirens,2018,Roguelike,"₩5,500",0%,3,2,5,1375000,0,0,0,0
2682910,The Spellswapper,2023,Roguelike,"₩5,600",0%,4,0,4,1120000,0,0,0,0
3049380,Zaraq,2025,Roguelike,"₩8,900",0%,1,1,2,890000,0,0,0,0
1569240,Evolve Lab,2025,Roguelike,Unknown,0%,0,0,0,0,0,0,0,0
3470390,Cursor Survival,2025,Roguelike,"₩4,500",0%,1,0,1,225000,0,0,0,0
1757130,Pong Temple,2024,Roguelike,"₩3,400",0%,2,0,2,340000,0,0,0,0
2008350,Crush Them！,2022,Roguelike,"₩3,300",0%,6,0,6,990000,0,0,0,0
3048110,NOIRCOTICS,2024,Roguelike,"₩3,400",0%,1,0,1,170000,0,0,0,0
2729550,Scarred Mansion,2025,Roguelike,"₩11,000",0%,1,0,1,550000,0,0,0,0
2869330,Computer dungeon,2025,Roguelike,"₩2,300",0%,0,0,0,0,0,0,0,0
763320,Advanced Mechanized Spacecraft,2018,Roguelike,"₩13,500",0%,7,2,9,6075000,0,0,0,0
1983450,Brave Builder Construct A Climb,2022,Roguelike,"₩5,500",0%,1,0,1,275000,0,0,0,0
3566730,Naroike,2025,Roguelike,Unknown,0%,0,0,0,0,0,0,0,0
1757130,Pong Temple,2024,Roguelike,"₩3,400",0%,2,0,2,340000,0,0,0,0
2008350,Crush Them！,2022,Roguelike,"₩3,300",0%,6,0,6,990000,0,0,0,0
2158530,Aerial Platforms,2023,Roguelike,"₩4,500",0%,5,3,8,1800000,0,0,0,0
3048110,NOIRCOTICS,2024,Roguelike,"₩3,400",0%,1,0,1,170000,0,0,0,0
3049380,Zaraq,2025,Roguelike,"₩8,900",0%,1,1,2,890000,0,0,0,0
3911080,36 Zodiac Cycles,2025,Roguelike,Unknown,0%,0,0,0,0,0,0,0,0
3608390,Glow Journey,2025,Roguelike,"₩5,600",0%,4,0,4,1120000,0,0,0,0
3470390,Cursor Survival,2025,Roguelike,"₩4,500",0%,1,0,1,225000,0,0,0,0
3924180,Just Dig,2025,Roguelike,Unknown,0%,0,0,0,0,0,0,0,0
2482010,Waspkeeper,2023,Roguelike,"₩5,600",0%,6,1,7,1960000,0,0,0,0
1582280,Sleepy Sunday,2021,Roguelike,"₩8,500",0%,1,0,1,425000,0,0,0,0
2729550,Scarred Mansion,2025,Roguelike,"₩11,000",0%,1,0,1,550000,0,0,0,0
3252420,Launch And Loot,2024,Roguelike,"₩4,450",0%,12,0,12,2670000,0,0,0,0
2990580,Medieval Chaos,2024,Roguelike,"₩6,700",0%,0,1,1,335000,0,0,0,0
1909790,Cadleiu,2023,Roguelike,"₩7,800",0%,1,1,2,780000,0,0,0,0
2117020,Farm Wars: The Farmer´s Wrath,2022,Roguelike,"₩1,100",0%,0,1,1,55000,0,0,0,0
2310260,Super Smash Asteroids,2023,Roguelike,"₩5,600",0%,5,0,5,1400000,0,0,0,0
3490250,Chemical Combat,2025,Roguelike,Unknown,0%,0,0,0,0,0,0,0,0
2808860,Arcane Chaos,2024,Roguelike,"₩3,400",0%,0,1,1,170000,0,0,0,0
2990580,Medieval Chaos,2024,Roguelike,"₩6,700",0%,0,1,1,335000,0,0,0,0
1465060,Tetrogue Dragons,2020,Roguelike,"₩8,500",0%,2,0,2,850000,0,0,0,0
1846390,Einherjar,2022,Roguelike,Free,0%,6,0,6,0,0,0,0,0
2412780,Bounda Forever,2023,Roguelike,"₩2,300",0%,1,0,1,115000,0,0,0,0
2358060,Card Artisan,2025,Roguelike,Unknown,0%,0,0,0,0,0,0,0,0
2158530,Aerial Platforms,2023,Roguelike,"₩4,500",0%,5,3,8,1800000,0,0,0,0
3793910,Branch Collector,2025,Roguelike,"₩8,900",0%,0,0,0,0,0,0,0,0
3924180,Just Dig,2025,Roguelike,Unknown,0%,0,0,0,0,0,0,0,0
1582280,Sleepy Sunday,2021,Roguelike,"₩8,500",0%,1,0,1,425000,0,0,0,0
2054150,Tower Defender VR: Last Adventure,2022,Roguelike,"₩20,500",0%,11,1,12,12300000,0,0,0,0
3911080,36 Zodiac Cycles,2025,Roguelike,Unknown,0%,0,0,0,0,0,0,0,0
2990580,Medieval Chaos,2024,Roguelike,"₩6,700",0%,0,1,1,335000,0,0,0,0
416220,The Light Empire,2015,Roguelike,"₩6,500",0%,1,11,12,3900000,0,0,0,0
2123110,Space Bot,2022,Roguelike,"₩5,600",0%,7,1,8,2240000,0,0,0,0
2500460,Inventorix,2025,Roguelike,Unknown,0%,0,0,0,0,0,0,0,0
840830,Noonie,2018,Roguelike,"₩2,200",0%,2,0,2,220000,0,0,0,0
3453650,SlimeIsland,2025,Roguelike,"₩2,300",0%,1,0,1,115000,0,0,0,0
1727780,Arena Warrior,2024,Roguelike,"₩2,300",0%,1,0,1,115000,0,0,0,0
547000,Septic Savages,2016,Roguelike,"₩8,500",0%,4,1,5,2125000,0,0,0,0
2123110,Space Bot,2022,Roguelike,"₩5,600",0%,7,1,8,2240000,0,0,0,0
2560320,Little Mages,2023,Roguelike,"₩2,300",0%,2,0,2,230000,0,0,0,0
2089750,Super Spyroxo Adventures: Island of Dnfoo,2024,Roguelike,"₩14,500",0%,5,1,6,4350000,0,0,0,0
3793910,Branch Collector,2025,Roguelike,"₩8,900",0%,0,0,0,0,0,0,0,0
2799460,SUSHIDO,2024,Roguelike,"₩3,400",0%,3,0,3,510000,0,0,0,0
1253320,Seconds in Space,2020,Roguelike,"₩8,500",0%,1,0,1,425000,0,0,0,0
1492260,RECONNECT - The Heart of Darkness,2021,Roguelike,"₩15,500",0%,7,1,8,6200000,0,0,0,0
1973490,Level Tank,2024,Roguelike,"₩5,500",0%,3,2,5,1375000,0,0,0,0
3409570,Bricks Smasher,2025,Roguelike,"₩2,300",0%,5,1,6,690000,0,0,0,0
2583340,Hexarium,2025,Roguelike,"₩13,500",0%,3,0,3,2025000,0,0,0,0
3453650,SlimeIsland,2025,Roguelike,"₩2,300",0%,1,0,1,115000,0,0,0,0
2699580,Raven Fighter,2023,Roguelike,"₩11,000",0%,4,1,5,2750000,0,0,0,0
1159590,Lost In Dungeon,2019,Roguelike,"₩1,100",0%,2,6,8,440000,0,0,0,0
1321520,Monstaal,2020,Roguelike,"₩1,100",0%,0,0,0,0,0,0,0,0
1609800,Akinofa,2021,Roguelike,"₩5,500",0%,2,0,2,550000,0,0,0,0
1570680,"Slayers, Inc.",2021,Roguelike,"₩10,500",0%,5,0,5,2625000,0,0,0,0
2666020,Uncharted Lands: Beginning,2023,Roguelike,"₩7,800",0%,0,0,0,0,0,0,0,0
2583880,Unknown Dungeon,2024,Roguelike,"₩5,600",0%,0,1,1,280000,0,0,0,0
2878630,Etherrealm,2024,Roguelike,"₩5,600",0%,0,0,0,0,0,0,0,0
2878630,Etherrealm,2024,Roguelike,"₩5,600",0%,0,0,0,0,0,0,0,0
2319350,The Last Team 最后的小队,2023,Roguelike,"₩4,500",0%,1,1,2,450000,0,0,0,0
3240510,Calypso's Calamity,2024,Roguelike,"₩2,300",0%,1,0,1,115000,0,0,0,0
1881540,Escape The Living Nebula,2022,Roguelike,"₩3,300",0%,4,2,6,990000,0,0,0,0
1757250,Unreal Element World,2022,Roguelike,"₩6,500",0%,1,3,4,1300000,0,0,0,0
2245320,EX_Holics.exe,2023,Roguelike,"₩14,500",0%,2,0,2,1450000,0,0,0,0
3551330,ANIGMA Byte,2025,Roguelike,"₩1,100",0%,1,0,1,55000,0,0,0,0
3033820,Eternal Vampire,2024,Roguelike,"₩1,100",0%,5,0,5,275000,0,0,0,0
2317080,Asura's Trial,2023,Roguelike,"₩1,100",0%,4,1,5,275000,0,0,0,0
1475350,Breath,2020,Roguelike,"₩3,300",0%,10,0,10,1650000,0,0,0,0
2154000,TOKKI,2022,Roguelike,"₩1,100",0%,12,0,12,660000,0,0,0,0
3412910,CyberArena,2025,Roguelike,"₩11,000",0%,1,0,1,550000,0,0,0,0
600690,TROID BLASTER,2017,Roguelike,"₩1,100",0%,3,3,6,330000,0,0,0,0
600690,TROID BLASTER,2017,Roguelike,"₩1,100",0%,3,3,6,330000,0,0,0,0
1623060,Endless Heck,2021,Roguelike,"₩1,720",0%,1,0,1,86000,0,0,0,0
1893590,Cat Follow Me,2022,Roguelike,"₩1,100",0%,5,1,6,330000,0,0,0,0
1872060,World of Epicia,2022,Roguelike,"₩7,500",0%,0,0,0,0,0,0,0,0
3669940,Changgwi,2025,Roguelike,Free,0%,0,0,0,0,0,0,0,0
1071640,Open Ocean,2019,Roguelike,"₩1,430",35%,2,0,2,143000,0,0,0,0
1370680,Lucid Steam,2020,Roguelike,"₩18,500",0%,2,3,5,4625000,0,0,0,0
1878180,Space Warden,2023,Roguelike,"₩5,600",0%,4,0,4,1120000,0,0,0,0
1881210,The Masters: Survival,2022,Roguelike,"₩5,600",0%,0,0,0,0,0,0,0,0
3227600,Tanks of Chaos,2024,Roguelike,"₩2,300",0%,2,0,2,230000,0,0,0,0
2551660,Astral Rift,2024,Roguelike,"₩5,600",0%,7,2,9,2520000,0,0,0,0
2779010,War Job,2024,Roguelike,"₩5,600",0%,10,2,12,3360000,0,0,0,0
2058220,Artifacts of Eyru,2022,Roguelike,"₩3,400",0%,2,1,3,510000,0,0,0,0
3232250,MoveFort,2024,Roguelike,"₩3,400",0%,0,0,0,0,0,0,0,0
3352850,The NAKI Files,2025,Roguelike,Unknown,0%,0,0,0,0,0,0,0,0
1082200,ASTRO: The Beginning,2021,Roguelike,"₩10,500",0%,1,3,4,2100000,0,0,0,0
2993080,Survive In Ankara,2024,Roguelike,"₩5,600",0%,2,2,4,1120000,0,0,0,0
2621670,Swarmhunters,2023,Roguelike,"₩1,100",0%,1,1,2,110000,0,0,0,0
1678410,They All Come Back,2021,Roguelike,"₩2,300",0%,7,0,7,805000,0,0,0,0
3357860,Cannoneer,2024,Roguelike,"₩3,400",0%,3,0,3,510000,0,0,0,0
3012290,Predictile,2024,Roguelike,"₩5,600",0%,0,0,0,0,0,0,0,0
1755130,ELE RAMPAGE,2021,Roguelike,Free,0%,0,0,0,0,0,0,0,0
3012290,Predictile,2024,Roguelike,"₩5,600",0%,0,0,0,0,0,0,0,0
2621670,Swarmhunters,2023,Roguelike,"₩1,100",0%,1,1,2,110000,0,0,0,0
2364720,Cy: Cyberpunk Survivors,2025,Roguelike,"₩5,600",0%,9,1,10,2800000,0,0,0,0
1767590,TealGrounds,2021,Roguelike,"₩4,400",0%,2,0,2,440000,0,0,0,0
2959740,Catamyst,2024,Roguelike,"₩5,600",0%,4,0,4,1120000,0,0,0,0
1314600,The Rogue Cavern,2020,Roguelike,"₩2,200",0%,1,1,2,220000,0,0,0,0
620330,Scrapper,2018,Roguelike,"₩10,500",0%,4,1,5,2625000,0,0,0,0
2760670,牧场大作战(Ranch Battle),2024,Roguelike,"₩1,100",0%,0,0,0,0,0,0,0,0
2527750,Lost Oath,2023,Roguelike,"₩1,100",0%,9,0,9,495000,0,0,0,0
1499030,3D Double Dealing Character,2021,Roguelike,"₩15,500",0%,7,1,8,6200000,0,0,0,0
2712670,Axe Ghost,2025,Roguelike,"₩11,000",0%,0,0,0,0,0,0,0,0
2958670,NUNNA,2024,Roguelike,"₩1,100",0%,6,2,8,440000,0,0,0,0
1269510,UNDERZONE,2021,Roguelike,"₩20,500",0%,1,1,2,2050000,0,0,0,0
1657570,Tube Rolling,2021,Roguelike,"₩1,100",0%,0,0,0,0,0,0,0,0
2823630,Tech Disorder,2024,Roguelike,"₩1,100",0%,2,0,2,110000,0,0,0,0
2640170,Bockito,2023,Roguelike,"₩2,300",0%,4,0,4,460000,0,0,0,0
2533890,Conrad's Quest,2023,Roguelike,"₩2,300",0%,0,0,0,0,0,0,0,0
2823630,Tech Disorder,2024,Roguelike,"₩1,100",0%,2,0,2,110000,0,0,0,0
979880,Fast Food Fighters,2019,Roguelike,"₩15,500",0%,3,0,3,2325000,0,0,0,0
930470,Crimson Souls,2019,Roguelike,"₩13,500",0%,2,1,3,2025000,0,0,0,0
3430010,The Variant Void,2025,Roguelike,"₩6,700",0%,1,0,1,335000,0,0,0,0
2319300,Spiritoké,2024,Roguelike,"₩5,600",0%,2,1,3,840000,0,0,0,0
3243720,Cast Dice Away,2024,Roguelike,"₩3,400",0%,4,0,4,680000,0,0,0,0
3792060,Bushido Kensei The Last Warrior,2025,Roguelike,"₩7,800",0%,0,0,0,0,0,0,0,0
1232720,Ghosts 4 Everybody,2020,Roguelike,"₩14,500",0%,0,0,0,0,0,0,0,0
3430010,The Variant Void,2025,Roguelike,"₩6,700",0%,1,0,1,335000,0,0,0,0
3354080,EggsNeverHurt,2024,Roguelike,"₩1,100",0%,0,0,0,0,0,0,0,0
3193630,Super Destroyer,2024,Roguelike,"₩6,700",0%,0,0,0,0,0,0,0,0
1138630,Heroes Swipe Right,2020,Roguelike,"₩5,500",0%,4,2,6,1650000,0,0,0,0
3573920,Clutchtime™: Tournament Edition,2025,Roguelike,Free,0%,0,0,0,0,0,0,0,0
1138630,Heroes Swipe Right,2020,Roguelike,"₩5,500",0%,4,2,6,1650000,0,0,0,0
1694320,Nilia,2021,Roguelike,"₩5,500",0%,2,1,3,825000,0,0,0,0
2433850,Arcane Tower Survivors,2025,Roguelike,Unknown,0%,0,0,0,0,0,0,0,0
3255570,Cookie Survivors,2024,Roguelike,"₩2,300",0%,1,0,1,115000,0,0,0,0
1973840,Space Bees 太空蜜蜂,2022,Roguelike,"₩2,200",0%,8,2,10,1100000,0,0,0,0
1971830,Dragon Kings,2024,Roguelike,"₩5,600",0%,1,1,2,560000,0,0,0,0
2934400,Hexton,2024,Roguelike,"₩2,300",0%,5,0,5,575000,0,0,0,0
1188020,Sir Smedieval,2019,Roguelike,"₩5,500",0%,0,0,0,0,0,0,0,0
1190760,Tales of the Deck,2020,Roguelike,"₩10,500",0%,12,7,19,9975000,0,0,0,0
2318590,School Booster,2023,Roguelike,Free,0%,0,0,0,0,0,0,0,0
3634700,Moonlit Reaper,2025,Roguelike,"₩8,900",0%,4,0,4,1780000,0,0,0,0
1204860,REFUGE,2020,Roguelike,"₩15,500",0%,1,11,12,9300000,0,0,0,0
2716600,Mystic Labyrinth,2024,Roguelike,"₩3,400",0%,2,0,2,340000,0,0,0,0
2934400,Hexton,2024,Roguelike,"₩2,300",0%,5,0,5,575000,0,0,0,0
2568730,Void Climber,2025,Roguelike,"₩5,600",0%,13,1,14,3920000,0,0,0,0
3074830,Gladiato Potato,2024,Roguelike,"₩6,700",0%,8,1,9,3015000,0,0,0,0
3765730,The Backrooms: Reset,2025,Roguelike,Unknown,0%,0,0,0,0,0,0,0,0
3717620,Silverlake,2025,Roguelike,"₩8,900",0%,0,0,0,0,0,0,0,0
1886960,I HUMAN MACHINE,2022,Roguelike,"₩3,400",0%,1,0,1,170000,0,0,0,0
3717620,Silverlake,2025,Roguelike,"₩8,900",0%,0,0,0,0,0,0,0,0
2226990,Crab Digger,2022,Roguelike,"₩2,310",79%,15,3,18,2079000,0,0,0,0
1253760,Little Adventures,2020,Roguelike,"₩7,500",0%,3,0,3,1125000,0,0,0,0
3389220,Castle Bomber RED,2025,Roguelike,"₩2,300",0%,2,0,2,230000,0,0,0,0
1024690,Chaos Village,2019,Roguelike,"₩1,100",0%,3,4,7,385000,0,0,0,0
3192670,Downcave,2024,Roguelike,"₩3,400",0%,4,0,4,680000,0,0,0,0
2204870,How long can you survive,2023,Roguelike,Free,0%,3,1,4,0,0,0,0,0
3259190,Dead Dawg Delivery Co.,2024,Roguelike,"₩11,000",0%,0,4,4,2200000,0,0,0,0
1264010,9 Till Void,2020,Roguelike,"₩5,600",0%,9,0,9,2520000,0,0,0,0
660200,Transistor Defense,2025,Roguelike,"₩5,600",0%,0,0,0,0,0,0,0,0
3267500,Through the stars,2024,Roguelike,"₩13,500",0%,0,0,0,0,0,0,0,0
1089800,Axan Ships,2019,Roguelike,"₩11,500",0%,0,1,1,575000,0,0,0,0
2631650,Nif Nif,2025,Roguelike,"₩21,500",0%,33,2,35,37625000,0,0,0,0
2147260,Extermination Cars Stadium,2022,Roguelike,"₩1,100",0%,9,8,17,935000,0,0,0,0
572290,The Existence Abstract,2017,Roguelike,"₩1,100",0%,1,2,3,165000,0,0,0,0
1294630,Shape Storm,2020,Roguelike,Free,0%,8,1,9,0,0,0,0,0
1223260,Castle Torgeath Redux,2020,Roguelike,"₩11,000",0%,8,0,8,4400000,0,0,0,0
2663260,Alien Slayer,2024,Roguelike,"₩2,300",0%,0,0,0,0,0,0,0,0
2962290,Chained Runes,2024,Roguelike,"₩7,800",0%,6,0,6,2340000,0,0,0,0
3320880,Creepy Claus,2024,Roguelike,"₩5,600",0%,1,2,3,840000,0,0,0,0
1400920,Flood Fill,2020,Roguelike,"₩2,200",0%,3,0,3,330000,0,0,0,0
3317220,Weaveborn Heroes,2024,Roguelike,"₩3,400",0%,4,0,4,680000,0,0,0,0
2875300,The Echo Escape,2024,Roguelike,Free,0%,4,1,5,0,0,0,0,0
3162140,Void Stealer Bodycam Horror,2024,Roguelike,"₩9,900",0%,8,3,11,5445000,0,0,0,0
3006040,Asha Empire: Exodus,2024,Roguelike,"₩16,500",0%,0,0,0,0,0,0,0,0
3353180,Straight to the Bone,2024,Roguelike,"₩3,400",0%,9,1,10,1700000,0,0,0,0
2097550,Folktale,2022,Roguelike,"₩2,300",0%,7,1,8,920000,0,0,0,0
1060320,One Drop Bot,2019,Roguelike,"₩3,300",0%,90,329,419,69135000,0,0,0,0
3395850,Foepower,2025,Roguelike,"₩6,700",0%,6,3,9,3015000,0,0,0,0
3417780,Yokai Tales,2025,Roguelike,"₩6,700",0%,0,0,0,0,0,0,0,0
1203780,Tiamat's Drink,2020,Roguelike,"₩4,400",0%,10,0,10,2200000,0,0,0,0
3030860,Minesweeper 99,2024,Roguelike,"₩2,300",0%,8,0,8,920000,0,0,0,0
2391080,Zone VX,2023,Roguelike,"₩4,500",0%,2,0,2,450000,0,0,0,0
1528980,Pit of Ascension,2021,Roguelike,"₩3,300",0%,4,0,4,660000,0,0,0,0
3583660,Vampire Prison,2025,Roguelike,"₩6,700",0%,2,1,3,1005000,0,0,0,0
2214860,Look for connecting stars,2022,Roguelike,"₩6,800",0%,1,0,1,340000,0,0,0,0
1954010,Escape from Deathmark Dungeon,2022,Roguelike,Free,0%,4,1,5,0,0,0,0,0
542620,Lonelyland VR,2016,Roguelike,"₩16,000",0%,6,3,9,7200000,0,0,0,0
935350,Cat Fu Mi,2018,Roguelike,"₩3,300",0%,8,1,9,1485000,0,0,0,0
1602970,Gedel Escape,2022,Roguelike,"₩7,500",0%,1,0,1,375000,0,0,0,0
1816530,haunt,2021,Roguelike,"₩3,300",0%,3,5,8,1320000,0,0,0,0
2609800,The Hamster's Journey,2024,Roguelike,"₩9,900",0%,5,0,5,2475000,0,0,0,0
2542080,Shoot & Sow,2024,Roguelike,"₩5,600",0%,8,0,8,2240000,0,0,0,0
3567940,Banished Knight,2025,Roguelike,"₩1,100",0%,12,0,12,660000,0,0,0,0
3150150,Survivor Alliance,2024,Roguelike,"₩1,100",0%,2,2,4,220000,0,0,0,0
1750810,Wager,2021,Roguelike,"₩1,100",0%,3,1,4,220000,0,0,0,0
2009420,Zaxterion: Space Frenzy!,2022,Roguelike,"₩8,900",0%,8,2,10,4450000,0,0,0,0
2985470,Crown's Labyrinth,2024,Roguelike,"₩6,700",0%,0,0,0,0,0,0,0,0
3281140,Card Hero,2024,Roguelike,"₩8,900",0%,0,0,0,0,0,0,0,0
1672680,Kungfu Football Captain,2021,Roguelike,"₩3,300",0%,5,5,10,1650000,0,0,0,0
2918230,Scarecrow vs Big Butt Birds,2024,Roguelike,"₩1,100",0%,8,0,8,440000,0,0,0,0
2292280,Mabus 3000,2023,Roguelike,"₩4,500",0%,1,1,2,450000,0,0,0,0
3323960,Hyper Tunnel,2024,Roguelike,"₩11,000",0%,1,0,1,550000,0,0,0,0
3405220,Dungeonfell,2025,Roguelike,"₩13,500",0%,13,1,14,9450000,0,0,0,0
375810,The Forgettable Dungeon,2019,Roguelike,"₩20,500",0%,15,5,20,20500000,0,0,0,0
3606980,Modulea,2025,Roguelike,"₩3,400",0%,0,0,0,0,0,0,0,0
3606980,Modulea,2025,Roguelike,"₩3,400",0%,0,0,0,0,0,0,0,0
1241140,Return to Sender,2020,Roguelike,"₩6,500",0%,1,1,2,650000,0,0,0,0
2260260,Hack and Shoot Heroes,2023,Roguelike,"₩5,600",0%,1,8,9,2520000,0,0,0,0
1267670,Heartless reseller is Roguelike,2020,Roguelike,"₩1,100",0%,2,3,5,275000,0,0,0,0
3355060,Unknown Hero,2025,Roguelike,"₩5,600",0%,0,1,1,280000,0,0,0,0
1067050,Deep Dungeon: Gym,2019,Roguelike,"₩1,100",0%,9,3,12,660000,0,0,0,0
383020,a Family of Grave Diggers,2016,Roguelike,"₩10,500",0%,7,12,19,9975000,0,0,0,0
1673470,Finding A Prince: The Game,2021,Roguelike,"₩5,500",0%,7,1,8,2200000,0,0,0,0
2878230,Kill Me If You Can,2024,Roguelike,"₩4,500",0%,3,2,5,1125000,0,0,0,0
3674790,Russian Survivors,2025,Roguelike,Unknown,0%,0,0,0,0,0,0,0,0
2734250,King Must Survive,2024,Roguelike,"₩3,400",0%,4,5,9,1530000,0,0,0,0
2068220,Rampage Ball 2048,2022,Roguelike,Free,0%,5,4,9,0,0,0,0,0
221020,Towns,2012,Roguelike,"₩16,500",0%,746,2055,2801,2310825000,0,0,0,0
3169250,Escape From Vampire Castle: Miss Luna's Diary,2024,Roguelike,"₩6,700",0%,1,1,2,670000,0,0,0,0
3638420,Inspiral: Echoes of Gravity,2025,Roguelike,Unknown,0%,0,0,0,0,0,0,0,0
1726290,The Last Defense,2022,Roguelike,"₩4,500",0%,1,3,4,900000,0,0,0,0
2597340,The Alchemist's Apprentice in the Maze of Madness,2024,Roguelike,"₩8,900",0%,0,0,0,0,0,0,0,0
2463250,GAIA Survivors,2023,Roguelike,"₩3,400",0%,3,2,5,850000,0,0,0,0
1200090,Dimension of Dreams,2020,Roguelike,"₩15,500",0%,7,1,8,6200000,0,0,0,0
790030,Hexer,2021,Roguelike,"₩1,100",0%,1,0,1,55000,0,0,0,0
2515960,Validus mortis,2023,Roguelike,"₩7,800",0%,2,1,3,1170000,0,0,0,0
1059640,Deepsea Salvor,2024,Roguelike,Free,0%,8,0,8,0,0,0,0,0
1981370,Down the Drain,2022,Roguelike,"₩10,500",0%,6,1,7,3675000,0,0,0,0
1204330,"Fight,to the last",2022,Roguelike,"₩1,100",0%,12,2,14,770000,0,0,0,0
1304360,Dumb Roguelike-like RPG,2020,Roguelike,"₩1,100",0%,2,0,2,110000,0,0,0,0
2314530,Astraea,2024,Roguelike,"₩5,600",0%,5,1,6,1680000,0,0,0,0
1919220,Automoji,2023,Roguelike,"₩5,600",0%,6,0,6,1680000,0,0,0,0
1857220,OtterQuest,2022,Roguelike,"₩5,500",0%,5,0,5,1375000,0,0,0,0
2766830,Beast Park,2024,Roguelike,"₩4,500",0%,0,0,0,0,0,0,0,0
2226730,OVIS LOOP,2025,Roguelite,"₩14,800",19%,0,0,0,0,304,50,354,261960000
250900,The Binding of Isaac: Rebirth,2014,Roguelite,"₩15,500",0%,334165,9255,343420,266150500000,0,0,0,0
1721110,Abyssus,2025,Roguelite,"₩27,000",0%,0,0,0,0,1148,219,1367,1845450000
1868140,DAVE THE DIVER,2023,Roguelite,"₩24,000",0%,125422,3909,129331,155197200000,0,0,0,0
1145350,Hades II,2024,Roguelite,"₩32,000",0%,60844,3288,64132,102611200000,0,0,0,0
2379780,Balatro,2024,Roguelite,"₩16,500",0%,150524,3042,153566,126691950000,0,0,0,0
1217060,Gunfire Reborn,2021,Roguelite,"₩20,500",0%,92655,6517,99172,101651300000,0,0,0,0
2530470,Garden of Witches,2025,Roguelite,"₩17,600",19%,479,19,498,438240000,808,42,850,748000000
632360,Risk of Rain 2,2020,Roguelite,"₩26,000",0%,293127,20450,313577,407650100000,0,0,0,0
1145360,Hades,2020,Roguelite,"₩27,000",0%,274829,4912,279741,377650350000,0,0,0,0
2835570,Buckshot Roulette,2024,Roguelite,"₩3,400",0%,91745,3796,95541,16241970000,0,0,0,0
1794680,Vampire Survivors,2022,Roguelite,"₩5,000",0%,246479,3855,250334,62583500000,0,0,0,0
2525310,Drop Duchy,2025,Roguelite,"₩13,200",19%,1225,141,1366,901560000,1571,194,1765,1164900000
646570,Slay the Spire,2019,Roguelite,"₩27,000",0%,178250,4027,182277,246073950000,0,0,0,0
2071280,Ravenswatch,2024,Roguelite,"₩27,000",0%,12942,3211,16153,21806550000,0,0,0,0
568220,Lobotomy Corporation | Monster Management Simulation,2018,Roguelite,"₩26,000",0%,41213,2719,43932,57111600000,0,0,0,0
1147560,Skul: The Hero Slayer,2021,Roguelite,"₩20,500",0%,51218,3683,54901,56273525000,0,0,0,0
269210,Hero Siege,2014,Roguelite,"₩8,900",0%,29813,13699,43512,19362840000,0,0,0,0
262060,Darkest Dungeon®,2016,Roguelite,"₩27,000",0%,137026,12430,149456,201765600000,0,0,0,0
1286580,Ship of Fools,2022,Roguelite,"₩9,900",60%,4328,979,5307,2626965000,0,0,0,0
3028310,Nordhold,2025,Roguelite,"₩15,050",30%,1924,216,2140,1610350000,0,0,0,0
1948280,Stacklands,2022,Roguelite,"₩8,800",0%,0,0,0,0,0,0,0,0
2106670,Gatekeeper,2025,Roguelite,"₩16,500",0%,1409,244,1653,1363725000,0,0,0,0
2695940,PANICORE,2024,Roguelite,"₩5,600",0%,8491,2056,10547,2953160000,0,0,0,0
527230,For The King,2018,Roguelite,"₩20,500",0%,36581,4906,41487,42524175000,0,0,0,0
1557740,ROUNDS,2021,Roguelite,"₩6,400",0%,34893,1765,36658,11730560000,0,0,0,0
1911610,Windblown,2024,Roguelite,"₩27,000",0%,7610,843,8453,11411550000,0,0,0,0
2820820,Jotunnslayer: Hordes of Hel,2025,Roguelite,"₩16,500",0%,3274,693,3967,3272775000,0,0,0,0
3406850,Debugging Hero,2025,Roguelite,"₩9,900",9%,0,0,0,0,124,19,143,70785000
588650,Dead Cells,2018,Roguelite,"₩25,800",0%,163549,4915,168464,217318560000,0,0,0,0
692890,Roboquest,2023,Roguelite,"₩30,000",0%,20701,988,21689,32533500000,0,0,0,0
753420,Dungreed,2018,Roguelite,"₩10,500",0%,8672,621,9293,4878825000,0,0,0,0
1569580,Blue Prince,2025,Roguelite,"₩32,000",0%,7306,1096,8402,13443200000,0,0,0,0
1188930,Chrono Ark,2024,Roguelite,"₩27,000",0%,11075,1192,12267,16560450000,0,0,0,0
1280930,Astral Ascent,2023,Roguelite,"₩13,000",50%,6549,365,6914,4494100000,0,0,0,0
881100,Noita,2020,Roguelite,"₩20,500",0%,74759,3718,78477,80438925000,0,0,0,0
1473350,(the) Gnorp Apologue,2023,Roguelite,"₩7,500",0%,7849,294,8143,3053625000,0,0,0,0
1063420,Void Crew,2024,Roguelite,"₩29,000",0%,5922,791,6713,9733850000,0,0,0,0
1296830,暖雪 Warm Snow,2022,Roguelite,"₩18,500",0%,34444,2563,37007,34231475000,0,0,0,0
3201070,Gigantes Ex Machina,2025,Roguelite,"₩16,500",0%,0,0,0,0,82,19,101,83325000
3103780,DRAPLINE,2025,Roguelite,"₩11,000",0%,0,0,0,0,868,46,914,502700000
2103140,Magicraft,2024,Roguelite,"₩17,500",0%,12485,1048,13533,11841375000,0,0,0,0
1608290,GNOSIA,2022,Roguelite,"₩26,000",0%,2995,190,3185,4140500000,0,0,0,0
2780710,Asgard's Fall — Viking Survivors,2025,Roguelite,"₩7,800",0%,710,112,822,320580000,746,164,910,354900000
2002220,Keeper's Toll,2024,Roguelite,"₩7,800",0%,491,47,538,209820000,427,47,474,184860000
2273980,Orcs Must Die! Deathtrap,2025,Roguelite,"₩32,000",0%,2388,950,3338,5340800000,0,0,0,0
590380,Into the Breach,2018,Roguelite,"₩15,500",0%,19126,1090,20216,15667400000,0,0,0,0
200210,Realm of the Mad God Exalt,2012,Roguelite,Free,0%,38723,7897,46620,0,0,0,0,0
247080,Crypt of the NecroDancer,2015,Roguelite,"₩16,500",0%,24053,1063,25116,20720700000,0,0,0,0
311690,Enter the Gungeon,2016,Roguelite,"₩16,500",0%,81669,3893,85562,70588650000,0,0,0,0
1763250,SWORN,2025,Roguelite,"₩27,000",0%,2039,422,2461,3322350000,0,0,0,0
445980,Wizard of Legend,2018,Roguelite,"₩4,950",70%,18633,1887,20520,5078700000,0,0,0,0
3072640,Guidus Zero,2025,Roguelite,"₩13,200",19%,254,105,359,236940000,315,111,426,281160000
2564520,Lost in Random: The Eternal Die,2025,Roguelite,"₩21,600",19%,0,0,0,0,363,59,422,455760000
3109580,I Am Legion: Stand Survivors,2025,Roguelite,"₩9,000",0%,1331,255,1586,713700000,1372,281,1653,743850000
858820,Tribes of Midgard,2021,Roguelite,"₩21,000",0%,17197,5278,22475,23598750000,0,0,0,0
2803280,Dragon Is Dead,2025,Roguelite,"₩21,500",0%,279,63,342,367650000,444,133,577,620275000
2543510,GUNTOUCHABLES,2025,Roguelite,"₩5,600",0%,0,0,0,0,84,21,105,29400000
2206270,Vampire Hunters,2024,Roguelite,"₩9,900",40%,1375,144,1519,751905000,1315,146,1461,723195000
2423300,School Labyrinth,2024,Roguelite,"₩7,800",0%,580,117,697,271830000,540,110,650,253500000
2776450,Multiverse Loot Hunter,2025,Roguelite,"₩12,150",9%,1502,271,1773,1077097500,1648,338,1986,1206495000
1282730,Loop Hero,2021,Roguelite,"₩16,500",0%,32214,2445,34659,28593675000,0,0,0,0
2738490,Sol Cesto,2025,Roguelite,"₩13,500",0%,844,35,879,593325000,1587,101,1688,1139400000
1740720,Have a Nice Death,2023,Roguelite,"₩27,000",0%,8588,1351,9939,13417650000,0,0,0,0
677120,Heroes of Hammerwatch,2018,Roguelite,"₩3,370",75%,8061,1123,9184,1547504000,0,0,0,0
2445690,Lost Castle 2,2024,Roguelite,"₩16,500",0%,6425,1865,8290,6839250000,0,0,0,0
337320,Paint the Town Red,2021,Roguelite,"₩21,500",0%,28358,1218,29576,31794200000,0,0,0,0
2644610,Menace from the Deep,2024,Roguelite,"₩13,400",32%,1446,258,1704,1141680000,1498,285,1783,1194610000
2193540,Wizard of Legend 2,2025,Roguelite,"₩20,800",19%,859,446,1305,1357200000,959,694,1653,1719120000
992300,嗜血印 Bloody Spell,2022,Roguelite,"₩26,000",0%,31311,3806,35117,45652100000,0,0,0,0
2400160,Glyphica: Typing Survival,2024,Roguelite,"₩10,000",0%,1031,115,1146,573000000,1091,149,1240,620000000
1694420,Card Survival: Tropical Island,2022,Roguelite,"₩26,000",0%,2596,133,2729,3547700000,0,0,0,0
3353100,Passant: A Chess Roguelike,2025,Roguelite,"₩12,150",9%,0,0,0,0,121,26,147,89302500
763890,Wildermyth,2021,Roguelite,"₩26,000",0%,16587,904,17491,22738300000,0,0,0,0
960690,One Step From Eden,2020,Roguelite,"₩8,200",60%,6940,495,7435,3048350000,0,0,0,0
1296610,Peglin,2024,Roguelite,"₩21,500",0%,13369,2624,15993,17192475000,0,0,0,0
212680,FTL: Faster Than Light,2012,Roguelite,"₩10,500",0%,71561,3491,75052,39402300000,0,0,0,0
998740,Ring of Pain,2020,Roguelite,"₩6,150",70%,4398,407,4805,1477537500,0,0,0,0
3223160,Apocalypse Express,2025,Roguelite,"₩11,000",0%,0,0,0,0,0,0,0,0
656350,UnderMine,2020,Roguelite,"₩20,500",0%,8280,778,9058,9284450000,0,0,0,0
113200,The Binding of Isaac,2011,Roguelite,"₩5,500",0%,57299,3080,60379,16604225000,0,0,0,0
1140150,Touhou: Lost Branch of Legend,2022,Roguelite,"₩35,000",0%,1536,114,1650,2887500000,0,0,0,0
973230,We Who Are About To Die,2022,Roguelite,"₩24,000",0%,6500,874,7374,8848800000,0,0,0,0
2068280,Nordic Ashes: Survivors of Ragnarok,2024,Roguelite,"₩11,000",0%,5280,677,5957,3276350000,0,0,0,0
1404850,Luck be a Landlord,2023,Roguelite,"₩11,000",0%,9928,702,10630,5846500000,0,0,0,0
1076200,Roguebook,2021,Roguelite,"₩3,900",85%,3231,625,3856,751920000,0,0,0,0
323220,Vagante,2018,Roguelite,"₩16,000",0%,4319,521,4840,3872000000,0,0,0,0
1646790,Striving for Light,2025,Roguelite,"₩19,500",0%,86,18,104,101400000,109,35,144,140400000
3238670,Conquest Dark,2025,Roguelite,"₩11,000",0%,1465,115,1580,869000000,1700,189,1889,1038950000
2093910,Time Walker: Dark World,2023,Roguelite,"₩5,600",0%,1224,193,1417,396760000,1173,191,1364,381920000
1951230,Pizza Possum,2023,Roguelite,"₩3,510",55%,1624,112,1736,304668000,1380,104,1484,260442000
1425000,Endless Alice,2025,Roguelite,"₩8,000",0%,429,62,491,196400000,587,80,667,266800000
2746910,Three Kingdoms: The Blood Moon,2025,Roguelite,"₩9,900",0%,412,27,439,217305000,416,41,457,226215000
3141720,Monster Battles,2025,Roguelite,"₩11,000",0%,162,48,210,115500000,208,69,277,152350000
1915510,Yao-Guai Hunter,2025,Roguelite,"₩18,150",0%,1614,316,1930,1751475000,1520,311,1831,1661632500
2061150,Ikki Unite,2023,Roguelite,"₩6,750",50%,540,160,700,236250000,509,152,661,223087500
1253920,Rogue Legacy 2,2022,Roguelite,"₩27,000",0%,13143,1326,14469,19533150000,0,0,0,0
2464530,VOIN,2024,Roguelite,"₩19,500",0%,771,46,817,796575000,779,59,838,817050000
2531940,Stray Path,2025,Roguelite,"₩9,000",40%,536,184,720,324000000,492,191,683,307350000
2163330,Yet Another Zombie Survivors,2023,Roguelite,"₩16,500",0%,10169,1044,11213,9250725000,0,0,0,0
3011360,Primordialis,2025,Roguelite,"₩21,500",0%,0,0,0,0,232,15,247,265525000
2334170,Metal Bringer,2025,Roguelite,"₩21,500",0%,746,92,838,900850000,763,114,877,942775000
1043260,Gladiator Guild Manager,2024,Roguelite,"₩16,500",0%,2900,637,3537,2918025000,0,0,0,0
2934190,Aooni,2024,Roguelite,"₩11,000",0%,585,171,756,415800000,581,173,754,414700000
2936130,5 Minute Raid,2024,Roguelite,"₩4,900",0%,43,3,46,11270000,39,4,43,10535000
873940,Crying Suns,2019,Roguelite,"₩7,800",70%,3664,603,4267,1664130000,0,0,0,0
1286350,BPM: BULLETS PER MINUTE,2020,Roguelite,"₩21,500",0%,10091,1023,11114,11947550000,0,0,0,0
512900,Streets of Rogue,2019,Roguelite,"₩21,500",0%,21076,857,21933,23577975000,0,0,0,0
2111190,MULLET MADJACK,2024,Roguelite,"₩20,830",6%,7361,171,7532,7844578000,0,0,0,0
2608350,Snezhinka:Sentinel Girls2,2024,Roguelite,"₩8,500",0%,1946,67,2013,855525000,0,0,0,0
2459550,Emberward,2024,Roguelite,"₩16,500",0%,2609,76,2685,2215125000,0,0,0,0
2094910,Pile Up!,2025,Roguelite,"₩11,000",0%,631,157,788,433400000,603,190,793,436150000
2924580,Inkborn,2025,Roguelite,"₩21,500",0%,0,0,0,0,42,9,51,54825000
3470340,RogueCraft,2025,Roguelite,"₩11,000",0%,0,0,0,0,24,3,27,14850000
1955830,Touhou Hero of Ice Fairy,2024,Roguelite,"₩9,800",0%,6899,186,7085,3471650000,0,0,0,0
3047370,Net.Attack(),2025,Roguelite,"₩8,010",9%,0,0,0,0,134,29,163,65281500
2296550,Axon TD: Uprising - Tower Defense,2024,Roguelite,"₩21,500",0%,572,72,644,692300000,530,79,609,654675000
1108370,Ratropolis,2020,Roguelite,"₩18,500",0%,4759,629,5388,4983900000,0,0,0,0
1490610,METALLIC CHILD,2021,Roguelite,"₩15,300",40%,1032,177,1209,924885000,930,177,1107,846855000
1990110,SpellRogue,2025,Roguelite,"₩21,500",0%,1081,154,1235,1327625000,1150,187,1337,1437275000
1494810,Mortal Sin,2023,Roguelite,"₩27,000",0%,3313,148,3461,4672350000,0,0,0,0
2788310,Twilight Survivors,2024,Roguelite,"₩3,400",0%,806,90,896,152320000,825,102,927,157590000
3005620,Drop Pockets,2025,Roguelite,"₩16,500",0%,0,0,0,0,89,21,110,90750000
858210,Nova Drift,2024,Roguelite,"₩19,000",0%,13393,592,13985,13285750000,0,0,0,0
3158260,HSS:Reload,2024,Roguelite,"₩9,900",0%,144,46,190,94050000,125,44,169,83655000
1123770,Curse of the Dead Gods,2021,Roguelite,"₩22,800",0%,7207,1357,8564,9762960000,0,0,0,0
807120,Iratus: Lord of the Dead,2020,Roguelite,"₩34,000",0%,6694,1116,7810,13277000000,0,0,0,0
2760790,Another Farm Roguelike: Rebirth,2025,Roguelite,"₩7,800",0%,0,0,0,0,216,92,308,120120000
2078230,Badlands Crew,2025,Roguelite,"₩19,500",0%,690,149,839,818025000,730,160,890,867750000
2597080,Realm of Ink,2024,Roguelite,"₩18,500",0%,2653,201,2854,2639950000,0,0,0,0
1227280,Despot's Game: Dystopian Battle Simulator,2022,Roguelite,"₩22,000",0%,2689,497,3186,3504600000,0,0,0,0
3234700,Break Siege,2025,Roguelite,"₩16,500",0%,61,5,66,54450000,48,4,52,42900000
3054610,Artifact Seeker: Resurrection,2024,Roguelite,"₩11,000",0%,555,111,666,366300000,514,120,634,348700000
2321350,StormEdge,2024,Roguelite,"₩6,600",60%,129,40,169,55770000,97,42,139,45870000
1290750,Crawl Tactics,2022,Roguelite,"₩20,500",0%,133,9,142,145550000,130,11,141,144525000
1755830,Astrea: Six-Sided Oracles,2023,Roguelite,"₩27,000",0%,3793,336,4129,5574150000,0,0,0,0
2218400,Greedland,2023,Roguelite,"₩14,000",0%,2091,340,2431,1701700000,0,0,0,0
3040560,Elite Exorcist Miko,2024,Roguelite,"₩8,800",19%,59,4,63,27720000,66,4,70,30800000
1668690,Alina of the Arena,2022,Roguelite,"₩15,500",0%,3404,318,3722,2884550000,0,0,0,0
651670,Star Renegades,2020,Roguelite,"₩27,000",0%,2357,483,2840,3834000000,0,0,0,0
2889980,The Reeve,2024,Roguelite,"₩4,500",0%,37,3,40,9000000,37,3,40,9000000
296710,Monstrum,2015,Roguelite,"₩19,000",0%,3161,318,3479,3305050000,0,0,0,0
2088570,Tiny Rogues,2022,Roguelite,"₩10,500",0%,9445,310,9755,5121375000,0,0,0,0
1232580,Knock on the Coffin Lid,2024,Roguelite,"₩26,000",0%,2186,382,2568,3338400000,0,0,0,0
861540,Dicey Dungeons,2019,Roguelite,"₩16,500",0%,9953,1161,11114,9169050000,0,0,0,0
349730,Popup Dungeon,2020,Roguelite,"₩10,400",60%,772,248,1020,530400000,478,119,597,310440000
1125240,Ancient Dungeon,2021,Roguelite,"₩21,500",0%,1377,68,1445,1553375000,1321,70,1391,1495325000
2372950,Meteorfall: Rustbowl Rumble,2025,Roguelite,"₩16,500",0%,66,0,66,54450000,72,2,74,61050000
3324320,MYRIAD DEATH,2025,Roguelite,"₩7,920",19%,191,29,220,87120000,194,32,226,89496000
2797650,Pip My Dice,2025,Roguelite,"₩12,500",0%,0,0,0,0,67,4,71,44375000
3324320,MYRIAD DEATH,2025,Roguelite,"₩7,920",19%,191,29,220,87120000,194,32,226,89496000
528230,SYNTHETIK: Legion Rising,2018,Roguelite,"₩20,500",0%,11971,746,12717,13034925000,0,0,0,0
2501600,DICEOMANCER,2024,Roguelite,"₩16,500",0%,4567,129,4696,3874200000,0,0,0,0
2113040,RUNGORE,2024,Roguelite,"₩16,500",0%,793,96,889,733425000,733,109,842,694650000
1479140,AK-xolotl: Together,2023,Roguelite,"₩20,500",0%,660,191,851,872275000,668,235,903,925575000
1296660,Wartorn,2025,Roguelite,"₩32,000",0%,0,0,0,0,79,18,97,155200000
1761380,Otherworld Legends 战魂铭人,2024,Roguelite,Free,0%,802,485,1287,0,852,501,1353,0
2843640,Idle Colony,2024,Roguelite,"₩8,000",0%,301,68,369,147600000,319,75,394,157600000
242680,Nuclear Throne,2015,Roguelite,"₩12,500",0%,17279,700,17979,11236875000,0,0,0,0
3385370,Maze Mice,2025,Roguelite,"₩11,000",0%,67,2,69,37950000,199,22,221,121550000
3435260,Dice With Death,2025,Roguelite,"₩15,500",0%,101,9,110,85250000,276,27,303,234825000
757320,Atomicrops,2020,Roguelite,"₩16,500",0%,5218,442,5660,4669500000,0,0,0,0
3021630,Savara,2025,Roguelite,"₩21,500",0%,311,30,341,366575000,378,47,425,456875000
3191030,Nubby's Number Factory,2025,Roguelite,"₩5,600",0%,9206,227,9433,2641240000,0,0,0,0
2464880,Terracards,2023,Roguelite,"₩9,900",0%,595,101,696,344520000,586,103,689,341055000
3553210,Auto Rogue,2025,Roguelite,"₩7,800",0%,318,21,339,132210000,489,43,532,207480000
1148650,The Legend of Bum-Bo,2019,Roguelite,"₩16,500",0%,4695,1106,5801,4785825000,0,0,0,0
1589570,Dunjungle,2024,Roguelite,"₩12,800",0%,598,12,610,390400000,573,18,591,378240000
603960,Star of Providence,2017,Roguelite,"₩16,000",0%,2783,94,2877,2301600000,0,0,0,0
2881660,Holy Shoot,2025,Roguelite,"₩18,990",0%,0,0,0,0,60,12,72,68364000
1275890,Baldi's Basics Plus,2020,Roguelite,"₩10,500",0%,7265,172,7437,3904425000,0,0,0,0
456670,Hand of Fate 2,2017,Roguelite,"₩31,000",0%,4795,885,5680,8804000000,0,0,0,0
1842730,Nightmare: The Lunatic,2024,Roguelite,"₩18,500",0%,216,27,243,224775000,175,28,203,187775000
858260,Until You Fall,2020,Roguelite,"₩27,000",0%,3039,185,3224,4352400000,0,0,0,0
740080,Deadly Days,2019,Roguelite,"₩14,000",0%,1448,237,1685,1179500000,1059,172,1231,861700000
2499520,Be My Horde,2024,Roguelite,"₩5,000",0%,1026,135,1161,290250000,1186,193,1379,344750000
1543960,Squiggle Football,2025,Roguelite,"₩14,800",19%,0,0,0,0,70,2,72,53280000
769560,月圆之夜 (Night of Full Moon),2019,Roguelite,Free,0%,8648,1784,10432,0,0,0,0,0
2097230,Turnip Boy Robs a Bank,2024,Roguelite,"₩16,500",0%,1800,79,1879,1550175000,1601,84,1685,1390125000
1016600,Devil Slayer - Raksasi,2021,Roguelite,"₩15,500",0%,2397,424,2821,2186275000,0,0,0,0
1265820,Fights in Tight Spaces,2021,Roguelite,"₩26,000",0%,3020,285,3305,4296500000,0,0,0,0
1842320,Slayer : the Demon Haunted World,2025,Roguelite,"₩19,500",0%,21,3,24,23400000,10,3,13,12675000
2715370,Ancient Cultivatrix,2025,Roguelite,"₩15,340",0%,287,96,383,293761000,164,71,235,180245000
1040420,Dreamscaper,2021,Roguelite,"₩27,000",0%,2670,358,3028,4087800000,0,0,0,0
2853160,SHOOPER NOVA,2025,Roguelite,"₩7,000",0%,307,72,379,132650000,290,73,363,127050000
2726450,Windowkill,2024,Roguelite,"₩5,600",0%,2933,124,3057,855960000,0,0,0,0
798490,Othercide,2020,Roguelite,"₩34,800",0%,3966,853,4819,8385060000,0,0,0,0
688130,Pogostuck: Rage With Your Friends,2019,Roguelite,"₩7,500",0%,5105,998,6103,2288625000,0,0,0,0
2009860,Tower Escape,2023,Roguelite,"₩8,900",0%,322,68,390,173550000,283,58,341,151745000
2862890,Become the Moon,2025,Roguelite,"₩18,500",0%,0,0,0,0,109,32,141,130425000
3140120,Wordatro!,2025,Roguelite,"₩11,370",0%,0,0,0,0,197,38,235,133597500
1332340,DISORDER,2025,Roguelite,"₩28,320",19%,46,55,101,143016000,55,58,113,160008000
2917350,Spin Hero,2024,Roguelite,"₩8,900",0%,421,113,534,237630000,383,121,504,224280000
1199030,Tainted Grail: Conquest,2021,Roguelite,"₩20,500",0%,6875,726,7601,7791025000,0,0,0,0
1037020,ScourgeBringer,2020,Roguelite,"₩17,500",0%,2614,381,2995,2620625000,0,0,0,0
2099220,Mobmania,2025,Roguelite,"₩5,500",0%,329,45,374,102850000,303,49,352,96800000
2202010,Neon Ascending,2025,Roguelite,"₩3,370",25%,49,6,55,9267500,54,10,64,10784000
2226700,挂姬恶魔 IDLE DEVILS,2024,Roguelite,"₩4,500",0%,952,230,1182,265950000,918,229,1147,258075000
940710,Colt Canyon,2020,Roguelite,"₩16,500",0%,1497,195,1692,1395900000,1202,133,1335,1101375000
2129810,Reignbreaker,2025,Roguelite,"₩10,000",0%,253,47,300,150000000,243,68,311,155500000
1734320,Brutal Orchestra,2021,Roguelite,"₩20,500",0%,1764,36,1800,1845000000,1637,33,1670,1711750000
396750,EVERSPACE™,2017,Roguelite,"₩21,900",0%,8668,2352,11020,12066900000,0,0,0,0
1579880,The Light Brigade,2023,Roguelite,"₩27,000",0%,973,114,1087,1467450000,894,110,1004,1355400000
3205380,Omelet You Cook,2025,Roguelite,"₩11,000",0%,0,0,0,0,359,0,359,197450000
1824580,Dungeon Drafters,2023,Roguelite,"₩27,000",0%,531,176,707,954450000,399,126,525,708750000
317820,Guild of Dungeoneering Ultimate Edition,2015,Roguelite,"₩20,500",0%,1979,591,2570,2634250000,1304,412,1716,1758900000
2305500,FAIRY TAIL: DUNGEONS,2024,Roguelite,"₩15,500",0%,529,42,571,442525000,519,45,564,437100000
3064290,Trizon,2025,Roguelite,"₩9,900",0%,350,27,377,186615000,397,34,431,213345000
1454010,Diary of Lucie,2023,Roguelite,"₩14,500",0%,385,52,437,316825000,361,54,415,300875000
1135810,Vault of the Void,2022,Roguelite,"₩18,500",0%,2538,196,2734,2528950000,0,0,0,0
2336580,Mareld,2024,Roguelite,"₩7,800",0%,155,16,171,66690000,131,18,149,58110000
3879060,Instant Anastasia,2025,Roguelite,"₩6,700",0%,0,0,0,0,25,2,27,9045000
304650,SUNLESS SEA,2015,Roguelite,"₩20,000",0%,7715,1573,9288,9288000000,0,0,0,0
3315330,Big Winner,2025,Roguelite,"₩14,500",0%,0,0,0,0,391,74,465,337125000
718590,Dark Devotion,2019,Roguelite,"₩5,120",75%,1762,582,2344,600064000,1360,454,1814,464384000
1184760,Shovel Knight Pocket Dungeon,2021,Roguelite,"₩20,500",0%,460,45,505,517625000,435,43,478,489950000
2726870,Loopstructor,2024,Roguelite,"₩5,600",0%,291,57,348,97440000,255,60,315,88200000
1421290,Battle Shapers,2024,Roguelite,"₩27,000",0%,696,143,839,1132650000,650,152,802,1082700000
1807090,Wantless : Solace at World’s End,2024,Roguelite,"₩19,500",0%,226,27,253,246675000,225,31,256,249600000
1173200,Metal Unit,2021,Roguelite,"₩15,500",0%,2312,484,2796,2166900000,1610,378,1988,1540700000
615120,COMPOUND,2022,Roguelite,"₩21,000",0%,2013,63,2076,2179800000,0,0,0,0
525620,Octogeddon,2018,Roguelite,"₩9,490",0%,1048,93,1141,541404500,1030,90,1120,531440000
2435090,Talented,2024,Roguelite,"₩4,500",0%,1081,94,1175,264375000,1106,96,1202,270450000
1073320,Meteorfall: Krumit's Tale,2020,Roguelite,"₩15,500",0%,763,80,843,653325000,657,73,730,565750000
698640,Deep Sky Derelicts,2018,Roguelite,"₩3,220",85%,2027,688,2715,437115000,1378,509,1887,303807000
1870300,SOVL: Fantasy Warfare,2023,Roguelite,Free,0%,0,0,0,0,0,0,0,0
2332210,Born Again,2023,Roguelite,Free,0%,0,0,0,0,769,158,927,0
1803400,Beneath Oresa,2023,Roguelite,"₩27,000",0%,1116,321,1437,1939950000,783,221,1004,1355400000
2789810,Bingle Bingle,2024,Roguelite,"₩12,500",0%,379,67,446,278750000,368,75,443,276875000
787810,Rogue Heroes: Ruins of Tasos,2021,Roguelite,"₩20,500",0%,2708,746,3454,3540350000,0,0,0,0
2096510,The Ouroboros King,2023,Roguelite,"₩11,000",0%,372,75,447,245850000,329,67,396,217800000
2147530,Raining Blood: Hellfire,2025,Roguelite,"₩8,900",0%,92,5,97,43165000,141,9,150,66750000
3057190,LOOTPLOT,2025,Roguelite,"₩7,800",0%,60,2,62,24180000,126,7,133,51870000
1144910,Space Gladiators,2021,Roguelite,"₩15,500",0%,401,42,443,343325000,360,40,400,310000000
2827780,Summonsters,2024,Roguelite,"₩3,400",0%,129,42,171,29070000,133,42,175,29750000
3868720,Doomfields,2025,Roguelite,"₩16,500",0%,0,0,0,0,31,7,38,31350000
2598800,Psionic Sentry : Infinite,2025,Roguelite,"₩5,000",0%,124,14,138,34500000,139,17,156,39000000
770100,One Deck Dungeon,2018,Roguelite,"₩11,000",0%,665,158,823,452650000,594,139,733,403150000
790060,The Void Rains Upon Her Heart,2018,Roguelite,"₩13,500",0%,1645,13,1658,1119150000,1346,27,1373,926775000
1299620,Fabled Lands,2022,Roguelite,"₩8,200",60%,393,94,487,199670000,379,95,474,194340000
3777060,Gold Miner:Classic Edition,2025,Roguelite,"₩4,500",0%,0,0,0,0,124,24,148,33300000
274500,Brigador: Up-Armored Edition,2016,Roguelite,"₩25,000",0%,5127,335,5462,6827500000,0,0,0,0
322110,20XX,2017,Roguelite,"₩16,000",0%,4021,377,4398,3518400000,0,0,0,0
2523890,Whispers of the Eyeless,2025,Roguelite,"₩21,500",0%,96,15,111,119325000,84,20,104,111800000
1944570,Boneraiser Minions,2023,Roguelite,"₩5,600",0%,4941,185,5126,1435280000,0,0,0,0
2455060,Taboo Trial,2023,Roguelite,"₩16,000",0%,1368,252,1620,1296000000,1337,255,1592,1273600000
1812060,Yokai Art: Night Parade of One Hundred Demons,2022,Roguelite,"₩7,800",0%,963,101,1064,414960000,935,104,1039,405210000
732370,Juicy Realm,2018,Roguelite,"₩10,500",0%,3177,443,3620,1900500000,0,0,0,0
2518630,None Shall Intrude,2025,Roguelite,"₩9,500",0%,469,137,606,287850000,516,191,707,335825000
1911360,Trinity Fusion,2023,Roguelite,"₩21,500",0%,644,87,731,785825000,516,77,593,637475000
699920,Despotism 3k,2018,Roguelite,"₩8,500",0%,2862,817,3679,1563575000,783,184,967,410975000
3427090,Refence,2025,Roguelite,"₩6,700",0%,67,11,78,26130000,80,17,97,32495000
252610,Death Road to Canada,2016,Roguelite,"₩15,500",0%,8712,673,9385,7273375000,0,0,0,0
2800840,Gunbot Diplomacy,2025,Roguelite,"₩4,900",0%,121,17,138,33810000,123,18,141,34545000
381020,Sky Rogue,2017,Roguelite,"₩21,000",0%,1078,82,1160,1218000000,927,81,1008,1058400000
1054550,Phantom Rose,2019,Roguelite,"₩15,000",0%,666,188,854,640500000,600,179,779,584250000
2102320,MISTROGUE: Mist and the Living Dungeons,2023,Roguelite,"₩4,350",70%,142,63,205,44587500,120,64,184,40020000
1046300,Pirates Outlaws,2020,Roguelite,"₩21,000",0%,585,116,701,736050000,523,115,638,669900000
2929730,Cat Bait,2024,Roguelite,"₩5,600",0%,1019,24,1043,292040000,1056,33,1089,304920000
605450,In Death,2018,Roguelite,"₩31,000",0%,820,159,979,1517450000,759,155,914,1416700000
1260590,Hadean Tactics,2023,Roguelite,"₩21,500",0%,1574,182,1756,1887700000,1442,178,1620,1741500000
1347970,Patch Quest,2023,Roguelite,"₩17,000",0%,2479,168,2647,2249950000,1870,119,1989,1690650000
2536960,Shadowveil: Legend of The Five Rings,2025,Roguelite,"₩27,000",0%,301,95,396,534600000,304,101,405,546750000
537800,Bomber Crew,2017,Roguelite,"₩16,500",0%,12925,1812,14737,12158025000,0,0,0,0
1390700,The Crackpet Show,2022,Roguelite,"₩18,500",0%,673,89,762,704850000,560,84,644,595700000
2175450,Rhythm Stones,2022,Roguelite,"₩9,900",0%,19,6,25,12375000,19,6,25,12375000
3043760,HELLBREAK,2025,Roguelite,"₩16,500",0%,0,0,0,0,75,13,88,72600000
2514910,KKCKC,2024,Roguelite,"₩11,900",0%,28,2,30,17850000,13,1,14,8330000
1059980,Just King,2023,Roguelite,"₩5,600",0%,1310,139,1449,405720000,1203,134,1337,374360000
2082410,Anomaly Collapse,2024,Roguelite,"₩21,500",0%,501,84,585,628875000,456,80,536,576200000
2784620,ROGUE FLIGHT,2024,Roguelite,"₩21,500",0%,210,9,219,235425000,192,6,198,212850000
2881800,SuperTaxCity,2025,Roguelite,"₩11,000",0%,128,13,141,77550000,115,11,126,69300000
1367300,Blade Assault,2022,Roguelite,"₩19,000",0%,1680,558,2238,2126100000,1344,448,1792,1702400000
1606340,Conquest of Elysium 5,2021,Roguelite,"₩32,000",0%,955,110,1065,1704000000,947,117,1064,1702400000
249050,Dungeon of the ENDLESS™,2014,Roguelite,"₩13,000",0%,11749,1985,13734,8927100000,0,0,0,0
1710100,Bing in Wonderland,2023,Roguelite,"₩9,900",0%,2012,62,2074,1026630000,1906,59,1965,972675000
1929870,Nomad Survival,2022,Roguelite,"₩5,600",0%,1745,314,2059,576520000,1310,196,1506,421680000
915230,Zombie Rollerz: Pinball Heroes,2022,Roguelite,"₩17,000",0%,312,54,366,311100000,241,42,283,240550000
2118250,Kitchen Crisis,2024,Roguelite,"₩16,500",0%,240,76,316,260700000,229,76,305,251625000
1220010,Home Behind 2,2022,Roguelite,"₩20,500",0%,6072,892,6964,7138100000,0,0,0,0
1245540,Touhou Endless Dream,2021,Roguelite,"₩8,500",0%,1746,108,1854,787950000,1563,118,1681,714425000
3177970,Bioweaver,2024,Roguelite,"₩7,800",0%,487,122,609,237510000,480,135,615,239850000
2513240,Hero Tale,2024,Roguelite,"₩5,600",0%,255,105,360,100800000,257,116,373,104440000
3090570,Time for Bed,2025,Roguelite,"₩6,200",0%,0,0,0,0,43,1,44,13640000
2100150,Shadow of the Depth,2025,Roguelite,"₩16,500",0%,325,129,454,374550000,307,126,433,357225000
1641240,Hero's Quest,2023,Roguelite,"₩4,500",0%,164,32,196,44100000,145,32,177,39825000
3343940,Spin Forward,2025,Roguelite,"₩5,880",0%,0,0,0,0,20,3,23,6762000
268130,Heat Signature,2017,Roguelite,"₩16,000",0%,6756,390,7146,5716800000,0,0,0,0
2416050,Cento,2024,Roguelite,"₩11,000",0%,90,3,93,51150000,90,4,94,51700000
2332410,Hero of Fate,2023,Roguelite,"₩2,250",0%,433,103,536,60300000,373,99,472,53100000
248820,Risk of Rain (2013),2013,Roguelite,"₩10,500",0%,27648,1978,29626,15553650000,0,0,0,0
2074480,Sunset Routes,2022,Roguelite,"₩1,100",0%,474,21,495,27225000,457,24,481,26455000
2305900,GUNFIELD,2024,Roguelite,"₩5,600",0%,183,7,190,53200000,188,10,198,55440000
1709900,Tower Tactics: Liberation,2023,Roguelite,"₩13,500",0%,1007,119,1126,760050000,990,122,1112,750600000
2488510,FatalZone,2024,Roguelite,"₩7,800",0%,1531,695,2226,868140000,0,0,0,0
2113770,In Woods,2024,Roguelite,"₩7,800",0%,145,21,166,64740000,144,28,172,67080000
1815230,Summum Aeterna,2023,Roguelite,"₩21,500",0%,313,51,364,391300000,252,41,293,314975000
946610,Pocket Rogues,2018,Roguelite,"₩11,000",0%,433,54,487,267850000,418,52,470,258500000
595140,Immortal Redneck,2017,Roguelite,"₩21,000",0%,2880,315,3195,3354750000,0,0,0,0
2341760,Defensurvivor,2024,Roguelite,"₩12,500",0%,62,24,86,53750000,66,25,91,56875000
2424650,Froggy's Battle,2023,Roguelite,"₩2,300",0%,353,18,371,42665000,318,17,335,38525000
655380,Dig Dog,2018,Roguelite,₩900,80%,60,19,79,3555000,50,16,66,2970000
2644230,Critter Crossfire,2025,Roguelite,"₩16,500",0%,0,0,0,0,23,1,24,19800000
2251010,The Witch's Cauldron,2024,Roguelite,"₩8,900",0%,541,45,586,260770000,494,49,543,241635000
1037130,Dandy Ace,2021,Roguelite,"₩20,500",0%,1079,143,1222,1252550000,873,130,1003,1028075000
1493520,Beat Hazard 3,2024,Roguelite,"₩21,500",0%,511,96,607,652525000,446,79,525,564375000
1600910,Demon's Mirror,2024,Roguelite,"₩21,500",0%,83,12,95,102125000,69,11,80,86000000
437570,GoNNER,2016,Roguelite,"₩11,000",0%,1075,243,1318,724900000,820,156,976,536800000
841600,Aura of Worlds,2024,Roguelite,"₩16,500",0%,96,7,103,84975000,71,5,76,62700000
1865930,Space Prison,2024,Roguelite,"₩21,500",0%,182,30,212,227900000,179,34,213,228975000
2336590,White Night Dream,2023,Roguelite,"₩1,100",0%,212,25,237,13035000,207,26,233,12815000
1674890,👑 Idle Calibur 👑（选王之剑）,2022,Roguelite,"₩8,500",0%,1124,172,1296,550800000,1055,172,1227,521475000
1394130,Breach Wanderers,2023,Roguelite,"₩15,500",0%,353,43,396,306900000,311,42,353,273575000
314410,Rampage Knights,2015,Roguelite,"₩14,500",0%,3298,260,3558,2579550000,0,0,0,0
1334500,RP7: Spin Your Own Encounter,2024,Roguelite,"₩18,000",0%,74,14,88,79200000,38,14,52,46800000
2811200,Machick,2024,Roguelite,"₩5,000",0%,158,21,179,44750000,145,22,167,41750000
2220870,Fantasy Survivors,2024,Roguelite,"₩7,800",0%,178,23,201,78390000,171,25,196,76440000
1593350,Increlution,2021,Roguelite,"₩4,500",0%,983,159,1142,256950000,978,172,1150,258750000
598060,Slasher's Keep,2020,Roguelite,"₩14,500",0%,1791,355,2146,1555850000,1649,338,1987,1440575000
241600,Rogue Legacy,2013,Roguelite,"₩16,500",0%,17124,1353,18477,15243525000,0,0,0,0
2252960,Flashback,2023,Roguelite,"₩1,100",0%,356,53,409,22495000,345,56,401,22055000
2089830,Beat Slayer,2024,Roguelite,"₩12,900",40%,106,6,112,72240000,65,6,71,45795000
3008240,How We Die,2024,Roguelite,"₩15,500",0%,18,3,21,16275000,12,3,15,11625000
1766010,Force Reboot,2022,Roguelite,"₩3,400",0%,585,29,614,104380000,558,29,587,99790000
1359120,The Dungeon Beneath,2020,Roguelite,"₩16,500",0%,748,95,843,695475000,626,85,711,586575000
2552680,Rogue Samurai,2024,Roguelite,"₩5,600",0%,30,19,49,13720000,27,19,46,12880000
1365010,Lost Potato,2020,Roguelite,"₩3,400",0%,192,8,200,34000000,180,11,191,32470000
779590,Scavenger SV-4,2018,Roguelite,"₩7,750",50%,493,46,539,208862500,495,49,544,210800000
3449690,Malys,2025,Roguelite,"₩11,000",0%,0,0,0,0,74,0,74,40700000
1903560,Atomic Picnic,2024,Roguelite,"₩21,500",0%,345,132,477,512775000,279,119,398,427850000
3538820,Galactic Simulator2: Stargate,2025,Roguelite,"₩6,700",0%,0,0,0,0,12,3,15,5025000
2508890,Etaine: Magic Survivor / 伊泰恩：魔法幸存者,2024,Roguelite,"₩3,950",0%,204,25,229,45227500,178,27,205,40487500
3669690,Noir Lords,2025,Roguelite,"₩9,900",0%,0,0,0,0,15,0,15,7425000
2311990,Rack and Slay,2024,Roguelite,"₩6,700",0%,436,36,472,158120000,425,42,467,156445000
2597020,Coreless,2025,Roguelite,"₩8,900",0%,0,0,0,0,17,4,21,9345000
984110,SYNTHETIK: Arena,2019,Roguelite,Free,0%,2099,223,2322,0,0,0,0,0
1668290,Dungeons of Aether,2023,Roguelite,"₩16,500",0%,494,110,604,498300000,463,109,572,471900000
1938850,Temp Zero,2022,Roguelite,"₩2,750",50%,154,9,163,22412500,138,10,148,20350000
1491200,Few Nights More,2025,Roguelite,"₩9,500",0%,298,56,354,168150000,280,57,337,160075000
1660290,Monmusu Gladiator,2021,Roguelite,"₩5,600",0%,167,8,175,49000000,161,10,171,47880000
816720,Bugs Must Die / 异星特勤队,2019,Roguelite,"₩10,880",0%,129,11,140,76160000,65,11,76,41344000
2563800,The Last Game,2024,Roguelite,"₩7,800",0%,65,6,71,27690000,54,5,59,23010000
1245430,Golden Light,2022,Roguelite,"₩21,900",0%,2994,492,3486,3817170000,1737,172,1909,2090355000
994220,NEOVERSE,2020,Roguelite,"₩19,500",0%,3155,588,3743,3649425000,0,0,0,0
3292980,Hacky,2024,Roguelite,"₩5,600",0%,71,7,78,21840000,71,6,77,21560000
401710,Flinthook,2017,Roguelite,"₩6,400",60%,612,216,828,264960000,430,159,589,188480000
844850,Tower Hunter: Erza's Trial,2019,Roguelite,"₩18,500",0%,1330,500,1830,1692750000,1220,498,1718,1589150000
234390,Teleglitch: Die More Edition,2013,Roguelite,"₩15,000",0%,2434,435,2869,2151750000,869,118,987,740250000
2206240,Footgun: Underground,2024,Roguelite,"₩16,500",0%,101,13,114,94050000,81,13,94,77550000
1314770,Three Kingdom: The Journey,2023,Roguelite,"₩13,500",0%,189,33,222,149850000,156,32,188,126900000
2891120,Mad Smartphone Tycoon,2024,Roguelite,"₩13,500",0%,345,117,462,311850000,340,119,459,309825000
1914580,Spirit Hunters: Infinite Horde,2023,Roguelite,"₩8,900",0%,1234,330,1564,695980000,1184,334,1518,675510000
919370,Overdungeon,2019,Roguelite,"₩16,500",0%,2447,629,3076,2537700000,0,0,0,0
1304130,ReRoad,2024,Roguelite,"₩3,300",80%,99,28,127,20955000,74,24,98,16170000
1176710,Space Crew: Legendary Edition,2020,Roguelite,"₩16,500",0%,2192,723,2915,2404875000,1243,351,1594,1315050000
2191770,Gregory Horror Show: Soul of Roses,2024,Roguelite,"₩18,500",0%,116,1,117,108225000,53,0,53,49025000
2542140,Ketz: Galactic Overlords,2025,Roguelite,"₩9,000",0%,132,52,184,82800000,167,75,242,108900000
582330,Warriors: Rise to Glory,2022,Roguelite,"₩20,500",0%,750,191,941,964525000,656,185,841,862025000
1055990,Erannorth Reborn,2019,Roguelite,"₩19,500",0%,319,60,379,369525000,318,60,378,368550000
1929360,Tumbleweed Destiny,2022,Roguelite,"₩3,400",0%,360,18,378,64260000,325,17,342,58140000
2370380,异界之门 D-World Gate,2023,Roguelite,"₩3,400",0%,51,4,55,9350000,29,5,34,5780000
524640,Asura: Vengeance Edition,2017,Roguelite,"₩10,500",0%,585,101,686,360150000,469,83,552,289800000
1640630,Heading Out,2024,Roguelite,"₩22,000",0%,444,128,572,629200000,409,129,538,591800000
1184820,Poker Quest: Swords and Spades,2022,Roguelite,"₩16,500",0%,590,88,678,559350000,563,92,655,540375000
1079230,Himno - The Silent Melody,2021,Roguelite,"₩13,500",0%,270,62,332,224100000,220,52,272,183600000
493080,Card Quest,2017,Roguelite,"₩10,500",0%,307,51,358,187950000,275,41,316,165900000
2447120,Veiled Edge,2024,Roguelite,"₩13,200",19%,30,0,30,19800000,20,0,20,13200000
3031590,13F,2024,Roguelite,"₩4,500",0%,88,4,92,20700000,84,4,88,19800000
1727520,Yamafuda! 2nd station,2021,Roguelite,"₩13,500",0%,221,6,227,153225000,218,9,227,153225000
2516820,LuckLand,2023,Roguelite,"₩9,900",0%,423,22,445,220275000,390,21,411,203445000
2228010,Right and Down and Dice,2024,Roguelite,"₩13,500",0%,84,19,103,69525000,67,10,77,51975000
2571270,MicroSStep,2025,Roguelite,"₩6,900",0%,29,6,35,12075000,31,7,38,13110000
3156010,Minesweeper & Dungeon RPG - 扫雷与地下城,2024,Roguelite,"₩3,400",0%,20,4,24,4080000,21,5,26,4420000
1709050,Nitro Kid,2022,Roguelite,"₩21,500",0%,430,54,484,520300000,332,41,373,400975000
360740,Downwell,2015,Roguelite,"₩3,400",0%,7921,279,8200,1394000000,0,0,0,0
1709050,Nitro Kid,2022,Roguelite,"₩21,500",0%,430,54,484,520300000,332,41,373,400975000
1193590,Abomi Nation,2021,Roguelite,"₩4,120",75%,106,19,125,25750000,93,18,111,22866000
1397130,Primateria,2024,Roguelite,"₩13,500",0%,152,24,176,118800000,126,22,148,99900000
2697430,Dexterous: Time to Steal,2024,Roguelite,"₩11,000",0%,9,0,9,4950000,10,0,10,5500000
3097330,ReMix,2024,Roguelite,"₩6,700",0%,78,16,94,31490000,65,14,79,26465000
1138970,Dandy Dungeon - Legend of Brave Yamada -,2019,Roguelite,"₩19,500",0%,71,12,83,80925000,68,12,80,78000000
1374230,Flame Keeper,2024,Roguelite,"₩6,610",0%,101,34,135,44617500,43,19,62,20491000
574090,MOTHERGUNSHIP,2018,Roguelite,"₩28,000",0%,1185,372,1557,2179800000,823,232,1055,1477000000
3566580,Legendary Heroes Survivors,2025,Roguelite,"₩3,400",0%,19,0,19,3230000,20,1,21,3570000
2581750,W.A.N.D. Project,2024,Roguelite,"₩12,900",0%,141,50,191,123195000,98,48,146,94170000
685400,Skelly Selest,2018,Roguelite,"₩5,500",0%,265,17,282,77550000,244,16,260,71500000
2185180,Fantasy Madness: Bloodbath,2025,Roguelite,"₩7,800",0%,56,5,61,23790000,45,8,53,20670000
1717090,Into the Necrovale,2024,Roguelite,"₩16,500",0%,483,67,550,453750000,454,74,528,435600000
360740,Downwell,2015,Roguelite,"₩3,400",0%,7921,279,8200,1394000000,0,0,0,0
1677090,Godless,2024,Roguelite,"₩11,000",0%,86,8,94,51700000,68,8,76,41800000
2808270,Buckshot With Friends,2024,Roguelite,"₩4,500",0%,44,46,90,20250000,40,38,78,17550000
1902870,Vertical Kingdom,2024,Roguelite,"₩21,500",0%,106,23,129,138675000,82,26,108,116100000
2340510,Moon's Creed,2025,Roguelite,"₩13,500",0%,73,10,83,56025000,56,14,70,47250000
2332260,Feed the Deep,2024,Roguelite,"₩3,900",50%,403,42,445,86775000,391,43,434,84630000
442780,STRAFE: Gold Edition,2017,Roguelite,"₩16,500",0%,1744,663,2407,1985775000,1276,448,1724,1422300000
3050600,Exorcist: Reviewer of Minds,2024,Roguelite,"₩6,700",0%,51,1,52,17420000,49,1,50,16750000
3442280,Phantomancer,2025,Roguelite,"₩13,500",0%,80,4,84,56700000,79,8,87,58725000
1058430,A Legionary's Life,2019,Roguelite,"₩8,500",0%,2063,308,2371,1007675000,0,0,0,0
1160020,AshenForest,2020,Roguelite,"₩7,500",0%,188,8,196,73500000,177,9,186,69750000
2050590,Fhtagn Simulator,2022,Roguelite,"₩8,500",0%,474,50,524,222700000,444,55,499,212075000
250500,Super Amazing Wagon Adventure,2013,Roguelite,"₩3,400",0%,1836,90,1926,327420000,1560,82,1642,279140000
428750,Neon Chrome,2016,Roguelite,"₩16,500",0%,1055,100,1155,952875000,491,37,528,435600000
3057760,CROPS!,2024,Roguelite,"₩8,900",0%,180,22,202,89890000,173,24,197,87665000
2522160,Letter Lancers,2024,Roguelite,"₩9,900",0%,74,4,78,38610000,63,4,67,33165000
516110,ToeJam & Earl: Back in the Groove!,2019,Roguelite,"₩15,500",0%,961,130,1091,845525000,623,77,700,542500000
315840,Catacomb Kids,2015,Roguelite,"₩17,500",0%,544,67,611,534625000,453,68,521,455875000
1127610,Iris and the Giant,2020,Roguelite,"₩18,500",0%,1105,141,1246,1152550000,582,79,661,611425000
2795230,ODDRooM,2025,Roguelite,"₩16,500",0%,24,2,26,21450000,26,1,27,22275000
3144770,Ooze Keeper,2024,Roguelite,"₩7,800",0%,26,1,27,10530000,24,4,28,10920000
3145320,Elements and build,2024,Roguelite,"₩9,900",0%,157,40,197,97515000,126,47,173,85635000
1198400,Rhythm Fighter,2020,Roguelite,"₩15,500",0%,356,81,437,338675000,302,76,378,292950000
2342690,Call of Boba,2025,Roguelite,"₩14,500",0%,103,35,138,100050000,76,34,110,79750000
3640750,This is Interesting,2025,Roguelite,"₩7,800",0%,60,1,61,23790000,65,1,66,25740000
1323470,GetsuFumaDen: Undying Moon,2022,Roguelite,"₩26,500",0%,838,253,1091,1445575000,0,0,0,0
1098610,Crush the Industry,2025,Roguelite,"₩16,500",0%,233,17,250,206250000,210,18,228,188100000
531180,AIRHEART - Tales of broken Wings,2018,Roguelite,"₩15,900",0%,154,30,184,146280000,100,25,125,99375000
2704510,Simple CEO,2024,Roguelite,"₩3,150",30%,14,6,20,3150000,11,6,17,2677500
2666230,Dog And Goblin,2024,Roguelite,"₩8,900",0%,120,34,154,68530000,101,36,137,60965000
2569170,Widow in the Endless Labyrinth,2023,Roguelite,"₩16,500",0%,95,28,123,101475000,94,28,122,100650000
2648990,Nerd Survivors,2024,Roguelite,"₩2,240",60%,68,8,76,8512000,65,7,72,8064000
2995560,Wildkeepers Rising,2025,Roguelite,"₩11,000",0%,58,14,72,39600000,62,16,78,42900000
2404170,Museum No.9,2025,Roguelite,"₩11,000",0%,160,49,209,114950000,116,45,161,88550000
2510850,Slay the Minotaur,2024,Roguelite,"₩5,600",0%,171,11,182,50960000,167,14,181,50680000
2882930,GRUEL,2025,Roguelite,"₩11,000",0%,56,2,58,31900000,62,3,65,35750000
506870,Unexplored,2017,Roguelite,"₩10,500",0%,607,105,712,373800000,498,62,560,294000000
2097030,Union of Gnomes,2025,Roguelite,"₩16,500",0%,265,36,301,248325000,207,46,253,208725000
1389200,Cramped Room of Death,2023,Roguelite,"₩16,500",0%,59,3,62,51150000,57,3,60,49500000
1232100,BroodStar,2022,Roguelite,"₩11,500",0%,88,4,92,52900000,74,6,80,46000000
1608660,Overhaul,2022,Roguelite,"₩12,500",0%,78,7,85,53125000,71,7,78,48750000
2083240,Asterogues,2024,Roguelite,"₩16,000",0%,91,8,99,79200000,75,8,83,66400000
2061300,The Way Home: Pixel Roguelike,2022,Roguelite,"₩9,900",0%,55,6,61,30195000,50,5,55,27225000
1331340,Break the Loop,2024,Roguelite,"₩16,500",0%,68,11,79,65175000,42,9,51,42075000
1643180,Artist Life Simulator,2022,Roguelite,"₩20,500",0%,147,29,176,180400000,128,28,156,159900000
968760,Blood Card 2: Dark Mist,2021,Roguelite,"₩15,500",0%,245,39,284,220100000,230,41,271,210025000
403830,The Consuming Shadow,2015,Roguelite,"₩1,100",0%,378,20,398,21890000,286,18,304,16720000
630720,Mana Spark,2018,Roguelite,"₩12,500",0%,523,141,664,415000000,371,93,464,290000000
3389700,Spell Wizard,2025,Roguelite,"₩3,400",0%,0,0,0,0,14,0,14,2380000
265000,FORCED SHOWDOWN,2016,Roguelite,"₩21,000",0%,556,113,669,702450000,396,87,483,507150000
2992190,Blue Hunter,2025,Roguelite,"₩16,500",0%,30,3,33,27225000,21,3,24,19800000
1973320,Road Defense: Outsiders,2023,Roguelite,"₩3,300",0%,123,25,148,24420000,120,23,143,23595000
2354600,Renfield: Bring Your Own Blood,2023,Roguelite,"₩5,600",0%,654,168,822,230160000,544,154,698,195440000
3874490,Denrei Survivors,2025,Roguelite,"₩11,000",0%,0,0,0,0,21,0,21,11550000
252630,Eldritch,2013,Roguelite,"₩15,000",0%,1932,268,2200,1650000000,1482,202,1684,1263000000
1824130,Outside the Window,2022,Roguelite,"₩1,380",40%,51,5,56,3864000,45,5,50,3450000
1929250,Armechgeddon,2024,Roguelite,"₩8,900",0%,40,5,45,20025000,39,6,45,20025000
3666980,Diceball,2025,Roguelite,"₩11,000",0%,0,0,0,0,13,2,15,8250000
438320,Rush Rover,2017,Roguelite,"₩5,500",0%,208,14,222,61050000,174,15,189,51975000
1964330,Madcap Mosaic,2022,Roguelite,"₩7,500",0%,66,4,70,26250000,65,3,68,25500000
619280,Gloom,2017,Roguelite,"₩10,500",0%,498,99,597,313425000,426,87,513,269325000
1520680,Tetra Cube,2021,Roguelite,"₩7,500",0%,48,8,56,21000000,42,7,49,18375000
1256060,Cosmodread,2021,Roguelite,"₩15,500",0%,372,33,405,313875000,347,30,377,292175000
2374320,Heroes Of  Loot: Gauntlet Of Power,2024,Roguelite,"₩16,500",0%,57,8,65,53625000,57,7,64,52800000
2089980,Extremely Powerful Capybaras,2023,Roguelite,"₩6,700",0%,689,381,1070,358450000,529,338,867,290445000
2139440,The Wall Mustn't Fall,2023,Roguelite,"₩5,600",0%,60,4,64,17920000,54,4,58,16240000
930780,Blood Card,2019,Roguelite,"₩15,500",0%,575,133,708,548700000,520,130,650,503750000
555630,A Magical High School Girl / 魔法の女子高生,2016,Roguelite,"₩11,000",0%,149,51,200,110000000,113,28,141,77550000
2092850,Krzyżacy - The Knights of the Cross,2023,Roguelite,"₩17,500",0%,463,146,609,532875000,425,142,567,496125000
2491130,Split Square,2023,Roguelite,"₩5,600",0%,19,2,21,5880000,14,2,16,4480000
2122070,宝石少女/Girl & Gem Magic,2023,Roguelite,"₩2,300",0%,148,36,184,21160000,142,35,177,20355000
1129310,Receiver 2,2020,Roguelite,"₩21,500",0%,2483,243,2726,2930450000,0,0,0,0
2577850,Seekers of Eclipse,2025,Roguelite,"₩12,500",0%,5,1,6,3750000,16,2,18,11250000
588950,Kingsway,2017,Roguelite,"₩10,500",0%,1518,128,1646,864150000,1324,115,1439,755475000
1278210,Space Raiders in Space,2020,Roguelite,"₩10,500",0%,129,7,136,71400000,63,6,69,36225000
3471350,Alpha League HD,2025,Roguelite,Free,0%,0,0,0,0,800,99,899,0
1285060,Winter Falling: Battle Tactics,2022,Roguelite,"₩11,000",0%,379,33,412,226600000,372,32,404,222200000
2591360,Witch & Bun Cats,2025,Roguelite,"₩8,000",0%,0,0,0,0,43,11,54,21600000
943140,Sparklite,2019,Roguelite,"₩25,600",0%,480,133,613,784640000,327,98,425,544000000
3496500,Orb Tower,2025,Roguelite,"₩2,300",0%,122,5,127,14605000,141,7,148,17020000
2848740,OverRider,2024,Roguelite,"₩11,000",0%,44,7,51,28050000,27,6,33,18150000
1866880,Cultivation Story: Reincarnation,2023,Roguelite,"₩10,500",0%,1782,148,1930,1013250000,1763,153,1916,1005900000
751820,Black Future '88,2019,Roguelite,"₩21,500",0%,527,204,731,785825000,363,127,490,526750000
1016360,PERISH,2023,Roguelite,"₩21,500",0%,384,147,531,570825000,0,0,0,0
606230,Thea 2: The Shattering,2019,Roguelite,"₩26,000",0%,1707,484,2191,2848300000,1456,387,1843,2395900000
2884080,OMG Words,2025,Roguelite,"₩11,000",0%,61,10,71,39050000,55,11,66,36300000
2747820,Iconia Defenders,2024,Roguelite,"₩13,500",0%,17,2,19,12825000,9,2,11,7425000
751820,Black Future '88,2019,Roguelite,"₩21,500",0%,527,204,731,785825000,363,127,490,526750000
2280060,Tenebris: Terra Incognita,2024,Roguelite,"₩21,500",0%,156,16,172,184900000,140,19,159,170925000
2747820,Iconia Defenders,2024,Roguelite,"₩13,500",0%,17,2,19,12825000,9,2,11,7425000
2884080,OMG Words,2025,Roguelite,"₩11,000",0%,61,10,71,39050000,55,11,66,36300000
711810,Never Split the Party,2019,Roguelite,Free,0%,3326,1029,4355,0,0,0,0,0
559260,Wayward Souls,2019,Roguelite,"₩15,500",0%,164,56,220,170500000,136,41,177,137175000
249630,Delver,2018,Roguelite,"₩15,500",0%,2455,343,2798,2168450000,0,0,0,0
2323980,Dungeons & Jewels,2023,Roguelite,"₩5,600",0%,88,8,96,26880000,81,8,89,24920000
220460,Cargo Commander,2012,Roguelite,"₩5,600",0%,764,161,925,259000000,539,118,657,183960000
3095890,Mechanines Tower Defense,2024,Roguelite,"₩7,800",0%,35,1,36,14040000,32,1,33,12870000
3616450,Paws Against the World,2025,Roguelite,"₩8,000",0%,4,0,4,1600000,11,0,11,4400000
262790,Our Darker Purpose,2014,Roguelite,"₩16,000",0%,601,131,732,585600000,449,98,547,437600000
266110,Tower of Guns,2014,Roguelite,"₩17,000",0%,982,238,1220,1037000000,437,71,508,431800000
264160,WazHack,2014,Roguelite,"₩10,500",0%,632,74,706,370650000,498,68,566,297150000
339400,Runestone Keeper,2015,Roguelite,"₩10,500",0%,2071,379,2450,1286250000,564,124,688,361200000
640340,Serious Sam: Tormental,2022,Roguelite,"₩13,500",0%,185,57,242,163350000,137,43,180,121500000
1269710,Kainga: Seeds of Civilization,2022,Roguelite,"₩20,500",0%,582,154,736,754400000,474,150,624,639600000
722560,RAD,2019,Roguelite,"₩21,800",0%,694,240,934,1018060000,472,149,621,676890000
2225870,Before The Dawn,2024,Roguelite,"₩3,360",40%,42,4,46,7728000,29,2,31,5208000
2003050,Perseus: Titan Slayer,2023,Roguelite,"₩8,900",0%,221,118,339,150855000,202,119,321,142845000
3183640,Demon Hunters,2025,Roguelite,"₩7,800",0%,17,0,17,6630000,13,1,14,5460000
727130,Between the Stars,2024,Roguelite,"₩32,000",0%,1724,577,2301,3681600000,1401,443,1844,2950400000
3236280,Flocking Hell,2025,Roguelite,"₩8,800",19%,0,0,0,0,36,3,39,17160000
1048350,Nigate Tale,2024,Roguelite,"₩20,500",0%,628,291,919,941975000,440,207,647,663175000
1470390,City of Beats,2023,Roguelite,"₩21,500",0%,101,25,126,135450000,56,6,62,66650000
1048350,Nigate Tale,2024,Roguelite,"₩20,500",0%,628,291,919,941975000,440,207,647,663175000
1229460,Dice Legacy,2021,Roguelite,"₩15,200",0%,706,320,1026,779760000,588,290,878,667280000
2459180,Praise Dead,2023,Roguelite,"₩8,900",0%,77,21,98,43610000,74,19,93,41385000
1163740,Card Hog,2023,Roguelite,"₩6,700",0%,501,27,528,176880000,425,27,452,151420000
2727040,Blood Sins,2025,Roguelite,"₩15,500",0%,0,0,0,0,13,0,13,10075000
2449080,Dungeon No Dungeon: Tyrant's Endgame,2024,Roguelite,"₩3,950",0%,61,3,64,12640000,24,2,26,5135000
573780,Xenon Valkyrie,2017,Roguelite,"₩10,500",0%,84,45,129,67725000,76,44,120,63000000
1515640,Arcadegeddon,2023,Roguelite,Free,0%,543,187,730,0,592,208,800,0
1518220,Spells & Secrets,2023,Roguelite,"₩27,000",0%,219,54,273,368550000,170,51,221,298350000
2812610,Curtain Call,2024,Roguelite,"₩7,800",0%,133,19,152,59280000,112,20,132,51480000
3162110,Space Cycle,2024,Roguelite,"₩4,500",0%,193,12,205,46125000,179,14,193,43425000
295770,Rogue Shooter: The FPS Roguelike,2014,Roguelite,"₩5,500",0%,270,92,362,99550000,243,81,324,89100000
1667700,Geometry Arena 2,2023,Roguelite,"₩6,700",0%,324,38,362,121270000,276,38,314,105190000
1649630,Berserk Mode,2023,Roguelite,"₩8,500",0%,213,13,226,96050000,174,11,185,78625000
987210,Crossroads: Lucky Edition,2019,Roguelite,Free,0%,49,11,60,0,51,11,62,0
1638390,Indies' Lies,2023,Roguelite,"₩4,950",70%,578,177,755,186862500,477,159,636,157410000
1076230,OmniFootman,2019,Roguelite,"₩13,500",0%,103,19,122,82350000,90,19,109,73575000
326840,Heart&Slash,2016,Roguelite,"₩15,500",0%,500,118,618,478950000,404,95,499,386725000
924070,Arboria,2021,Roguelite,"₩14,340",0%,581,168,749,537033000,411,116,527,377859000
1196080,Space Simulation Toolkit,2020,Roguelite,"₩21,500",0%,294,75,369,396675000,288,81,369,396675000
2054770,Combo Card Clashers,2024,Roguelite,"₩13,500",0%,95,17,112,75600000,70,17,87,58725000
871420,Lovecraft's Untold Stories,2019,Roguelite,"₩16,500",0%,681,236,917,756525000,511,144,655,540375000
2365860,The Pair Annihilation,2024,Roguelite,"₩12,900",0%,23,1,24,15480000,23,1,24,15480000
297120,Heavy Bullets,2014,Roguelite,"₩11,000",0%,1251,279,1530,841500000,1010,222,1232,677600000
1934080,Floating Life2,2023,Roguelite,"₩20,500",0%,473,327,800,820000000,326,300,626,641650000
327880,Sublevel Zero Redux,2015,Roguelite,"₩16,000",0%,446,66,512,409600000,371,65,436,348800000
2127230,MOONPONG: Tales of Epic Lunacy,2022,Roguelite,"₩7,500",0%,55,3,58,21750000,43,3,46,17250000
1004370,Paper Cut Mansion,2022,Roguelite,"₩20,500",0%,50,21,71,72775000,32,20,52,53300000
701470,TTV2,2015,Roguelite,"₩1,100",0%,161,17,178,9790000,446,91,537,29535000
1267470,Warriors of the Nile,2020,Roguelite,"₩13,500",0%,1980,537,2517,1698975000,1867,526,2393,1615275000
515650,Straimium Immortaly,2016,Roguelite,"₩7,800",0%,152,15,167,65130000,137,15,152,59280000
2814760,Immortals Must Die,2024,Roguelite,"₩5,600",0%,14,3,17,4760000,12,3,15,4200000
575820,I Hate Running Backwards,2018,Roguelite,"₩16,500",0%,179,58,237,195525000,132,51,183,150975000
1235450,Treasure Drifter: Nian,2021,Roguelite,"₩1,800",60%,30,8,38,3420000,20,7,27,2430000
3033600,Rogue Rollout,2024,Roguelite,"₩13,500",0%,23,2,25,16875000,17,2,19,12825000
1016730,Deck of Ashes,2020,Roguelite,"₩21,500",0%,756,291,1047,1125525000,596,256,852,915900000
2659970,Lucky Mayor,2023,Roguelite,"₩7,800",0%,79,21,100,39000000,71,23,94,36660000
2452820,Skogdal,2025,Roguelite,"₩21,500",0%,52,2,54,58050000,58,2,60,64500000
1661920,Ancient: Legacy of Azul,2022,Roguelite,"₩5,600",0%,46,11,57,15960000,44,11,55,15400000
2188790,Unknown Pyramid,2023,Roguelite,"₩5,600",0%,21,1,22,6160000,20,1,21,5880000
704840,The Walking Vegetables,2017,Roguelite,"₩10,500",0%,169,18,187,98175000,85,11,96,50400000
704000,GUNHEAD,2023,Roguelite,"₩21,500",0%,146,43,189,203175000,97,43,140,150500000
467960,Home Behind,2016,Roguelite,"₩6,500",0%,5049,917,5966,1938950000,0,0,0,0
2100050,Spell Defender,2022,Roguelite,"₩3,300",0%,125,13,138,22770000,116,17,133,21945000
518650,illumine,2016,Roguelite,₩970,85%,64,10,74,3589000,54,5,59,2861500
2621150,Lizard Survivors: Battle for Hyperborea,2023,Roguelite,"₩1,100",0%,1150,191,1341,73755000,1061,173,1234,67870000
1842510,Mechanibot,2022,Roguelite,"₩3,300",0%,57,5,62,10230000,45,5,50,8250000
1698350,Full Metal Sergeant,2023,Roguelite,"₩11,000",0%,111,13,124,68200000,98,15,113,62150000
2427050,Munch,2024,Roguelite,"₩16,670",0%,68,31,99,82516500,53,32,85,70847500
3172400,Darkest Mine,2025,Roguelite,"₩5,600",0%,13,0,13,3640000,12,1,13,3640000
336940,Basingstoke,2018,Roguelite,"₩36,000",0%,277,122,399,718200000,194,48,242,435600000
2824730,Yawnoc,2024,Roguelite,"₩5,600",0%,56,0,56,15680000,55,1,56,15680000
1591690,DEATHRUN TV,2022,Roguelite,"₩15,500",0%,63,18,81,62775000,47,8,55,42625000
396640,TowerClimb,2015,Roguelite,"₩16,000",0%,353,32,385,308000000,266,33,299,239200000
1094590,Helvetii,2023,Roguelite,"₩16,500",0%,44,3,47,38775000,27,2,29,23925000
1902300,DROP - System Breach,2023,Roguelite,"₩6,540",40%,141,21,162,52974000,131,21,152,49704000
916040,SFD : Rogue TRPG,2018,Roguelite,"₩8,500",0%,86,13,99,42075000,76,14,90,38250000
3052500,ColdRidge,2024,Roguelite,"₩11,000",0%,77,26,103,56650000,60,25,85,46750000
809310,Sipho,2023,Roguelite,"₩19,500",0%,281,49,330,321750000,262,50,312,304200000
399640,Flamebreak,2015,Roguelite,"₩10,500",0%,489,33,522,274050000,410,31,441,231525000
2751120,Dive The Depths,2025,Roguelite,"₩9,800",0%,84,21,105,51450000,63,21,84,41160000
1114530,TTV3,2019,Roguelite,"₩1,100",0%,87,13,100,5500000,106,17,123,6765000
402120,Deathstate: Abyssal Edition,2015,Roguelite,"₩10,500",0%,303,49,352,184800000,240,46,286,150150000
603530,A Robot Named Fight!,2017,Roguelite,"₩14,500",0%,752,103,855,619875000,675,92,767,556075000
2056490,Forrader Hero,2023,Roguelite,"₩2,250",50%,67,7,74,8325000,54,4,58,6525000
1409530,Neophyte,2022,Roguelite,"₩3,300",0%,590,40,630,103950000,567,49,616,101640000
1153150,PARA♰BELLUM ~ 魔弹帕菈,2024,Roguelite,"₩3,400",0%,131,5,136,23120000,104,5,109,18530000
1766350,Heroes of Book & Paper,2023,Roguelite,"₩7,500",0%,25,0,25,9375000,22,0,22,8250000
344740,CRYPTARK,2017,Roguelite,"₩16,000",0%,1502,320,1822,1457600000,741,152,893,714400000
1175360,Doomsday Hunters,2023,Roguelite,"₩17,500",0%,687,80,767,671125000,608,75,683,597625000
2428750,Saikyo Robots,2024,Roguelite,"₩5,600",0%,14,0,14,3920000,13,0,13,3640000
3074110,The Rangers In The South,2025,Roguelite,"₩4,500",0%,597,110,707,159075000,587,120,707,159075000
2412200,Cthulhu's Reach: Devil Reef,2024,Roguelite,"₩11,000",0%,54,5,59,32450000,39,5,44,24200000
371430,Space Grunts,2016,Roguelite,"₩11,000",0%,61,13,74,40700000,29,7,36,19800000
1590160,Liberte,2023,Roguelite,"₩21,500",0%,121,58,179,192425000,95,51,146,156950000
2443170,Survivor Challenge TD,2025,Roguelite,"₩5,600",0%,44,4,48,13440000,31,6,37,10360000
2786160,Skeleton War,2024,Roguelite,"₩4,500",0%,83,2,85,19125000,75,2,77,17325000
857980,Void Bastards,2019,Roguelite,"₩31,000",0%,4527,739,5266,8162300000,0,0,0,0
3430570,Survive till 100 years old,2025,Roguelite,"₩2,300",0%,20,5,25,2875000,17,6,23,2645000
410820,Starward Rogue,2016,Roguelite,"₩13,500",0%,437,47,484,326700000,254,31,285,192375000
2787630,The Wrath of the Goose King,2024,Roguelite,"₩6,240",19%,20,0,20,6240000,17,0,17,5304000
2955500,Space Horde Attack,2024,Roguelite,"₩7,800",0%,11,1,12,4680000,9,1,10,3900000
1702990,Legend of the Outlaw Mage,2022,Roguelite,Free,0%,0,0,0,0,285,18,303,0
2752720,Dice Player One,2024,Roguelite,"₩16,500",0%,458,39,497,410025000,399,40,439,362175000
1491510,Recon Control,2021,Roguelite,"₩12,500",0%,103,17,120,75000000,67,16,83,51875000
268750,Magicite,2014,Roguelite,"₩11,000",0%,6459,1120,7579,4168450000,0,0,0,0
296970,Renowned Explorers: International Society,2015,Roguelite,"₩21,000",0%,2609,238,2847,2989350000,0,0,0,0
2430470,Vilde,2025,Roguelite,"₩17,500",0%,0,0,0,0,38,22,60,52500000
2283940,Ancient Guardians: The Dragon,2025,Roguelite,"₩6,700",0%,11,1,12,4020000,15,1,16,5360000
2288880,Acolyte of the Altar,2024,Roguelite,"₩21,500",0%,62,20,82,88150000,55,21,76,81700000
2839040,1080p,2024,Roguelite,"₩3,250",0%,17,0,17,2762500,15,0,15,2437500
1243890,Sword of the Necromancer,2021,Roguelite,"₩15,500",0%,238,120,358,277450000,188,81,269,208475000
3499910,Dachs Hunter,2025,Roguelite,"₩5,600",0%,0,0,0,0,11,0,11,3080000
3424020,Letterlike,2025,Roguelite,"₩8,900",0%,38,1,39,17355000,23,1,24,10680000
1093790,Seals of the Bygone,2020,Roguelite,"₩13,500",0%,79,18,97,65475000,55,11,66,44550000
1191840,Legend Creatures(传奇生物),2020,Roguelite,"₩5,500",0%,3536,386,3922,1078550000,3390,377,3767,1035925000
3087810,Recesses,2024,Roguelite,"₩5,600",0%,57,2,59,16520000,52,1,53,14840000
1755870,The Monster Within,2022,Roguelite,"₩16,500",0%,70,16,86,70950000,64,16,80,66000000
1115580,Grand Brix Shooter,2019,Roguelite,"₩9,900",0%,76,5,81,40095000,54,2,56,27720000
1099170,Battle Planet - Judgement Day,2019,Roguelite,"₩11,000",0%,64,9,73,40150000,54,9,63,34650000
400450,NeuroVoider,2016,Roguelite,"₩15,000",0%,584,182,766,574500000,362,108,470,352500000
1295630,Helskate,2025,Roguelite,"₩27,000",0%,226,76,302,407700000,192,82,274,369900000
364510,Transcendence,2015,Roguelite,"₩15,500",0%,187,26,213,165075000,174,26,200,155000000
1054800,变量 Variables,2019,Roguelite,"₩11,500",0%,874,131,1005,577875000,810,132,942,541650000
442210,Switchcars,2021,Roguelite,"₩9,500",0%,412,44,456,216600000,146,16,162,76950000
1192440,The Monster Breeder,2025,Roguelite,"₩32,000",0%,215,9,224,358400000,222,14,236,377600000
1844130,Stellar Orphans,2024,Roguelite,"₩18,500",0%,85,30,115,106375000,82,32,114,105450000
1828700,Celestial Project,2022,Roguelite,"₩11,000",0%,30,8,38,20900000,24,9,33,18150000
2807240,Swamp Up,2024,Roguelite,"₩5,600",0%,21,0,21,5880000,17,0,17,4760000
1935100,Nightfall Comes,2024,Roguelite,"₩12,500",0%,18,4,22,13750000,17,6,23,14375000
443880,Loot Rascals,2017,Roguelite,"₩10,500",0%,140,63,203,106575000,56,9,65,34125000
2618840,末世少女 Zombie Girl,2023,Roguelite,"₩6,600",40%,496,453,949,313170000,487,467,954,314820000
2098560,YouTuber Survivors,2024,Roguelite,"₩6,700",0%,33,1,34,11390000,26,1,27,9045000
457890,TumbleSeed,2017,Roguelite,"₩16,000",0%,162,48,210,168000000,66,8,74,59200000
1892750,Regulators,2025,Roguelite,"₩16,500",0%,32,0,32,26400000,35,0,35,28875000
2360290,Dungeon and Craft,2023,Roguelite,"₩7,800",0%,27,2,29,11310000,23,2,25,9750000
357330,Space Beast Terror Fright,2022,Roguelite,"₩16,000",0%,1567,146,1713,1370400000,1098,109,1207,965600000
2657310,Godrop,2024,Roguelite,"₩9,900",0%,298,14,312,154440000,257,16,273,135135000
3301260,One Minute,2025,Roguelite,"₩3,400",0%,21,1,22,3740000,16,1,17,2890000
981880,GrowRilla VR,2020,Roguelite,"₩16,500",0%,74,8,82,67650000,58,5,63,51975000
3530490,Fadedlands: The Reckless Squad,2025,Roguelite,"₩6,030",9%,0,0,0,0,24,0,24,7236000
904380,Vambrace: Cold Soul,2019,Roguelite,"₩2,700",90%,585,309,894,120690000,432,232,664,89640000
446020,Jalopy,2018,Roguelite,"₩15,500",0%,7925,2406,10331,8006525000,0,0,0,0
2992470,Rustwing,2025,Roguelite,"₩6,700",0%,11,1,12,4020000,14,2,16,5360000
369550,Blacksea Odyssey,2016,Roguelite,"₩10,500",0%,163,40,203,106575000,72,21,93,48825000
714240,SWARMRIDER OMEGA,2017,Roguelite,"₩1,100",0%,78,20,98,5390000,77,12,89,4895000
2404510,Lucky Hero,2023,Roguelite,"₩12,500",0%,81,12,93,58125000,65,12,77,48125000
619780,The Swords of Ditto: Mormo's Curse,2018,Roguelite,"₩16,500",0%,1462,855,2317,1911525000,1105,677,1782,1470150000
2318810,HAZAMA_QUEEN,2023,Roguelite,"₩5,600",0%,109,3,112,31360000,99,2,101,28280000
381900,Bard's Gold,2015,Roguelite,"₩8,500",0%,104,29,133,56525000,76,18,94,39950000
3499540,COMBOLITE,2025,Roguelite,"₩7,800",0%,34,10,44,17160000,40,11,51,19890000
387060,Earth Overclocked,2015,Roguelite,"₩5,500",0%,156,36,192,52800000,109,22,131,36025000
2892660,DON'T EXIST,2024,Roguelite,"₩6,700",0%,37,7,44,14740000,38,7,45,15075000
1022610,Alchemic Dungeons DX,2019,Roguelite,"₩8,500",0%,18,2,20,8500000,18,2,20,8500000
541200,GTTOD: Get To The Orange Door,2017,Roguelite,"₩21,500",0%,2899,382,3281,3527075000,0,0,0,0
2375730,Mercenaries of the Kingdom: First Blood,2024,Roguelite,"₩14,500",0%,46,11,57,41325000,30,10,40,29000000
856210,bit Dungeon III,2019,Roguelite,"₩10,500",0%,145,54,199,104475000,108,32,140,73500000
1120980,bit Dungeon,2019,Roguelite,"₩1,100",0%,162,17,179,9845000,139,12,151,8305000
1263370,Seek Girl:Fog Ⅰ,2020,Roguelite,"₩4,400",0%,3961,725,4686,1030920000,3775,719,4494,988680000
2674970,Devil Slot Machine,2024,Roguelite,"₩6,700",0%,21,3,24,8040000,9,3,12,4020000
2205260,Godfist,2023,Roguelite,"₩4,500",0%,29,3,32,7200000,24,3,27,6075000
264690,Coin Crypt,2014,Roguelite,"₩10,500",0%,516,84,600,315000000,180,18,198,103950000
1036740,METAL DOGS,2023,Roguelite,"₩20,500",0%,643,138,781,800525000,612,143,755,773875000
396480,Battlevoid: Harbinger,2016,Roguelite,"₩10,500",0%,808,212,1020,535500000,718,191,909,477225000
2619900,Tiny Breakers Camp,2024,Roguelite,"₩4,500",0%,48,10,58,13050000,44,9,53,11925000
1296450,Dust & Neon,2023,Roguelite,"₩21,500",0%,296,92,388,417100000,202,68,270,290250000
1078200,Spirits Abyss,2020,Roguelite,"₩9,900",0%,388,15,403,199485000,377,20,397,196515000
513250,Rogue Stache,2019,Roguelite,"₩1,100",0%,41,3,44,2420000,17,1,18,990000
1979570,Tomomon,2024,Roguelite,"₩13,930",0%,73,27,100,69650000,77,30,107,74525500
2136220,Andromeda Survivors,2022,Roguelite,"₩3,300",0%,41,8,49,8085000,37,8,45,7425000
2607260,Demon Corporation: Onboarding,2025,Roguelite,"₩7,800",0%,54,0,54,21060000,38,0,38,14820000
3167520,Bricks Survivors,2025,Roguelite,"₩5,600",0%,28,0,28,7840000,24,1,25,7000000
2541990,Dash x Survivors,2024,Roguelite,"₩6,700",0%,27,1,28,9380000,23,1,24,8040000
2960700,Beyond the Chiron Gate,2024,Roguelite,"₩11,000",0%,16,2,18,9900000,15,2,17,9350000
2083900,FLERP,2022,Roguelite,"₩3,400",0%,338,51,389,66130000,330,54,384,65280000
842170,Hyperspace Dogfights,2018,Roguelite,"₩11,000",0%,118,14,132,72600000,96,13,109,59950000
1619570,Death Roads: Tournament,2023,Roguelite,"₩16,500",0%,605,131,736,607200000,530,133,663,546975000
2400960,SolForge Fusion,2024,Roguelite,Free,0%,145,51,196,0,214,53,267,0
2527880,Undead West,2024,Roguelite,"₩8,900",0%,25,3,28,12460000,19,3,22,9790000
1417720,Gemini,2020,Roguelite,"₩8,500",0%,128,14,142,60350000,89,12,101,42925000
2746030,Deep Among the Swarm,2024,Roguelite,"₩9,900",0%,111,15,126,62370000,106,16,122,60390000
2278830,GunSuit Guardians,2023,Roguelite,"₩3,400",0%,207,26,233,39610000,182,27,209,35530000
1932700,Entomophobia,2024,Roguelite,"₩4,670",0%,34,3,37,8639500,30,3,33,7705500
339830,The Church in the Darkness ™,2019,Roguelite,"₩21,500",0%,88,60,148,159100000,67,51,118,126850000
439880,Heroes of Loot 2,2016,Roguelite,"₩12,500",0%,33,10,43,26875000,18,3,21,13125000
363420,Leap of Fate,2016,Roguelite,"₩17,000",0%,405,58,463,393550000,286,39,325,276250000
1240130,Dashing Fire,2020,Roguelite,"₩7,500",0%,74,3,77,28875000,63,3,66,24750000
3024640,None Shall Intrude: Descent,2024,Roguelite,Free,0%,0,0,0,0,222,27,249,0
3295230,Happy Hotel,2024,Roguelite,"₩4,000",0%,20,0,20,4000000,21,0,21,4200000
2598050,Foxcrate,2023,Roguelite,"₩5,600",0%,13,0,13,3640000,11,0,11,3080000
308600,Skillshot City,2017,Roguelite,Free,0%,2028,411,2439,0,0,0,0,0
2317960,Samurai Survivors,2023,Roguelite,"₩5,600",0%,43,5,48,13440000,39,5,44,12320000
2027510,Monster Crawl,2024,Roguelite,"₩8,900",0%,15,0,15,6675000,14,0,14,6230000
2323550,UDO,2024,Roguelite,"₩16,500",0%,12,1,13,10725000,12,1,13,10725000
2522940,Hyperlight Survivor,2023,Roguelite,"₩5,600",0%,12,2,14,3920000,12,2,14,3920000
2323550,UDO,2024,Roguelite,"₩16,500",0%,12,1,13,10725000,12,1,13,10725000
745000,Card Crawl,2018,Roguelite,"₩3,300",0%,134,41,175,28875000,124,42,166,27390000
323060,Tharsis,2016,Roguelite,"₩16,000",0%,1737,739,2476,1980800000,1010,413,1423,1138400000
3082690,Dead Soul TowerDefense:Shadow Labyrinth,2025,Roguelite,"₩8,800",19%,10,4,14,6160000,8,6,14,6160000
3169180,Chosen War,2025,Roguelite,"₩2,300",0%,0,0,0,0,8,3,11,1265000
620900,Witchinour,2017,Roguelite,"₩6,700",0%,54,5,59,19765000,51,5,56,18760000
2412280,Valiant Tactics,2025,Roguelite,"₩16,000",0%,0,0,0,0,12,2,14,11200000
2892060,Card Toons,2025,Roguelite,"₩16,500",0%,10,3,13,10725000,11,4,15,12375000
1464170,Touhou Eternal Spell Cards,2024,Roguelite,"₩5,600",0%,30,5,35,9800000,17,5,22,6160000
386560,Psycho Starship Rampage,2015,Roguelite,"₩10,500",0%,135,22,157,82425000,105,22,127,66675000
391140,Blast-off,2018,Roguelite,"₩3,370",0%,361,53,414,69759000,322,52,374,63019000
1664670,Refactor,2022,Roguelite,"₩5,600",0%,386,64,450,126000000,354,62,416,116480000
2451820,Brawl Tactics: Origins,2024,Roguelite,"₩11,620",25%,28,6,34,19754000,27,6,33,19173000
1418390,Antipaint,2024,Roguelite,"₩8,900",0%,218,8,226,100570000,212,9,221,98345000
492410,Rogues Like Us,2018,Roguelite,"₩6,700",0%,57,6,63,21105000,27,5,32,10720000
298560,Captain Forever Remix,2016,Roguelite,"₩10,500",0%,301,68,369,193725000,244,65,309,162225000
3625870,Dungeon Drops,2025,Roguelite,"₩3,360",40%,0,0,0,0,12,1,13,2184000
3060130,Cosmic Call,2024,Roguelite,"₩11,000",0%,19,0,19,10450000,18,0,18,9900000
2474750,Happy Poker,2025,Roguelite,"₩5,600",0%,44,2,46,12880000,24,3,27,7560000
250580,Paranautical Activity: Deluxe Atonement Edition,2014,Roguelite,"₩10,500",0%,961,447,1408,739200000,410,176,586,307650000
1124080,Active DBG: Brave's Rage,2023,Roguelite,"₩19,500",0%,230,44,274,267150000,178,39,217,211575000
602070,Plasma Puncher,2017,Roguelite,"₩6,500",0%,68,9,77,25025000,54,9,63,20475000
2636910,Moonbase Lambda,2025,Roguelite,"₩5,500",0%,31,1,32,8800000,32,1,33,9075000
349100,Notrium,2015,Roguelite,"₩3,400",0%,68,4,72,12240000,59,1,60,10200000
250580,Paranautical Activity: Deluxe Atonement Edition,2014,Roguelite,"₩10,500",0%,961,447,1408,739200000,410,176,586,307650000
1607040,Evertried,2021,Roguelite,"₩21,500",0%,55,14,69,74175000,25,9,34,36550000
1124080,Active DBG: Brave's Rage,2023,Roguelite,"₩19,500",0%,230,44,274,267150000,178,39,217,211575000
349100,Notrium,2015,Roguelite,"₩3,400",0%,68,4,72,12240000,59,1,60,10200000
2451720,Slayin DX,2024,Roguelite,"₩3,400",0%,37,0,37,6290000,35,0,35,5950000
1955390,Playable Mockup,2022,Roguelite,"₩7,800",0%,66,8,74,28860000,64,10,74,28860000
2610320,Starcremental,2024,Roguelite,"₩3,400",0%,15,2,17,2890000,14,3,17,2890000
1929900,Touhou: Dreamland of Infinity,2022,Roguelite,"₩20,500",0%,86,16,102,104550000,70,17,87,89175000
2158810,Cosmic Coliseum,2025,Roguelite,"₩5,600",0%,36,2,38,10640000,41,3,44,12320000
584220,RunningDead,2017,Roguelite,"₩2,300",0%,82,17,99,11385000,48,8,56,6440000
1408710,Regain Earth: First Strike,2021,Roguelite,"₩13,500",0%,61,11,72,48600000,46,7,53,35775000
719520,Spectro,2020,Roguelite,"₩15,500",0%,54,10,64,49600000,41,9,50,38750000
2636910,Moonbase Lambda,2025,Roguelite,"₩5,500",0%,31,1,32,8800000,32,1,33,9075000
725040,Ebony Spire: Heresy,2017,Roguelite,"₩1,100",0%,36,17,53,2915000,28,7,35,1925000
2792960,METAL BEANS,2024,Roguelite,Free,0%,0,0,0,0,47,4,51,0
318230,Convoy,2015,Roguelite,"₩16,000",0%,1131,307,1438,1150400000,866,244,1110,888000000
1832240,The Feathered Serpent,2024,Roguelite,"₩8,600",60%,42,1,43,18490000,27,1,28,12040000
1995780,Aliens After Ava,2023,Roguelite,Free,0%,0,0,0,0,194,2,196,0
2407160,Dragon Lair Depths,2024,Roguelite,"₩7,800",0%,21,1,22,8580000,10,1,11,4290000
616000,Riptale,2017,Roguelite,"₩6,500",0%,97,13,110,35750000,62,9,71,23075000
2119580,Golden Record Retriever,2024,Roguelite,"₩17,500",0%,32,16,48,42000000,22,16,38,33250000
1117670,GONNER2,2020,Roguelite,"₩14,500",0%,88,42,130,94250000,63,34,97,70325000
1491460,Tor Eternum,2022,Roguelite,"₩2,300",0%,57,16,73,8395000,41,10,51,5865000
3283230,Randotura,2024,Roguelite,"₩2,300",0%,18,0,18,2070000,20,0,20,2300000
1289750,Operation Zeta,2022,Roguelite,"₩10,500",0%,16,1,17,8925000,10,0,10,5250000
1945230,Diablo The Abyss,2023,Roguelite,"₩8,800",0%,180,35,215,94600000,171,35,206,90640000
1117670,GONNER2,2020,Roguelite,"₩14,500",0%,88,42,130,94250000,63,34,97,70325000
2266780,Ascendant,2025,Roguelite,"₩13,730",0%,32,8,40,27460000,32,8,40,27460000
1808320,Lake of Creatures,2024,Roguelite,"₩14,000",0%,34,5,39,27300000,35,13,48,33600000
1289750,Operation Zeta,2022,Roguelite,"₩10,500",0%,16,1,17,8925000,10,0,10,5250000
562230,Space Tyrant,2018,Roguelite,"₩21,000",0%,511,94,605,635250000,453,86,539,565950000
1581790,Mystery at Morgoth,2023,Roguelite,"₩6,000",0%,11,1,12,3600000,10,1,11,3300000
3048930,Duriano,2025,Roguelite,"₩7,800",0%,111,2,113,44070000,104,3,107,41730000
1000760,Foregone,2021,Roguelite,"₩20,500",0%,1102,248,1350,1383750000,1042,244,1286,1318150000
2387310,Magic Paper,2024,Roguelite,"₩14,900",0%,25,3,28,20860000,18,3,21,15645000
2321210,Neon Echo,2023,Roguelite,"₩16,500",0%,2290,1809,4099,3381675000,0,0,0,0
840430,Planetary Dustoff,2019,Roguelite,"₩11,000",0%,42,5,47,25850000,39,5,44,24200000
1943740,Arrival of Beasts,2023,Roguelite,"₩11,000",0%,43,2,45,24750000,28,1,29,15950000
657090,Robothorium,2019,Roguelite,"₩16,000",0%,259,107,366,292800000,159,86,245,196000000
3040270,Bees vs Zombees,2024,Roguelite,"₩8,000",0%,77,5,82,32800000,74,3,77,30800000
2279220,Diceheart,2023,Roguelite,"₩13,500",0%,21,1,22,14850000,18,2,20,13500000
880830,Cavesweeper,2018,Roguelite,"₩5,500",0%,13,3,16,4400000,12,3,15,4125000
1833540,STARS ERA: ABYSS FRONTIER,2024,Roguelite,"₩5,850",25%,26,2,28,8190000,19,2,21,6142500
872680,Z Dawn,2019,Roguelite,"₩10,500",0%,190,72,262,137550000,163,67,230,120750000
1602370,DurDanto,2024,Roguelite,"₩23,960",0%,12,2,14,16772000,10,1,11,13178000
3061550,RIOO,2024,Roguelite,"₩1,100",0%,8,2,10,550000,8,2,10,550000
546090,Trip to Vinelands,2015,Roguelite,"₩1,100",0%,197,27,224,12320000,517,98,615,33825000
1435160,NYANCO MINE,2020,Roguelite,"₩2,300",0%,24,0,24,2760000,13,0,13,1495000
1375930,Minesweeper: Collector,2020,Roguelite,"₩8,400",0%,105,9,114,47880000,105,10,115,48300000
2287990,GemCrusty,2023,Roguelite,Free,0%,0,0,0,0,114,15,129,0
1375930,Minesweeper: Collector,2020,Roguelite,"₩8,400",0%,105,9,114,47880000,105,10,115,48300000
1604840,Super Fowlst 2,2021,Roguelite,"₩4,400",0%,15,1,16,3520000,14,1,15,3300000
546090,Trip to Vinelands,2015,Roguelite,"₩1,100",0%,197,27,224,12320000,517,98,615,33825000
1148290,Thy Kingdom Crumble,2019,Roguelite,"₩5,500",0%,13,2,15,4125000,9,2,11,3025000
306550,Runers,2014,Roguelite,"₩10,500",0%,227,57,284,149100000,180,48,228,119700000
2275220,Frontline Survivors,2024,Roguelite,"₩5,600",0%,18,0,18,5040000,11,1,12,3360000
2161430,FAKE SIGNALS,2023,Roguelite,"₩11,000",0%,56,15,71,39050000,24,14,38,20900000
978790,Frantic Dimension,2018,Roguelite,Free,0%,58,6,64,0,15,1,16,0
2377620,Lord O' Pirates,2025,Roguelite,"₩5,600",0%,0,0,0,0,11,1,12,3360000
1127110,Outpost,2020,Roguelite,Free,0%,664,94,758,0,666,99,765,0
2925270,CAN BULLET,2024,Roguelite,"₩4,500",0%,19,0,19,4275000,20,0,20,4500000
1410140,Load Roll Die,2021,Roguelite,"₩11,000",0%,13,2,15,8250000,9,2,11,6050000
2669440,元卡牌2 - MetaCard2,2024,Roguelite,"₩7,800",0%,46,2,48,18720000,27,1,28,10920000
882590,Outcast Tales: The First Journey,2024,Roguelite,Free,0%,0,0,0,0,200,35,235,0
2257560,Kill The Climbers,2024,Roguelite,"₩3,400",0%,11,2,13,2210000,11,2,13,2210000
2406360,SpeedOverflow,2023,Roguelite,"₩5,600",0%,117,29,146,40880000,84,31,115,32200000
2908120,One Boss One Fight,2024,Roguelite,"₩11,000",0%,21,6,27,14850000,21,5,26,14300000
291190,Heroes of Steel RPG,2014,Roguelite,"₩11,000",0%,215,62,277,152350000,166,50,216,118800000
1739650,Dimensions: Dreadnought Architect,2023,Roguelite,"₩21,000",0%,109,83,192,201600000,101,73,174,182700000
836080,BARRAGE / 铁幕,2018,Roguelite,"₩5,600",0%,53,9,62,17360000,44,7,51,14280000
464260,Xeno Crisis,2019,Roguelite,"₩20,500",0%,158,24,182,186550000,145,28,173,177325000
384490,NECROPOLIS: BRUTAL EDITION,2016,Roguelite,"₩33,000",0%,3010,1623,4633,7644450000,0,0,0,0
2185780,Return to abyss 重返深渊,2023,Roguelite,"₩5,600",0%,769,195,964,269920000,742,197,939,262920000
800550,DarkDIRE: The Advanced Set,2018,Roguelite,"₩4,400",0%,18,2,20,4400000,13,2,15,3300000
1886080,Tetraphobia,2024,Roguelite,"₩12,500",0%,11,0,11,6875000,11,0,11,6875000
2060550,Fabular: Prologue,2022,Roguelite,Free,0%,0,0,0,0,67,4,71,0
2207480,HELLCARD: Prologue,2023,Roguelite,Free,0%,0,0,0,0,329,54,383,0
2185780,Return to abyss 重返深渊,2023,Roguelite,"₩5,600",0%,769,195,964,269920000,742,197,939,262920000
1054270,RASHLANDER,2019,Roguelite,"₩4,400",0%,44,4,48,10560000,32,3,35,7700000
3424920,DarkRanger,2025,Roguelite,"₩13,500",0%,0,0,0,0,25,9,34,22950000
328760,SanctuaryRPG: Black Edition,2015,Roguelite,"₩8,500",0%,1435,134,1569,666825000,931,81,1012,430100000
1990730,Pylorus - Footsteps of Greed,2022,Roguelite,Free,0%,0,0,0,0,11,0,11,0
1721020,Loot Train,2021,Roguelite,Free,0%,0,0,0,0,31,5,36,0
358830,Good Robot,2016,Roguelite,"₩9,900",0%,217,42,259,128205000,134,17,151,74745000
2639840,Dino Survivors,2023,Roguelite,"₩2,300",0%,51,7,58,6670000,35,6,41,4715000
2692030,Valkyrie Squad: Siege Breakers,2025,Roguelite,"₩6,700",0%,56,24,80,26800000,52,25,77,25795000
794760,ABYSS CRAWLERS plus,2018,Roguelite,"₩5,500",0%,76,6,82,22550000,71,5,76,20900000
990640,Numgeon,2018,Roguelite,"₩5,600",0%,62,19,81,22680000,51,15,66,18480000
2697390,Homebrew32,2024,Roguelite,"₩5,600",0%,28,1,29,8120000,23,1,24,6720000
2150180,Deep Dungeon,2022,Roguelite,"₩3,400",0%,12,3,15,2550000,12,2,14,2380000
371890,Gunslugs,2015,Roguelite,"₩5,000",0%,89,32,121,30250000,12,3,15,3750000
293240,Cosmochoria,2015,Roguelite,"₩10,500",0%,419,50,469,246225000,285,35,320,168000000
364420,Roguelands,2016,Roguelite,"₩11,000",0%,2978,725,3703,2036650000,0,0,0,0
2766770,这是一个正方形！（This Is A Square！）,2024,Roguelite,"₩4,500",0%,24,0,24,5400000,10,0,10,2250000
2172120,Rift Rangers,2023,Roguelite,"₩5,600",0%,34,4,38,10640000,18,3,21,5880000
1145950,Vector Prospector,2020,Roguelite,"₩8,500",0%,13,2,15,6375000,11,2,13,5525000
2673010,Sisyphus Paradox,2024,Roguelite,"₩9,900",0%,23,0,23,11385000,17,0,17,8415000
2482130,Final Resistance,2023,Roguelite,"₩4,500",0%,36,3,39,8775000,25,3,28,6300000
494720,Morphblade,2017,Roguelite,"₩5,500",0%,513,47,560,154000000,238,15,253,69575000
1280380,Moolii's Dreamland,2023,Roguelite,"₩8,900",0%,90,7,97,43165000,58,6,64,28480000
3126220,Make It Count,2025,Roguelite,"₩8,900",0%,8,3,11,4895000,7,5,12,5340000
1291540,Cartridge Defense,2022,Roguelite,"₩12,500",0%,89,8,97,60625000,72,7,79,49375000
2987250,Slime Coming,2024,Roguelite,"₩4,500",0%,14,0,14,3150000,11,0,11,2475000
2860270,Orbs of Chaos,2024,Roguelite,"₩5,600",0%,23,2,25,7000000,18,2,20,5600000
2242220,Forest Fire,2023,Roguelite,"₩4,350",35%,63,6,69,15007500,61,6,67,14572500
2071430,Roots of Yggdrasil,2024,Roguelite,"₩21,500",0%,282,30,312,335400000,238,33,271,291325000
1303050,Ruggnar,2022,Roguelite,"₩14,500",0%,12,4,16,11600000,9,1,10,7250000
2582540,RoGlass,2024,Roguelite,"₩11,000",0%,91,1,92,50600000,82,0,82,45100000
2416290,PLONG,2023,Roguelite,"₩5,600",0%,28,0,28,7840000,25,0,25,7000000
595790,Hell is Other Demons,2019,Roguelite,"₩10,500",0%,296,23,319,167475000,267,23,290,152250000
1413210,The Cassir Simulator,2020,Roguelite,"₩1,100",0%,73,8,81,4455000,71,6,77,4235000
1317950,Eternal Dreamers,2021,Roguelite,Free,0%,71,14,85,0,70,15,85,0
2452350,Hamboy : AutoChess Survivor,2023,Roguelite,"₩4,500",0%,25,9,34,7650000,22,9,31,6975000
2559500,Survivors of Mayhem,2024,Roguelite,"₩7,800",0%,15,0,15,5850000,15,0,15,5850000
2398660,The Dream Labyrinth,2024,Roguelite,"₩16,500",0%,35,8,43,35475000,35,8,43,35475000
2507980,Meta-Ghost: The Breaking Show,2024,Roguelite,"₩19,500",0%,932,437,1369,1334775000,752,371,1123,1094925000
1495920,BulletGarden,2021,Roguelite,"₩4,500",0%,17,1,18,4050000,15,1,16,3600000
2981030,OutRoad Fury,2024,Roguelite,Free,0%,0,0,0,0,33,5,38,0
2212410,Shadowkin,2024,Roguelite,"₩7,800",0%,65,24,89,34710000,42,20,62,24180000
3826020,Stop Breaking My Castle!,2025,Roguelite,Free,0%,0,0,0,0,17,1,18,0
1918790,The Dark Realm,2024,Roguelite,"₩9,500",0%,20,2,22,10450000,11,1,12,5700000
2497850,NUNNA: Prologue,2023,Roguelite,Free,0%,0,0,0,0,15,0,15,0
1672920,FrankenStorm TD: Prologue,2021,Roguelite,Free,0%,0,0,0,0,310,46,356,0
2717450,Museum Mystery: Deckbuilding Card Game,2024,Roguelite,Free,0%,0,0,0,0,139,24,163,0
3252190,Nine Heavens,2025,Roguelite,"₩4,500",0%,18,1,19,4275000,10,2,12,2700000
1702880,LinearShooter Remixed,2021,Roguelite,"₩3,300",0%,11,0,11,1815000,11,0,11,1815000
2211110,Brick Odyssey,2023,Roguelite,"₩13,500",0%,32,1,33,22275000,17,1,18,12150000
3206010,Attack Core,2024,Roguelite,"₩6,700",0%,98,2,100,33500000,95,3,98,32830000
985510,Necken,2021,Roguelite,"₩5,500",0%,28,3,31,8525000,22,3,25,6875000
2126370,Wraithbinder,2024,Roguelite,"₩16,500",0%,20,0,20,16500000,13,0,13,10725000
929010,Swag and Sorcery,2019,Roguelite,"₩14,500",0%,1728,1460,3188,2311300000,0,0,0,0
1842610,Dungeon Wizards,2022,Roguelite,"₩7,800",0%,52,5,57,22230000,49,4,53,20670000
2516980,Heroes & Redemption,2024,Roguelite,Free,0%,44,11,55,0,57,12,69,0
2834690,2048 - Dungeons,2025,Roguelite,"₩5,600",0%,0,0,0,0,14,0,14,3920000
2315020,Froguelike,2024,Roguelite,"₩3,400",0%,165,5,170,28900000,151,5,156,26520000
2220480,Burst Hero,2023,Roguelite,"₩3,400",0%,80,13,93,15810000,61,12,73,12410000
2219880,Animal Academy,2023,Roguelite,"₩4,500",0%,13,1,14,3150000,13,1,14,3150000
2875780,Staying Fresh,2024,Roguelite,"₩4,500",0%,19,0,19,4275000,17,0,17,3825000
2162820,Rustil: Eternal Labyrinth Castle,2024,Roguelite,"₩16,500",0%,155,71,226,186450000,158,74,232,191400000
3201630,Beast Brawl,2024,Roguelite,Free,0%,0,0,0,0,11,0,11,0
3151420,Mystic Explorer,2025,Roguelite,"₩5,600",0%,0,0,0,0,22,2,24,6720000
1149860,Arsenal Demon,2019,Roguelite,"₩5,600",0%,20,1,21,5880000,16,0,16,4480000
2599700,Algor PEW PEW,2024,Roguelite,"₩12,500",0%,26,4,30,18750000,25,3,28,17500000
1272120,Darkanoid,2020,Roguelite,"₩3,300",0%,61,5,66,10890000,49,4,53,8745000
891370,The Last Hex,2021,Roguelite,"₩12,500",0%,173,39,212,132500000,142,42,184,115000000
2598860,Boundless Paths,2024,Roguelite,"₩8,900",0%,15,0,15,6675000,16,0,16,7120000
3072680,Made in Tower,2024,Roguelite,"₩2,300",0%,20,0,20,2300000,17,0,17,1955000
1394830,LOCIS,2020,Roguelite,"₩5,500",0%,17,4,21,5775000,15,3,18,4950000
2599420,Dynasty,2024,Roguelite,Free,0%,0,0,0,0,15,3,18,0
2873190,From Soil to Bottle,2024,Roguelite,"₩16,500",0%,42,7,49,40425000,41,7,48,39600000
783450,HYPERGUN,2018,Roguelite,"₩10,500",0%,45,28,73,38325000,27,21,48,25200000
1295760,Moonfall,2020,Roguelite,"₩5,500",0%,15,1,16,4400000,11,1,12,3300000
2599420,Dynasty,2024,Roguelite,Free,0%,0,0,0,0,15,3,18,0
1394830,LOCIS,2020,Roguelite,"₩5,500",0%,17,4,21,5775000,15,3,18,4950000
876220,Moss Destruction,2019,Roguelite,"₩2,200",0%,80,31,111,12210000,9,1,10,1100000
2452890,Catacomb Rogue Clawsaders,2024,Roguelite,"₩2,300",0%,13,1,14,1610000,13,1,14,1610000
3160160,Six-Ear Macaque: Awakening,2025,Roguelite,"₩7,800",0%,98,0,98,38220000,89,0,89,34710000
2223170,Blow Away Survivors,2024,Roguelite,"₩8,900",0%,9,3,12,5340000,8,3,11,4895000
400180,Okhlos: Omega,2016,Roguelite,"₩14,500",0%,657,201,858,622050000,489,138,627,454575000
2823320,Midnight Racer,2025,Roguelite,"₩4,710",0%,11,0,11,2590500,11,0,11,2590500
3062680,Sculplings,2025,Roguelite,"₩7,800",0%,28,0,28,10920000,33,0,33,12870000
2927780,Last Outpost,2025,Roguelite,"₩11,000",0%,35,8,43,23650000,35,11,46,25300000
1334650,Hell Shuffle,2021,Roguelite,Free,0%,49,4,53,0,49,5,54,0
544180,Orbox C,2016,Roguelite,"₩1,100",0%,243,10,253,13915000,62,5,67,3685000
503620,Fictorum,2017,Roguelite,"₩10,500",0%,889,243,1132,594300000,791,223,1014,532350000
961420,Vile,2019,Roguelite,"₩13,500",0%,35,5,40,27000000,25,5,30,20250000
533050,Lazy Galaxy: Rebel Story,2018,Roguelite,"₩5,500",0%,34,5,39,10725000,25,5,30,8250000
3096270,NETHER DUNGEONS,2024,Roguelite,Free,0%,0,0,0,0,323,57,380,0
2354040,Spaceship Survivors,2023,Roguelite,"₩5,600",0%,11,0,11,3080000,11,0,11,3080000
3068380,Carnival Of Souls,2025,Roguelite,"₩11,000",0%,21,4,25,13750000,20,5,25,13750000
2455110,Yokai Art: Survival Prologue,2023,Roguelite,Free,0%,0,0,0,0,53,3,56,0
2009380,They Don't Sleep,2022,Roguelite,"₩3,400",0%,198,7,205,34850000,195,8,203,34510000
2169300,Dizzy Rogues,2023,Roguelite,"₩4,500",0%,45,4,49,11025000,40,4,44,9900000
1174030,Hero Lodge,2022,Roguelite,"₩10,500",0%,22,1,23,12075000,20,1,21,11025000
318600,The Flame in the Flood,2016,Roguelite,"₩16,000",0%,5443,1723,7166,5732800000,0,0,0,0
1805680,A Contusion,2022,Roguelite,"₩5,600",0%,10,2,12,3360000,10,2,12,3360000
2953030,Princess of Destruction | 滅ぼし姫,2024,Roguelite,"₩5,600",0%,27,2,29,8120000,31,2,33,9240000
2754370,Voidsayer,2025,Roguelite,"₩16,000",0%,27,7,34,27200000,50,18,68,54400000
2101250,Nebula,2023,Roguelite,"₩4,500",0%,151,20,171,38475000,135,20,155,34875000
2114330,Honeymancer,2025,Roguelite,"₩16,500",0%,21,1,22,18150000,19,1,20,16500000
2100810,cheesequest,2022,Roguelite,"₩3,300",0%,27,4,31,5115000,23,4,27,4455000
3178660,Blood Rising,2024,Roguelite,Free,0%,0,0,0,0,11,1,12,0
2885480,BattleCap,2024,Roguelite,"₩13,500",0%,174,4,178,120150000,166,5,171,115425000
2074710,Microbes and Machines,2022,Roguelite,"₩1,100",0%,34,7,41,2255000,34,6,40,2200000
3669450,Pantheion,2025,Roguelite,"₩7,920",19%,0,0,0,0,13,1,14,5544000
3349840,InKing,2024,Roguelite,Free,0%,0,0,0,0,108,5,113,0
1141220,DemonCrawl,2019,Roguelite,"₩15,500",0%,950,254,1204,933100000,863,243,1106,857150000
1693660,Cards of Patience,2021,Roguelite,"₩5,500",0%,19,3,22,6050000,16,4,20,5500000
290890,You Must Build A Boat,2015,Roguelite,"₩5,500",0%,862,187,1049,288475000,661,155,816,224400000
3398740,Tower Of Penguinaria,2025,Roguelite,Free,0%,0,0,0,0,15,1,16,0
224820,Super House of Dead Ninjas,2013,Roguelite,"₩7,500",0%,1629,70,1699,637125000,1394,58,1452,544500000
2393900,Story Of Infinity: Xia,2023,Roguelite,Free,0%,39,8,47,0,38,8,46,0
1214330,World Seed Classic,2020,Roguelite,"₩6,500",0%,98,9,107,34775000,92,8,100,32500000
2018840,UNILOGUE,2022,Roguelite,Free,0%,18,1,19,0,18,1,19,0
2340860,Way of the Bullet,2024,Roguelite,"₩11,000",0%,14,0,14,7700000,13,0,13,7150000
1440150,Pixel Survivor - Pixel Up!,2023,Roguelite,"₩1,100",0%,19,5,24,1320000,18,4,22,1210000
2851110,Golden Warden,2025,Roguelite,"₩11,000",0%,34,2,36,19800000,35,3,38,20900000
2158850,Spooky Halloween in the Voxel World (Remake),2022,Roguelite,"₩7,500",0%,16,0,16,6000000,12,0,12,4500000
1196240,WizardPunk,2023,Roguelite,"₩11,000",0%,14,0,14,7700000,10,1,11,6050000
455100,Gerty,2019,Roguelite,"₩15,500",0%,38,7,45,34875000,25,5,30,23250000
1070190,Spellsword Cards: Origins,2019,Roguelite,"₩10,500",0%,47,24,71,37275000,37,23,60,31500000
1766390,FORWARD: Escape the Fold - Ultimate Edition,2022,Roguelite,"₩10,500",0%,552,91,643,337575000,506,89,595,312375000
1000080,Zengeon,2019,Roguelite,"₩20,500",0%,1022,517,1539,1577475000,813,400,1213,1243325000
2696390,Guns And Draguns,2024,Roguelite,"₩14,500",0%,17,0,17,12325000,14,0,14,10150000
1077890,Catch a Duck,2019,Roguelite,"₩5,500",0%,64,16,80,22000000,64,16,80,22000000
1667770,Samurai Shampoo Classic,2021,Roguelite,Free,0%,0,0,0,0,156,19,175,0
2626860,Dragon Eclipse,2024,Roguelite,"₩14,500",0%,135,64,199,144275000,98,58,156,113100000
338190,Just Get Through,2015,Roguelite,"₩5,600",0%,186,32,218,61040000,135,26,161,45080000
2388820,Eternal Survivor,2023,Roguelite,"₩1,100",0%,17,0,17,935000,12,0,12,660000
1209140,Peace Data,2020,Roguelite,"₩4,500",0%,193,21,214,48150000,166,20,186,41850000
2783850,Superation,2025,Roguelite,"₩5,600",0%,0,0,0,0,10,0,10,2800000
1907140,Dungeon: Faster & Deadlier,2022,Roguelite,"₩11,000",0%,67,18,85,46750000,59,18,77,42350000
2346230,Ravenwood,2024,Roguelite,"₩5,600",0%,14,2,16,4480000,13,2,15,4200000
1181000,UBERMOSH:OMEGA,2019,Roguelite,"₩1,100",0%,160,11,171,9405000,316,27,343,18865000
2489460,Cropisle TD,2023,Roguelite,"₩2,300",0%,39,6,45,5175000,28,6,34,3910000
338320,Pixel Heroes: Byte & Magic,2015,Roguelite,"₩11,000",0%,432,139,571,314050000,235,66,301,165550000
1625930,Galaia,2024,Roguelite,"₩5,600",0%,53,7,60,16800000,48,7,55,15400000
1769510,FEWAR-DVD,2021,Roguelite,Free,0%,64,2,66,0,65,2,67,0
688060,Odd Realm,2024,Roguelite,"₩21,500",0%,818,136,954,1025550000,759,134,893,959975000
2568600,The Sentinel,2023,Roguelite,"₩1,100",0%,10,1,11,605000,10,1,11,605000
1564350,Bot Loop,2024,Roguelite,"₩21,500",0%,12,1,13,13975000,9,1,10,10750000
1668620,Castles on Clouds,2024,Roguelite,"₩3,400",0%,25,0,25,4250000,25,0,25,4250000
2437080,Stardust Defenders,2023,Roguelite,"₩5,600",0%,29,4,33,9240000,24,4,28,7840000
2438770,Chores of Corruption,2023,Roguelite,"₩5,600",0%,23,1,24,6720000,13,1,14,3920000
2083840,Her Name Was Fire,2022,Roguelite,"₩4,400",0%,209,75,284,62480000,200,74,274,60280000
2190230,Dust and Aliens,2023,Roguelite,Free,0%,0,0,0,0,136,19,155,0
2083840,Her Name Was Fire,2022,Roguelite,"₩4,400",0%,209,75,284,62480000,200,74,274,60280000
2507040,Gunslinger Express,2024,Roguelite,"₩5,600",0%,16,2,18,5040000,15,3,18,5040000
2027970,Sole Saga,2023,Roguelite,"₩7,800",0%,85,29,114,44460000,49,25,74,28860000
2086140,RICE - Repetitive Indie Combat Experience™,2023,Roguelite,"₩5,600",0%,193,67,260,72800000,184,65,249,69720000
3128280,Cats & Dice,2025,Roguelite,"₩8,900",0%,40,9,49,21805000,32,10,42,18690000
2258480,Gunforged,2025,Roguelite,"₩9,900",0%,52,4,56,27720000,52,4,56,27720000
3613450,Coil's Containment,2025,Roguelite,"₩2,300",0%,16,0,16,1840000,14,0,14,1610000
2166820,史莱姆冒险战SlimeWarfare,2023,Roguelite,"₩6,700",0%,23,1,24,8040000,18,1,19,6365000
688060,Odd Realm,2024,Roguelite,"₩21,500",0%,818,136,954,1025550000,759,134,893,959975000
1048880,Emberlight,2019,Roguelite,Free,0%,46,11,57,0,46,12,58,0
2928450,BRUTUS MAXIMUS,2024,Roguelite,"₩11,000",0%,17,4,21,11550000,18,4,22,12100000
1833680,BeatRider,2024,Roguelite,"₩13,500",0%,48,16,64,43200000,17,16,33,22275000
1090060,Weapon Hacker,2020,Roguelite,"₩10,500",0%,33,2,35,18375000,23,2,25,13125000
1931090,Hexagonal Tower,2022,Roguelite,"₩3,400",0%,28,25,53,9010000,28,25,53,9010000
1882040,Craft Hero,2022,Roguelite,"₩5,500",0%,326,62,388,106700000,285,67,352,96800000
3092540,Plumber Survivors: Prologue,2024,Roguelite,Free,0%,0,0,0,0,24,1,25,0
457520,Moustache Mountain,2016,Roguelite,"₩2,200",0%,111,43,154,16940000,80,26,106,11660000
1651520,Holy Grain,2025,Roguelite,"₩16,500",0%,8,2,10,8250000,9,2,11,9075000
3069320,Chimera,2024,Roguelite,"₩6,700",0%,19,3,22,7370000,17,4,21,7035000
1537480,玉言·离光,2024,Roguelite,"₩7,800",0%,127,51,178,69420000,64,32,96,37440000
2773160,Magic Caster,2024,Roguelite,"₩3,400",0%,18,0,18,3060000,14,0,14,2380000
3440750,Beats&Boss,2025,Roguelite,"₩3,400",0%,16,2,18,3060000,12,2,14,2380000
3730600,Aestheta,2025,Roguelite,"₩3,400",0%,0,0,0,0,79,16,95,16150000
1454730,Chenso Club,2022,Roguelite,"₩11,000",0%,235,77,312,171600000,64,19,83,45650000
1936990,FROGUE,2024,Roguelite,"₩13,500",0%,36,1,37,24975000,26,1,27,18225000
364740,Magi,2017,Roguelite,"₩10,500",0%,20,2,22,11550000,17,2,19,9975000
719800,Last Encounter,2018,Roguelite,"₩15,500",0%,32,12,44,34100000,14,3,17,13175000
926390,Infected Shelter,2019,Roguelite,Free,0%,381,74,455,0,395,81,476,0
383230,Dungeon Souls,2016,Roguelite,"₩13,500",0%,1647,584,2231,1505925000,1015,303,1318,889650000
3730600,Aestheta,2025,Roguelite,"₩3,400",0%,0,0,0,0,79,16,95,16150000
340520,Tallowmere,2015,Roguelite,"₩4,500",0%,759,78,837,188325000,680,75,755,169875000
2997110,Slasher: Origins,2025,Roguelite,"₩5,000",0%,14,6,20,5000000,12,6,18,4500000
2462090,Star Knight: Order of the Vortex,2024,Roguelite,"₩5,600",0%,13,0,13,3640000,10,0,10,2800000
363930,Dead Age,2016,Roguelite,"₩1,650",90%,4467,1008,5475,451687500,0,0,0,0
2447310,Knight Overloaded,2023,Roguelite,Free,0%,127,23,150,0,127,24,151,0
3366070,Champi,2025,Roguelite,Free,0%,0,0,0,0,20,2,22,0
2554690,Too Shroom!,2024,Roguelite,Free,0%,0,0,0,0,22,2,24,0
337290,Still Not Dead,2018,Roguelite,"₩5,600",0%,167,50,217,60760000,107,27,134,37520000
2393890,IGNISTONE,2023,Roguelite,"₩5,300",0%,50,3,53,14045000,38,3,41,10865000
2480000,Nightshift Survival,2023,Roguelite,"₩3,400",0%,43,4,47,7990000,38,4,42,7140000
2476020,Good Luck My Lord,2023,Roguelite,"₩4,500",0%,14,3,17,3825000,13,3,16,3600000
3073350,Genesis Survivors,2024,Roguelite,"₩5,600",0%,76,26,102,28560000,64,19,83,23240000
407560,Killing Room,2016,Roguelite,"₩16,500",0%,990,433,1423,1173975000,885,361,1246,1027950000
3490820,Meme Survivors: Backrooms,2025,Roguelite,"₩1,100",0%,20,0,20,1100000,17,0,17,935000
887400,THE GREAT GEOMETRIC MULTIVERSE TOUR,2018,Roguelite,"₩1,100",0%,284,80,364,20020000,30,2,32,1760000
1811430,Biters & Bullets: Prologue,2022,Roguelite,Free,0%,0,0,0,0,302,37,339,0
883020,Shadowlings,2018,Roguelite,Free,0%,78,17,95,0,78,17,95,0
1074610,COLLAPSED,2019,Roguelite,"₩15,500",0%,132,50,182,141050000,95,42,137,106175000
1849800,Cramit's Keep,2022,Roguelite,"₩5,500",0%,14,0,14,3850000,10,0,10,2750000
1151080,Legend of Keepers: Prologue,2019,Roguelite,Free,0%,2187,182,2369,0,0,0,0,0
1849800,Cramit's Keep,2022,Roguelite,"₩5,500",0%,14,0,14,3850000,10,0,10,2750000
3166200,Across the Abyss: Voidborn,2024,Roguelite,"₩3,400",0%,23,2,25,4250000,16,2,18,3060000
1169520,Guild of Ascension,2021,Roguelite,"₩15,500",0%,41,12,53,41075000,35,7,42,32550000
1074610,COLLAPSED,2019,Roguelite,"₩15,500",0%,132,50,182,141050000,95,42,137,106175000
2476730,Myriad Mayhem,2023,Roguelite,"₩7,800",0%,18,4,22,8580000,16,4,20,7800000
351330,DROD RPG: Tendry's Tale,2016,Roguelite,"₩11,000",0%,38,7,45,24750000,25,6,31,17050000
3386380,Guardian Grids,2024,Roguelite,"₩2,520",55%,9,4,13,1638000,7,4,11,1386000
327510,WASTED,2016,Roguelite,"₩14,000",0%,899,272,1171,819700000,487,129,616,431200000
2396300,My Life of Repayment,2023,Roguelite,Free,0%,0,0,0,0,14,3,17,0
332400,Girlfriend Rescue,2015,Roguelite,"₩11,000",0%,190,35,225,123750000,105,26,131,72050000
401910,Darknet,2017,Roguelite,"₩16,000",0%,112,12,124,99200000,61,9,70,56000000
3752220,RiftGuard,2025,Roguelite,"₩1,100",0%,0,0,0,0,15,0,15,825000
1706920,Firekeep,2022,Roguelite,"₩14,500",0%,19,3,22,15950000,19,2,21,15225000
3273740,Abyss Chaser,2025,Roguelite,"₩7,430",0%,13,0,13,4829500,12,0,12,4458000
973060,恶魔迷宫 2 |Evil Maze 2 | 惡魔迷宮 2,2019,Roguelite,"₩11,000",0%,69,35,104,57200000,50,34,84,46200000
2817910,The Nightwatch,2024,Roguelite,"₩5,600",0%,27,4,31,8680000,27,4,31,8680000
1078490,Seed Hunter 猎源,2020,Roguelite,"₩9,500",0%,257,118,375,178125000,170,87,257,122075000
2009620,Harvest Hunt,2024,Roguelite,"₩17,920",0%,65,0,65,58240000,37,0,37,33152000
1811940,Archipelago,2022,Roguelite,"₩5,500",0%,30,8,38,10450000,28,9,37,10175000
2456130,Demon's Bane,2023,Roguelite,"₩3,400",0%,11,0,11,1870000,11,2,13,2210000
300580,GALAK-Z,2015,Roguelite,"₩20,500",0%,395,146,541,554525000,191,54,245,251125000
3096620,Legacy of Defense - Prologue,2024,Roguelite,Free,0%,0,0,0,0,399,70,469,0
2089920,Shadow Heroes,2022,Roguelite,"₩2,880",50%,37,2,39,5616000,19,2,21,3024000
2136550,HIGhSCORE,2023,Roguelite,"₩4,500",0%,28,0,28,6300000,22,0,22,4950000
2089920,Shadow Heroes,2022,Roguelite,"₩2,880",50%,37,2,39,5616000,19,2,21,3024000
1443100,RogueSlide,2022,Roguelite,"₩1,100",0%,30,3,33,1815000,20,3,23,1265000
3396310,Shorebound,2025,Roguelite,"₩11,000",0%,20,3,23,12650000,7,3,10,5500000
2377320,Berry Hunt Survivors,2024,Roguelite,"₩3,400",0%,10,2,12,2040000,9,2,11,1870000
958050,1001st Hyper Tower,2019,Roguelite,"₩12,500",0%,41,6,47,29375000,31,5,36,22500000
2780310,Silicon War:Blitz,2024,Roguelite,"₩5,600",0%,11,1,12,3360000,12,1,13,3640000
2280440,Ogre Chambers DX,2023,Roguelite,Free,0%,0,0,0,0,104,12,116,0
1209570,Cosmos,2020,Roguelite,"₩2,200",0%,12,2,14,1540000,10,2,12,1320000
1182420,VED,2024,Roguelite,"₩27,000",0%,47,12,59,79650000,30,8,38,51300000
959090,WayDown,2018,Roguelite,Free,0%,10,1,11,0,10,1,11,0
3472840,By Bait or By Bullet,2025,Roguelite,Free,0%,0,0,0,0,9,1,10,0
1354990,Dungeons of Voidria,2022,Roguelite,"₩13,500",0%,29,2,31,20925000,29,3,32,21600000
2960560,Union of Gnomes: Prologue,2024,Roguelite,Free,0%,0,0,0,0,236,52,288,0
1234940,Astronarch,2021,Roguelite,"₩15,500",0%,982,115,1097,850175000,726,81,807,625425000
2920970,元卡牌2 MetaCard2 序章 Prologue,2024,Roguelite,Free,0%,0,0,0,0,16,2,18,0
2563960,Necroslayer,2024,Roguelite,"₩6,700",0%,13,1,14,4690000,9,1,10,3350000
1704120,IT Startup: Tech Fodder,2024,Roguelite,"₩6,600",40%,27,0,27,8910000,26,0,26,8580000
591000,Deep Sixed,2018,Roguelite,"₩6,500",0%,87,16,103,33475000,63,11,74,24050000
1035010,Mini Gal4Xy,2019,Roguelite,"₩4,500",0%,31,5,36,8100000,26,3,29,6525000
2820310,Muchacho Bean,2024,Roguelite,"₩3,400",0%,43,1,44,7480000,11,1,12,2040000
2606550,Farmer Survivors,2024,Roguelite,"₩4,500",0%,29,7,36,8100000,21,3,24,5400000
459680,Auro: A Monster-Bumping Adventure,2016,Roguelite,Free,0%,66,13,79,0,65,13,78,0
3639280,MASTERMIND,2025,Roguelite,Free,0%,0,0,0,0,19,2,21,0
1290780,Residual,2021,Roguelite,"₩10,250",50%,24,7,31,15887500,16,7,23,11787500
2602290,TH3-M15 GUILD,2024,Roguelite,"₩6,700",0%,18,0,18,6030000,15,0,15,5025000
2602290,TH3-M15 GUILD,2024,Roguelite,"₩6,700",0%,18,0,18,6030000,15,0,15,5025000
2443090,Deathless: Survivors,2024,Roguelite,"₩11,000",0%,127,69,196,107800000,122,68,190,104500000
2870580,Cubed and Dangerous,2024,Roguelite,"₩4,450",55%,29,1,30,6675000,20,1,21,4672500
602120,Molemen Must Die!,2017,Roguelite,"₩2,200",0%,54,5,59,6490000,16,0,16,1760000
2849070,Soulkin,2025,Roguelite,"₩11,000",0%,32,3,35,19250000,22,3,25,13750000
3514820,Crypt Keeper,2025,Roguelite,"₩11,000",0%,0,0,0,0,20,0,20,11000000
2611750,Cosmic Cursor,2024,Roguelite,"₩5,000",0%,13,1,14,3500000,14,1,15,3750000
2800510,Job Joust,2024,Roguelite,"₩11,000",0%,15,0,15,8250000,15,0,15,8250000
1154300,The Equinox Hunt,2020,Roguelite,"₩11,000",0%,25,4,29,15950000,21,4,25,13750000
296930,Ascendant,2014,Roguelite,Free,0%,163,50,213,0,163,51,214,0
2155280,Defend Earth: Xenos Survivors,2023,Roguelite,"₩5,600",0%,45,7,52,14560000,33,4,37,10360000
2073490,To the Stars,2024,Roguelite,"₩16,500",0%,40,4,44,36300000,38,4,42,34650000
793820,Coffee Crawl,2018,Roguelite,"₩5,500",0%,9,4,13,3575000,8,2,10,2750000
2591290,Tabletop Hero,2024,Roguelite,"₩9,900",0%,42,9,51,25245000,35,6,41,20295000
3183500,Epoch of Guardians,2025,Roguelite,"₩13,500",0%,31,6,37,24975000,24,6,30,20250000
3055000,Hell's Descent,2024,Roguelite,Free,0%,12,0,12,0,13,0,13,0
444270,Hypersensitive Bob,2016,Roguelite,"₩5,500",0%,50,10,60,16500000,34,8,42,11550000
2271030,Tacape,2023,Roguelite,"₩7,800",0%,27,4,31,12090000,19,2,21,8190000
1364710,Skycadia,2020,Roguelite,"₩10,500",0%,20,2,22,11550000,16,2,18,9450000
1499770,Echoes of Mayhem®,2023,Roguelite,"₩11,000",0%,15,2,17,9350000,10,1,11,6050000
1848710,Ninja Soul,2022,Roguelite,"₩10,500",0%,130,33,163,85575000,89,31,120,63000000
2719650,Project XSTING,2024,Roguelite,"₩8,900",0%,15,0,15,6675000,14,0,14,6230000
1989140,Tower of Spirit,2024,Roguelite,"₩5,600",0%,27,2,29,8120000,22,1,23,6440000
1433550,Space Gladiators: The Hole,2020,Roguelite,Free,0%,125,20,145,0,125,19,144,0
1541250,Super Raft Boat Classic,2021,Roguelite,Free,0%,866,65,931,0,864,65,929,0
3167100,CODE: BLUE,2025,Roguelite,"₩3,400",0%,18,0,18,3060000,11,0,11,1870000
3417900,Mine & Slash,2025,Roguelite,"₩11,000",0%,13,2,15,8250000,7,3,10,5500000
395570,We Are The Dwarves,2016,Roguelite,"₩6,100",0%,893,430,1323,403515000,604,224,828,252540000
2728950,Potty Knight Saga,2024,Roguelite,"₩6,700",0%,102,4,106,35510000,86,4,90,30150000
2522270,Rune Gate,2024,Roguelite,"₩11,000",0%,48,5,53,29150000,35,5,40,22000000
3139190,Forest Dump: Prologue,2024,Roguelite,Free,0%,0,0,0,0,27,4,31,0
554710,Spell Cast,2022,Roguelite,"₩1,100",0%,39,19,58,3190000,31,17,48,2640000
1919720,Crimson Dawn,2023,Roguelite,"₩4,500",0%,237,132,369,83025000,196,131,327,73575000
1126890,Urban Cards,2021,Roguelite,"₩16,500",0%,140,39,179,147675000,111,37,148,122100000
2658490,The Dark Survivors,2024,Roguelite,"₩1,100",0%,15,5,20,1100000,12,5,17,935000
1175430,Project Starship X,2020,Roguelite,"₩11,000",0%,88,5,93,51150000,64,3,67,36850000
2372350,"Bahamut2-Come on,Fight",2023,Roguelite,"₩11,000",0%,35,3,38,20900000,35,4,39,21450000
1951650,Calcium Chaos: Derailed,2024,Roguelite,"₩11,000",0%,61,0,61,33550000,48,0,48,26400000
2664720,ASTROSWARM,2024,Roguelite,"₩11,000",0%,31,2,33,18150000,25,2,27,14850000
2318630,The Territory of Egg,2023,Roguelite,"₩3,400",0%,47,1,48,8160000,34,1,35,5950000
1458000,Air Bounce - The Jump 'n' Run Challenge,2020,Roguelite,"₩5,500",0%,52,9,61,16775000,52,9,61,16775000
528730,Crypt of the Serpent King,2016,Roguelite,"₩2,200",0%,224,50,274,30140000,198,50,248,27280000
1808210,Hullbreakers,2023,Roguelite,Free,0%,0,0,0,0,12,0,12,0
331440,bit Dungeon II,2014,Roguelite,"₩4,400",0%,1821,386,2207,485540000,1150,253,1403,308660000
1608550,Firegirl: Hack 'n Splash Rescue DX,2021,Roguelite,"₩18,500",0%,206,91,297,274725000,114,53,167,154475000
573110,AWAY: Journey to the Unexpected,2019,Roguelite,"₩17,500",0%,100,95,195,170625000,30,27,57,49875000
2481920,Lifeforms: Binary Fission,2024,Roguelite,"₩11,000",0%,22,6,28,15400000,19,6,25,13750000
2870150,Brawl To The West,2025,Roguelite,"₩9,900",0%,0,0,0,0,101,39,140,69300000
2704720,Orbius,2023,Roguelite,"₩3,400",0%,18,2,20,3400000,16,2,18,3060000
1077090,Bucket Knight,2019,Roguelite,₩820,85%,37,8,45,1845000,33,7,40,1640000
1077090,Bucket Knight,2019,Roguelite,₩820,85%,37,8,45,1845000,33,7,40,1640000
2583330,Zlime: Return Of Demon Lord,2024,Roguelite,"₩7,800",0%,70,1,71,27690000,45,1,46,17940000
433600,A Legend of Luca,2016,Roguelite,"₩11,000",0%,163,41,204,112200000,139,39,178,97900000
3609260,Idle Zombie Wave: Premium,2025,Roguelite,"₩8,900",0%,4,3,7,3115000,6,4,10,4450000
2426640,Kobold Castle,2023,Roguelite,"₩7,800",0%,22,0,22,8580000,20,0,20,7800000
2345550,Meow Legion,2024,Roguelite,"₩2,300",0%,11,0,11,1265000,10,0,10,1150000
1373830,SPL: Skilled Pilots Live,2020,Roguelite,"₩15,500",0%,11,1,12,9300000,10,1,11,8525000
485680,sphereFACE,2017,Roguelite,"₩5,600",0%,29,3,32,8960000,23,3,26,7280000
905490,Deck Hunter,2019,Roguelite,"₩10,500",0%,227,96,323,169575000,205,96,301,158025000
1078510,Alluris,2019,Roguelite,"₩10,500",0%,157,14,171,89775000,125,14,139,72975000
3081270,Gourds Up,2024,Roguelite,"₩5,600",0%,15,0,15,4200000,10,0,10,2800000
2608400,Regular Spacecraft - Defending the Mothership,2023,Roguelite,"₩1,100",0%,15,1,16,880000,15,1,16,880000
1457840,Fishticuffs,2020,Roguelite,"₩5,500",0%,11,0,11,3025000,11,0,11,3025000
2877790,Rogue Girl,2024,Roguelite,"₩2,300",0%,27,12,39,4485000,26,13,39,4485000
2269530,HaHa,2024,Roguelite,"₩2,700",40%,0,0,0,0,15,0,15,2025000
1431150,LongPath,2020,Roguelite,"₩2,200",0%,9,2,11,1210000,9,2,11,1210000
810000,Manaya,2018,Roguelite,"₩3,400",0%,13,3,16,2720000,12,3,15,2550000
2539180,Mayhem Survivors: Animals,2024,Roguelite,Free,0%,0,0,0,0,23,4,27,0
2640910,Yeetus,2023,Roguelite,"₩4,500",0%,22,0,22,4950000,20,0,20,4500000
1325520,Mezmeratu,2020,Roguelite,"₩8,500",0%,12,4,16,6800000,12,3,15,6375000
2375570,Champion's Chalice,2024,Roguelite,"₩11,000",0%,18,3,21,11550000,16,3,19,10450000
2150310,元素召唤 Summon Elemental,2023,Roguelite,"₩3,400",0%,51,6,57,9690000,44,6,50,8500000
1650200,Scholar of the Arcane Arts,2025,Roguelite,"₩4,500",0%,31,2,33,7425000,22,3,25,5625000
1239950,Astronaut: The Best,2023,Roguelite,"₩15,500",0%,29,3,32,24800000,27,3,30,23250000
1000470,Drawngeon: Dungeons of Ink and Paper,2019,Roguelite,"₩5,600",0%,62,15,77,21560000,52,15,67,18760000
2963830,Skel Dungeon: Heroes Must Die!,2024,Roguelite,"₩9,900",0%,11,6,17,8415000,6,5,11,5445000
1149710,Tesla Force,2020,Roguelite,"₩18,500",0%,182,49,231,213675000,111,33,144,133200000
2150310,元素召唤 Summon Elemental,2023,Roguelite,"₩3,400",0%,51,6,57,9690000,44,6,50,8500000
742530,Roguemance,2018,Roguelite,"₩7,500",0%,36,14,50,18750000,27,12,39,14625000
2457000,Space Vikings,2023,Roguelite,"₩3,400",0%,20,2,22,3740000,15,1,16,2720000
2025930,Robot Revolt,2023,Roguelite,"₩6,700",0%,17,3,20,6700000,15,3,18,6030000
928990,Undungeon,2021,Roguelite,"₩4,300",80%,237,131,368,79120000,154,79,233,50095000
280040,A Wizard's Lizard,2014,Roguelite,"₩10,500",0%,312,131,443,232575000,166,75,241,126525000
1418020,Tavern of Gods,2021,Roguelite,"₩9,320",0%,621,171,792,369072000,586,175,761,354626000
1880160,元卡牌MetaCard,2023,Roguelite,"₩6,700",0%,36,8,44,14740000,24,8,32,10720000
2997060,Hunt the Pale Gods,2025,Roguelite,"₩16,500",0%,24,1,25,20625000,17,1,18,14850000
446120,Bunker Punks,2018,Roguelite,"₩16,000",0%,313,123,436,348800000,218,81,299,239200000
362090,Siralim,2015,Roguelite,"₩11,000",0%,223,38,261,143550000,165,31,196,107800000
542660,Feral Fury,2017,Roguelite,"₩7,500",0%,106,25,131,49125000,78,23,101,37875000
2945350,Wukong's Pool,2024,Roguelite,"₩6,700",0%,18,2,20,6700000,10,2,12,4020000
1354540,Arcaxer,2021,Roguelite,"₩26,000",0%,21,3,24,31200000,18,3,21,27300000
3055780,PERMUTER,2024,Roguelite,"₩4,500",0%,18,0,18,4050000,18,0,18,4050000
777410,EarthNight,2019,Roguelite,"₩5,600",0%,80,25,105,29400000,30,3,33,9240000
2850970,The Great Couturier,2024,Roguelite,"₩2,800",50%,12,3,15,2100000,9,3,12,1680000
1170050,Null Drifter,2019,Roguelite,"₩4,500",0%,25,1,26,5850000,17,1,18,4050000
305780,Echo of the Wilds,2014,Roguelite,"₩7,800",0%,149,45,194,75660000,109,29,138,53820000
1324860,Heretic's Lot: Prologue,2020,Roguelite,Free,0%,13,1,14,0,13,1,14,0
1228320,Dungeon Looter,2024,Roguelite,"₩13,500",0%,70,19,89,60075000,58,19,77,51975000
2837280,Counterpick Labs,2024,Roguelite,Free,0%,0,0,0,0,77,9,86,0
2475020,Light Speed Ride Out,2023,Roguelite,"₩5,600",0%,18,1,19,5320000,18,1,19,5320000
1304810,HANI,2021,Roguelite,"₩3,300",0%,20,2,22,3630000,19,1,20,3300000
2625970,Necromorphosis,2024,Roguelite,"₩5,600",0%,10,1,11,3080000,11,1,12,3360000
3027710,Cat Guardian,2024,Roguelite,"₩6,670",25%,18,1,19,6336500,17,1,18,6003000
492290,Has-Been Heroes,2017,Roguelite,"₩21,000",0%,290,90,380,399000000,204,54,258,270900000
1180110,DeadShotZ,2019,Roguelite,"₩2,300",0%,15,2,17,1955000,12,2,14,1610000
637880,I wanna be The Cat,2017,Roguelite,"₩7,500",0%,154,14,168,63000000,138,15,153,57375000
1023790,Rick Henderson,2021,Roguelite,"₩3,400",0%,28,1,29,4930000,22,1,23,3910000
2836750,Super Infection Massive Pathology,2025,Roguelite,"₩11,000",0%,0,0,0,0,13,1,14,7700000
1076480,Dream Flash,2019,Roguelite,"₩7,500",0%,47,0,47,17625000,31,0,31,11625000
704950,Scarlett's Dungeon,2017,Roguelite,"₩5,600",0%,37,15,52,14560000,26,11,37,10360000
1255050,Craft In Abyss,2021,Roguelite,"₩10,500",0%,45,9,54,28350000,33,5,38,19950000
511540,MoonQuest,2020,Roguelite,"₩20,500",0%,81,27,108,110700000,58,21,79,80975000
2215340,Shishi : Timeless Prelude,2023,Roguelite,"₩21,500",0%,12,0,12,12900000,11,0,11,11825000
1928030,"Rightfully, Beary Arms",2023,Roguelite,"₩11,000",0%,25,0,25,13750000,18,0,18,9900000
2146180,Cyclo Chambers,2023,Roguelite,"₩5,600",0%,114,22,136,38080000,106,22,128,35840000
898450,UBERMOSH:SANTICIDE,2018,Roguelite,"₩1,100",0%,192,12,204,11220000,313,27,340,18700000
1888450,Shop-Like - The Rogue-Like Item Shop Experience,2023,Roguelite,"₩8,900",0%,34,9,43,19135000,29,8,37,16465000
858680,Black Paradox,2019,Roguelite,"₩15,500",0%,86,41,127,98425000,58,23,81,62775000
1203360,Core Defense,2020,Roguelite,"₩11,000",0%,287,74,361,198550000,260,73,333,183150000
1075550,Bite the Bullet,2020,Roguelite,"₩10,500",0%,48,39,87,45675000,22,18,40,21000000
1681560,Hungry Bunny,2021,Roguelite,"₩5,500",0%,15,4,19,5225000,12,1,13,3575000
2782530,Shrimp.io,2024,Roguelite,Free,0%,0,0,0,0,204,33,237,0
2199060,Core Devourer,2024,Roguelite,"₩6,700",0%,79,21,100,33500000,57,25,82,27470000
2152780,Impeachment Survivors,2023,Roguelite,"₩3,400",0%,25,0,25,4250000,22,0,22,3740000
1386440,B67,2020,Roguelite,"₩9,500",0%,41,5,46,21850000,40,5,45,21375000
612160,Splinter Zone,2017,Roguelite,"₩5,500",0%,23,1,24,6600000,13,0,13,3575000
2100300,Abstract Grind,2022,Roguelite,Free,0%,0,0,0,0,14,6,20,0
1448970,CIPHER 61,2022,Roguelite,"₩8,500",0%,15,2,17,7225000,10,2,12,5100000
2145190,ENERGY SURVIVORS,2023,Roguelite,"₩3,400",0%,28,7,35,5950000,28,6,34,5780000
1043150,Danger Gazers,2020,Roguelite,"₩11,000",0%,50,19,69,37950000,29,11,40,22000000
698870,Metaverse Keeper / 元能失控,2019,Roguelite,"₩15,500",0%,619,176,795,616125000,454,135,589,456475000
1746820,HYDROGEN,2024,Roguelite,"₩6,700",0%,10,0,10,3350000,10,0,10,3350000
920680,Fate Hunters,2019,Roguelite,"₩15,500",0%,679,182,861,667275000,613,183,796,616900000
2579550,Salvo Shuffle,2024,Roguelite,Free,0%,0,0,0,0,70,1,71,0
1064580,CaptainMarlene,2019,Roguelite,"₩1,100",0%,16,5,21,1155000,13,0,13,715000
3432500,Sin and Love,2025,Roguelite,"₩16,500",0%,162,53,215,177375000,148,69,217,179025000
1497600,Poker Squadrons,2021,Roguelite,"₩1,100",0%,15,2,17,935000,14,2,16,880000
965120,能量冲击 Energy Shock,2019,Roguelite,"₩10,500",0%,58,6,64,33600000,34,7,41,21525000
829260,Morning Never Comes,2018,Roguelite,"₩1,100",0%,35,6,41,2255000,31,6,37,2035000
1340770,Artifacts,2020,Roguelite,"₩4,400",0%,9,3,12,2640000,9,3,12,2640000
1094400,Twin Ruin,2021,Roguelite,"₩7,500",0%,22,2,24,9000000,19,2,21,7875000
1987260,The Nine Tailed Celestial Fox,2024,Roguelite,"₩11,000",0%,19,3,22,12100000,11,3,14,7700000
1073770,XANARTHRAXIA,2019,Roguelite,"₩1,100",0%,37,6,43,2365000,27,5,32,1760000
1183840,Dungeon of Rikka,2020,Roguelite,"₩5,500",0%,24,4,28,7700000,17,3,20,5500000
257120,Not The Robots,2013,Roguelite,"₩11,000",0%,445,120,565,310750000,234,58,292,160600000
1960330,Alchemia: Creatio Ex Nihilo,2025,Roguelite,"₩21,500",0%,21,2,23,24725000,17,3,20,21500000
1020730,Dark Bestiary,2020,Roguelite,"₩9,900",0%,459,55,514,254430000,444,60,504,249480000
1300330,Farmageddon: A Cattle Royale,2021,Roguelite,Free,0%,36,1,37,0,37,1,38,0
2171270,Legend of Feather,2022,Roguelite,"₩4,500",0%,36,11,47,10575000,27,9,36,8100000
1071660,Ruine,2019,Roguelite,"₩5,500",0%,15,1,16,4400000,11,1,12,3300000
2483730,Banner of Conquest,2025,Roguelite,"₩5,600",0%,78,22,100,28000000,59,26,85,23800000
1020730,Dark Bestiary,2020,Roguelite,"₩9,900",0%,459,55,514,254430000,444,60,504,249480000
1071660,Ruine,2019,Roguelite,"₩5,500",0%,15,1,16,4400000,11,1,12,3300000
1610890,Boney's Research On Humans!,2022,Roguelite,"₩6,500",0%,14,1,15,4875000,13,1,14,4550000
2231230,Solar Survivors,2024,Roguelite,"₩5,600",0%,20,0,20,5600000,19,0,19,5320000
2352040,FatSheep Crisis,2023,Roguelite,"₩1,800",60%,111,34,145,13050000,102,34,136,12240000
2076810,Further Still: Survivors,2022,Roguelite,"₩4,400",0%,30,5,35,7700000,20,5,25,5500000
1252580,Rising Hell - Prologue,2020,Roguelite,Free,0%,94,19,113,0,94,19,113,0
1226490,Lost In Ferry VR,2020,Roguelite,"₩10,500",0%,14,2,16,8400000,11,2,13,6825000
429620,Dungeon Rushers,2016,Roguelite,"₩16,000",0%,758,460,1218,974400000,495,291,786,628800000
1199180,Edge Of Galaxy,2021,Roguelite,"₩5,600",0%,19,11,30,8400000,13,8,21,5880000
1141760,Westale: Peelgrimage,2023,Roguelite,"₩5,600",0%,327,141,468,131040000,266,137,403,112840000
843360,Rift Keeper,2019,Roguelite,"₩10,500",0%,57,23,80,42000000,27,20,47,24675000
2649800,Vinecard,2025,Roguelite,"₩11,000",0%,64,1,65,35750000,39,1,40,22000000
2761340,Beats of Betrayal,2024,Roguelite,"₩13,500",0%,31,0,31,20925000,31,0,31,20925000
3862650,Stonehold,2025,Roguelite,Free,0%,0,0,0,0,10,1,11,0
3019160,Creeping Dusk,2024,Roguelite,"₩7,800",0%,59,22,81,31590000,56,28,84,32760000
3157680,Card of Legend,2025,Roguelite,"₩9,000",0%,19,10,29,13050000,18,11,29,13050000
2407200,OVERWHELMED,2023,Roguelite,"₩5,600",0%,23,1,24,6720000,14,1,15,4200000
805920,Seek Etyliv,2018,Roguelite,"₩5,190",0%,52,13,65,16867500,47,13,60,15570000
1885200,Rally: Endless Conquest,2024,Roguelite,"₩7,800",0%,37,2,39,15210000,35,2,37,14430000
3346990,Ninja Vs. Zombies 3,2025,Roguelite,"₩5,600",0%,12,1,13,3640000,12,0,12,3360000
529970,PositronX,2020,Roguelite,"₩25,000",0%,61,20,81,101250000,38,17,55,68750000
615010,Runic Rampage - Action RPG,2017,Roguelite,"₩7,800",0%,192,28,220,85800000,178,27,205,79950000
1501410,Dwarf Journey,2021,Roguelite,"₩11,000",0%,323,22,345,189750000,282,24,306,168300000
311480,Vertical Drop Heroes HD,2014,Roguelite,"₩7,500",0%,591,141,732,274500000,114,34,148,55500000
2068460,Last Of Ark: Prologue,2022,Roguelite,Free,0%,0,0,0,0,16,4,20,0
3257980,Turtle Riders: Adventure Begins,2025,Roguelite,Free,0%,0,0,0,0,25,6,31,0
1535100,Nadir: A Grimdark Deckbuilder,2023,Roguelite,"₩19,900",0%,197,118,315,313425000,147,86,233,231835000
446760,Neighborhorde,2017,Roguelite,"₩5,600",0%,35,8,43,12040000,22,5,27,7560000
346340,Gran Vitreous,2015,Roguelite,"₩5,500",0%,26,8,34,9350000,22,5,27,7425000
1995330,Monos: The Endless Tower,2023,Roguelite,"₩9,200",0%,20,4,24,11040000,15,4,19,8740000
3333460,No Space For All,2024,Roguelite,"₩5,600",0%,35,1,36,10080000,28,0,28,7840000
2774490,Dream Survivors,2024,Roguelite,"₩7,800",0%,13,5,18,7020000,12,5,17,6630000
2455500,Time Survivors: Chapter 0,2023,Roguelite,Free,0%,0,0,0,0,133,31,164,0
3610940,Gunbot Diplomacy: Blast Off,2025,Roguelite,Free,0%,0,0,0,0,94,13,107,0
327670,Ironcast,2015,Roguelite,"₩15,500",0%,681,254,935,724625000,553,205,758,587450000
1784630,Alice!,2022,Roguelite,"₩10,500",0%,40,12,52,27300000,34,12,46,24150000
905660,纸境英雄 Papercraft,2019,Roguelite,"₩18,500",0%,255,44,299,276575000,185,38,223,206275000
2850100,Dungeon Exiles,2024,Roguelite,"₩5,600",0%,77,28,105,29400000,80,30,110,30800000
2614790,GunDeck[100],2023,Roguelite,"₩5,600",0%,32,3,35,9800000,25,2,27,7560000
2388460,Pathfinder: Gallowspire Survivors,2024,Roguelite,"₩7,800",0%,347,228,575,224250000,322,224,546,212940000
1840790,Metal Mutation,2023,Roguelite,"₩3,300",85%,57,21,78,12870000,39,17,56,9240000
3410640,Rogue Worlds,2025,Roguelite,Free,0%,0,0,0,0,46,0,46,0
2220320,Space Mercenary Defense Force,2023,Roguelite,"₩2,800",50%,16,3,19,2660000,9,1,10,1400000
1253860,Neurodeck : Psychological Deckbuilder,2021,Roguelite,"₩14,500",0%,158,101,259,187775000,86,79,165,119625000
2620530,Perfect Teams,2024,Roguelite,"₩21,500",0%,20,0,20,21500000,18,0,18,19350000
1409700,A Way To Die,2022,Roguelite,"₩8,050",0%,25,1,26,10465000,13,1,14,5635000
600630,Spaceship Looter,2017,Roguelite,Free,0%,162,66,228,0,163,67,230,0
1730550,Panta Rhei - Guardian of Time,2025,Roguelite,"₩18,500",0%,0,0,0,0,14,0,14,12950000
3406600,Winter Quackdown,2025,Roguelite,"₩1,100",0%,12,1,13,715000,12,1,13,715000
2433820,SUPRACORE,2023,Roguelite,"₩5,600",0%,12,1,13,3640000,11,1,12,3360000
445600,Void Raiders,2016,Roguelite,"₩5,500",0%,56,23,79,21725000,44,23,67,18425000
1847150,Touhou Genso Wanderer -FORESIGHT-,2024,Roguelite,"₩37,500",0%,146,158,304,570000000,129,158,287,538125000
2722640,Coin-Op Vice,2024,Roguelite,"₩11,000",0%,15,2,17,9350000,15,1,16,8800000
1183010,Listeria Wars,2022,Roguelite,"₩6,700",0%,31,1,32,10720000,25,1,26,8710000
1976230,Outnumbered,2022,Roguelite,Free,0%,0,0,0,0,187,50,237,0
1072870,Random War,2019,Roguelite,"₩1,100",0%,14,1,15,825000,13,1,14,770000
1524530,Fantasy Town Regional Manager,2021,Roguelite,"₩10,500",0%,70,18,88,46200000,58,17,75,39375000
1286670,Spooky Chase,2020,Roguelite,"₩5,600",0%,43,4,47,13160000,35,3,38,10640000
490230,SWARMRIDERS,2016,Roguelite,Free,0%,431,55,486,0,500,68,568,0
1611420,Sea Horizon,2022,Roguelite,"₩18,000",0%,140,35,175,157500000,106,32,138,124200000
1677580,My Master's A Moron,2022,Roguelite,"₩15,500",0%,24,5,29,22475000,16,5,21,16275000
3393180,Sweep,2025,Roguelite,"₩7,800",0%,16,4,20,7800000,13,4,17,6630000
1303350,Rocky Mayhem,2024,Roguelite,Free,0%,36,6,42,0,37,6,43,0
1476170,Godstrike,2021,Roguelite,"₩6,300",0%,152,82,234,73710000,117,58,175,55125000
1632330,Calamity Eliminator,2021,Roguelite,"₩8,500",0%,62,23,85,36125000,57,22,79,33575000
1190820,Booobjz,2021,Roguelite,"₩1,100",0%,20,9,29,1595000,19,2,21,1155000
872040,Hovership Havoc,2019,Roguelite,"₩10,500",0%,24,7,31,16275000,12,6,18,9450000
2194820,Koboo: The Tree Spirit - Prologue,2024,Roguelite,Free,0%,0,0,0,0,27,3,30,0
1331420,Rogue Arrows,2022,Roguelite,"₩5,600",0%,33,9,42,11760000,32,9,41,11480000
2404070,Death's Toll,2024,Roguelite,"₩11,000",0%,24,4,28,15400000,19,5,24,13200000
496620,Monster Slayers,2017,Roguelite,"₩9,500",0%,975,256,1231,584725000,623,165,788,374300000
659110,Vicious Attack Llama Apocalypse,2018,Roguelite,"₩15,500",0%,53,15,68,52700000,27,10,37,28675000
894000,Night of the Blood Moon,2019,Roguelite,"₩5,500",0%,60,7,67,18425000,37,5,42,11550000
659110,Vicious Attack Llama Apocalypse,2018,Roguelite,"₩15,500",0%,53,15,68,52700000,27,10,37,28675000
371220,VERLIES II,2015,Roguelite,"₩3,400",0%,79,56,135,22950000,65,42,107,18190000
516430,Ruin of the Reckless,2017,Roguelite,"₩10,500",0%,63,14,77,40425000,31,11,42,22050000
2331710,Sky Survivors,2023,Roguelite,"₩5,600",0%,33,3,36,10080000,23,3,26,7280000
2691050,Neongarten - Prologue,2024,Roguelite,Free,0%,0,0,0,0,19,5,24,0
1494450,Oakenfold,2022,Roguelite,"₩19,900",0%,42,5,47,46765000,17,4,21,20895000
334420,Out There: Ω Edition,2015,Roguelite,"₩4,000",75%,1274,416,1690,338000000,1006,336,1342,268400000
332530,Shutshimi,2015,Roguelite,"₩5,500",0%,117,55,172,47300000,46,4,50,13750000
507120,The Superfluous,2017,Roguelite,"₩5,600",0%,43,10,53,14840000,25,9,34,9520000
294370,Crowntakers,2014,Roguelite,"₩11,000",0%,486,175,661,363550000,288,96,384,211200000
1393410,Seek Girl V,2020,Roguelite,"₩2,200",0%,698,264,962,105820000,657,255,912,100320000
2955220,CARD QUEST,2024,Roguelite,"₩11,000",0%,75,21,96,52800000,50,22,72,39600000
452920,Laser Disco Defenders,2016,Roguelite,"₩10,480",0%,43,10,53,27772000,9,2,11,5764000
1302440,RogueJack: Roguelike Blackjack,2020,Roguelite,"₩5,600",0%,38,10,48,13440000,32,9,41,11480000
577470,Last Days Of Tascaria,2019,Roguelite,"₩8,500",0%,21,5,26,11050000,15,5,20,8500000
756020,Puppet Kings,2017,Roguelite,"₩10,500",0%,22,8,30,15750000,15,5,20,10500000
2114380,Dungeon Dungeon!,2024,Roguelite,"₩16,500",0%,13,5,18,14850000,8,5,13,10725000
2259340,Don't Wake God,2023,Roguelite,Free,0%,0,0,0,0,24,4,28,0
2428310,天行镖客 (Sky Escort),2024,Roguelite,"₩11,000",0%,66,12,78,42900000,43,13,56,30800000
2490080,Last Hopeless,2023,Roguelite,"₩6,700",0%,21,0,21,7035000,21,0,21,7035000
1152450,Creeps Creeps? Creeps!,2020,Roguelite,"₩2,200",0%,32,4,36,3960000,27,2,29,3190000
2739800,Tribe Nation,2025,Roguelite,"₩11,000",0%,21,5,26,14300000,19,5,24,13200000
1953020,Lab Remnants,2022,Roguelite,"₩2,300",0%,18,1,19,2185000,18,1,19,2185000
1924010,Shapebreaker - Tower Defense Deckbuilder,2023,Roguelite,"₩5,600",0%,45,11,56,15680000,44,13,57,15960000
1924010,Shapebreaker - Tower Defense Deckbuilder,2023,Roguelite,"₩5,600",0%,45,11,56,15680000,44,13,57,15960000
1152450,Creeps Creeps? Creeps!,2020,Roguelite,"₩2,200",0%,32,4,36,3960000,27,2,29,3190000
520660,Wrack: Exoverse,2019,Roguelite,"₩15,500",0%,31,12,43,33325000,15,9,24,18600000
475960,Bombslinger,2018,Roguelite,"₩13,000",0%,105,29,134,87100000,85,25,110,71500000
3596030,Sweepin' XS,2025,Roguelite,"₩5,600",0%,0,0,0,0,15,0,15,4200000
2456160,Doors & Loot,2024,Roguelite,"₩13,500",0%,21,0,21,14175000,14,1,15,10125000
2095740,Survivor Of The Journey,2023,Roguelite,"₩4,500",0%,55,28,83,18675000,52,25,77,17325000
640970,In Game Adventure: Legend of Monsters,2017,Roguelite,Free,0%,103,34,137,0,102,34,136,0
326150,Death Skid Marks,2014,Roguelite,Free,0%,706,67,773,0,710,70,780,0
3160500,Kingdom of Cards,2025,Roguelite,"₩13,500",0%,63,14,77,51975000,40,14,54,36450000
616640,B-12,2019,Roguelite,Free,0%,30,7,37,0,30,7,37,0
3339350,Spitfire - Moonpie´s Mission,2025,Roguelite,"₩7,800",0%,44,0,44,17160000,40,1,41,15990000
2369950,Blade of the Netherworld,2024,Roguelite,"₩7,800",0%,122,32,154,60060000,88,31,119,46410000
773540,Boss Crushers,2019,Roguelite,"₩15,500",0%,43,27,70,54250000,30,17,47,36425000
496290,Deep Dark Dungeon,2018,Roguelite,"₩10,500",0%,30,20,50,26250000,22,15,37,19425000
530930,Soulblight,2018,Roguelite,"₩16,000",0%,68,114,182,145600000,25,25,50,40000000
2287150,Revenge of the Mage,2025,Roguelite,"₩6,700",0%,115,20,135,45225000,73,20,93,31155000
1366520,Dungeon Limbus,2021,Roguelite,"₩15,500",0%,12,9,21,16275000,8,8,16,12400000
1162320,AVA: Dark History,2020,Roguelite,"₩2,950",0%,40,12,52,7670000,32,7,39,5752500
368700,Mysterious Space,2015,Roguelite,"₩10,500",0%,21,5,26,13650000,11,3,14,7350000
782570,Endless Road: Reborn,2018,Roguelite,"₩11,500",0%,391,127,518,297850000,317,111,428,246100000
798240,CRYEP,2018,Roguelite,"₩13,500",0%,22,5,27,18225000,15,0,15,10125000
444940,UBERMOSH:BLACK,2016,Roguelite,"₩1,100",0%,306,59,365,20075000,571,85,656,36080000
2560260,Oni Station,2023,Roguelite,"₩5,600",0%,13,2,15,4200000,12,1,13,3640000
1131240,Dungeons of Edera,2022,Roguelite,"₩15,500",0%,714,331,1045,809875000,650,320,970,751750000
343100,Overture,2015,Roguelite,"₩5,500",0%,949,303,1252,344300000,402,164,566,155650000
1582380,Midautumn,2023,Roguelite,"₩25,500",0%,16,5,21,26775000,9,4,13,16575000
917850,Elemental War - A Tower Defense Game,2019,Roguelite,"₩15,500",0%,20,6,26,20150000,16,6,22,17050000
2570710,Let Him Cook,2024,Roguelite,"₩7,800",0%,39,0,39,15210000,32,0,32,12480000
2001670,BURST WITCH,2022,Roguelite,"₩7,500",0%,31,34,65,24375000,31,33,64,24000000
1164480,Killer Gin,2020,Roguelite,"₩15,500",0%,14,3,17,13175000,10,2,12,9300000
663300,Enlightenment,2018,Roguelite,"₩13,000",0%,289,166,455,295750000,224,149,373,242450000
1228970,Elemental Abyss 元素之渊,2020,Roguelite,"₩10,500",0%,19,0,19,9975000,13,0,13,6825000
1719880,Return home,2021,Roguelite,"₩6,500",0%,16,2,18,5850000,10,2,12,3900000
1965620,Battle Waves: Card Tactics,2024,Roguelite,"₩6,700",0%,22,3,25,8375000,11,3,14,4690000
2716270,The Witch's Cauldron Prologue,2023,Roguelite,Free,0%,18,2,20,0,18,2,20,0
1355620,Mage Rage,2022,Roguelite,"₩3,400",0%,16,4,20,3400000,13,4,17,2890000
1251210,Dungeon No Dungeon,2021,Roguelite,"₩7,500",0%,291,211,502,188250000,237,187,424,159000000
1290090,The Wicked Days,2021,Roguelite,"₩20,500",0%,26,7,33,33825000,14,6,20,20500000
1268900,Nearly Dead,2021,Roguelite,"₩26,000",0%,137,147,284,369200000,112,137,249,323700000
483850,Guns N' Boxes,2022,Roguelite,Free,0%,65,19,84,0,65,20,85,0
2884150,Rapture Recovery Squad,2025,Roguelite,"₩5,600",0%,8,1,9,2520000,9,3,12,3360000
1952930,Soul Wargame,2023,Roguelite,"₩8,000",0%,111,22,133,53200000,82,22,104,41600000
2568050,BAR,2025,Roguelite,"₩6,700",0%,14,3,17,5695000,14,5,19,6365000
2955410,Hell Miners,2024,Roguelite,Free,0%,0,0,0,0,12,1,13,0
819520,Star Souls,2020,Roguelite,"₩8,500",0%,29,8,37,15725000,21,7,28,11900000
2884590,Darkchaser: Battletide,2024,Roguelite,"₩6,350",0%,75,18,93,29527500,62,19,81,25717500
1813370,To Carry a Sword,2022,Roguelite,Free,0%,15,2,17,0,17,2,19,0
1826480,Escape Master,2021,Roguelite,Free,0%,0,0,0,0,21,1,22,0
339250,Winged Sakura: Endless Dream,2017,Roguelite,"₩11,000",0%,22,8,30,16500000,21,7,28,15400000
2884590,Darkchaser: Battletide,2024,Roguelite,"₩6,350",0%,75,18,93,29527500,62,19,81,25717500
903780,Beast Agenda 2030,2019,Roguelite,"₩15,500",0%,16,2,18,13950000,8,2,10,7750000
3046050,Dagger Froggy,2024,Roguelite,"₩5,600",0%,50,0,50,14000000,45,1,46,12880000
997710,Ravenland,2021,Roguelite,"₩10,500",0%,10,9,19,9975000,10,9,19,9975000
1232590,DREAMGATE,2020,Roguelite,"₩15,500",0%,69,25,94,72850000,60,24,84,65100000
2107810,Marine Survivors,2022,Roguelite,"₩1,100",0%,20,17,37,2035000,13,15,28,1540000
1813370,To Carry a Sword,2022,Roguelite,Free,0%,15,2,17,0,17,2,19,0
1826480,Escape Master,2021,Roguelite,Free,0%,0,0,0,0,21,1,22,0
970140,Reynard,2019,Roguelite,"₩9,500",0%,28,8,36,17100000,20,7,27,12825000
2109020,Koler,2023,Roguelite,"₩11,000",0%,18,6,24,13200000,16,6,22,12100000
2330870,CD 2: Trap Master,2024,Roguelite,"₩16,500",0%,294,69,363,299475000,257,68,325,268125000
2158130,Deadly Harvest,2022,Roguelite,"₩1,100",0%,32,0,32,1760000,29,0,29,1595000
1452000,"It's Six Random Characters and a Single Floor Dungeon, That's the Whole Game",2020,Roguelite,"₩5,500",0%,12,4,16,4400000,11,4,15,4125000
3813480,Game Tech Simulator,2025,Roguelite,"₩3,400",0%,0,0,0,0,10,1,11,1870000
1950820,Mechabot Defender,2022,Roguelite,"₩4,400",0%,11,1,12,2640000,9,1,10,2200000
536640,Grimm: Dark Legacy,2016,Roguelite,"₩15,500",0%,39,42,81,62775000,29,41,70,54250000
2758280,Boldly Forward,2024,Roguelite,"₩4,500",0%,69,76,145,32625000,63,78,141,31725000
1122830,Atomorf,2019,Roguelite,"₩2,200",0%,19,6,25,2750000,12,2,14,1540000
295870,The Dungeoning,2014,Roguelite,"₩4,400",0%,52,21,73,16060000,45,18,63,13860000
1022710,Conglomerate 451,2020,Roguelite,"₩21,500",0%,155,84,239,256925000,91,51,142,152650000
1146910,Atomorf2,2019,Roguelite,"₩2,200",0%,19,3,22,2420000,13,1,14,1540000
801290,Diabolic,2018,Roguelite,"₩8,900",0%,321,62,383,170435000,255,45,300,133500000
770070,Swords and Sandals 5 Redux: Maximus Edition,2018,Roguelite,"₩7,800",0%,120,70,190,74100000,118,70,188,73320000
772230,跳跃2/LeapII,2019,Roguelite,"₩5,500",0%,14,0,14,3850000,12,0,12,3300000
2118580,SuperTotalCarnage!,2022,Roguelite,"₩3,400",0%,42,28,70,11900000,35,24,59,10030000
2296870,Crimson Connect Origin,2023,Roguelite,"₩6,700",0%,25,22,47,15745000,25,22,47,15745000
1102780,Desert Of The Dead,2019,Roguelite,"₩1,100",0%,296,136,432,23760000,276,119,395,21725000
3437060,Black Fairy Tale,2025,Roguelite,"₩2,300",0%,36,4,40,4600000,34,4,38,4370000
520300,Underworld Dungeon,2017,Roguelite,Free,0%,12,4,16,0,13,4,17,0
770070,Swords and Sandals 5 Redux: Maximus Edition,2018,Roguelite,"₩7,800",0%,120,70,190,74100000,118,70,188,73320000
801290,Diabolic,2018,Roguelite,"₩8,900",0%,321,62,383,170435000,255,45,300,133500000
301840,City of Brass,2018,Roguelite,"₩21,500",0%,637,181,818,879350000,583,174,757,813775000
2333710,不屈者传说 No Give up,2025,Roguelite,"₩5,600",0%,13,5,18,5040000,6,4,10,2800000
548370,Rezrog,2017,Roguelite,"₩11,000",0%,148,180,328,180400000,129,164,293,161150000
1245370,Puzzle Forge Dungeon,2021,Roguelite,"₩11,000",0%,31,11,42,23100000,17,7,24,13200000
1910780,Fray Fight,2022,Roguelite,Free,0%,0,0,0,0,626,220,846,0
1731410,Monastery,2023,Roguelite,"₩17,500",0%,34,2,36,31500000,30,2,32,28000000
1981050,Defiled Survivors,2023,Roguelite,"₩2,300",0%,10,10,20,2300000,7,8,15,1725000
1632140,Girl Agent,2022,Roguelite,"₩3,400",0%,45,6,51,8670000,27,5,32,5440000
2523250,FatalZone: Outbreak,2023,Roguelite,Free,0%,0,0,0,0,223,74,297,0
2088650,Mist Slayer,2023,Roguelite,"₩19,500",0%,254,123,377,367575000,198,106,304,296400000
2077590,Sidestep Legends,2023,Roguelite,"₩5,600",0%,24,10,34,9520000,22,9,31,8680000
1858760,Gem Worlds,2023,Roguelite,"₩5,600",0%,11,0,11,3080000,11,0,11,3080000
1579890,Infinite World:Dice Team,2024,Roguelite,"₩4,500",0%,27,8,35,7875000,28,9,37,8325000
269690,RymdResa,2015,Roguelite,"₩13,500",0%,225,79,304,205200000,158,65,223,150525000
2133440,Pixelmancer,2022,Roguelite,"₩3,400",0%,18,0,18,3060000,12,0,12,2040000
277870,Diehard Dungeon,2014,Roguelite,"₩2,200",0%,368,130,498,54780000,309,114,423,46530000
2973520,Hero's Survival,2024,Roguelite,Free,0%,0,0,0,0,9,2,11,0
1234240,Last Farewell,2022,Roguelite,"₩15,500",0%,54,23,77,59675000,37,14,51,39525000
719180,Revulsion,2019,Roguelite,"₩3,300",0%,59,18,77,12705000,47,18,65,10725000
2184470,South Pole Bebop,2024,Roguelite,Free,0%,39,5,44,0,43,5,48,0
413830,Overdosed - A Trip To Hell,2016,Roguelite,"₩7,500",0%,11,6,17,6375000,8,6,14,5250000
905070,CONTINGENCY,2019,Roguelite,Free,0%,13,1,14,0,13,1,14,0
2134560,9th Sentinel Sisters,2023,Roguelite,"₩5,600",0%,170,72,242,67760000,157,77,234,65520000
403940,Dungelot: Shattered Lands,2016,Roguelite,"₩11,000",0%,429,138,567,311850000,195,83,278,152900000
3023170,Dice Player One: Trailer,2024,Roguelite,Free,0%,0,0,0,0,37,1,38,0
738760,the Line,2017,Roguelite,"₩1,320",70%,21,17,38,2508000,13,10,23,1518000
1403890,SmFly: Gravity Adventure,2020,Roguelite,"₩6,500",0%,17,4,21,6825000,14,1,15,4875000
2386560,Carnage Cuisine,2024,Roguelite,Free,0%,9,4,13,0,11,5,16,0
1926660,OUTLANDER,2022,Roguelite,Free,0%,9,0,9,0,10,0,10,0
1733030,Knights of the Tiny Table,2021,Roguelite,"₩4,400",0%,23,6,29,6380000,15,6,21,4620000
264280,99 Levels To Hell,2014,Roguelite,"₩5,500",0%,367,237,604,166100000,199,139,338,92950000
1168800,Mulite Sword Man,2019,Roguelite,"₩4,500",0%,20,5,25,5625000,11,4,15,3375000
664510,Infernal Racket,2017,Roguelite,"₩8,500",0%,13,6,19,8075000,9,5,14,5950000
766630,Dust and Salt,2018,Roguelite,"₩4,450",50%,62,12,74,16465000,52,12,64,14240000
600610,The Hand of Merlin,2022,Roguelite,"₩28,000",0%,252,99,351,491400000,206,89,295,413000000
1571960,The Corpsmen,2024,Roguelite,"₩20,500",0%,59,37,96,98400000,42,30,72,73800000
481870,Mini Thief,2018,Roguelite,"₩5,600",0%,682,432,1114,311920000,255,115,370,103600000
1387570,Orbitect,2023,Roguelite,"₩11,000",0%,8,4,12,6600000,7,4,11,6050000
1999470,THE LAST HUMAN IS A BIKER,2023,Roguelite,"₩2,300",0%,50,7,57,6555000,22,5,27,3105000
1566090,Malice & Greed,2021,Roguelite,"₩15,500",0%,52,12,64,49600000,41,14,55,42625000
2106170,Super Weapon Master 超级武器大师,2022,Roguelite,"₩4,400",0%,27,8,35,7700000,12,8,20,4400000
2066490,Robot Resistors,2023,Roguelite,"₩1,100",0%,37,11,48,2640000,34,11,45,2475000
686360,Dungeons & Treasure VR,2017,Roguelite,"₩21,500",0%,54,20,74,79550000,40,15,55,59125000
1086840,Operation Sniff,2020,Roguelite,"₩2,200",0%,63,15,78,8580000,24,5,29,3190000
1086840,Operation Sniff,2020,Roguelite,"₩2,200",0%,63,15,78,8580000,24,5,29,3190000
2148060,Hack & Schlitz,2022,Roguelite,"₩2,300",0%,14,0,14,1610000,13,0,13,1495000
542350,Castle of no Escape 2,2016,Roguelite,₩880,84%,333,103,436,19184000,246,86,332,14608000
1100930,Legioncraft,2022,Roguelite,"₩14,500",0%,1082,289,1371,993975000,978,276,1254,909150000
1015190,Double Damnation,2022,Roguelite,Free,0%,0,0,0,0,17,5,22,0
2023500,"Deck of Life: No Turns, Individual Card Permadeath",2023,Roguelite,Free,0%,13,6,19,0,13,6,19,0
2500680,Tiny Chaos,2024,Roguelite,"₩5,600",0%,38,7,45,12600000,31,3,34,9520000
856990,A Long Way Down,2020,Roguelite,"₩18,500",0%,152,75,227,209975000,64,51,115,106375000
931000,"URUZ ""Return of The Er Kishi""",2020,Roguelite,"₩5,600",0%,439,129,568,159040000,407,121,528,147840000
2933930,Tetra Dungeon,2024,Roguelite,"₩5,600",0%,43,3,46,12880000,23,3,26,7280000
2769070,Ultimate Hero,2025,Roguelite,"₩11,000",0%,150,62,212,116600000,113,64,177,97350000
1974560,Blade and Burden,2025,Roguelite,"₩5,020",25%,10,1,11,2761000,10,1,11,2761000
381610,Dandy: Or a Brief Glimpse Into the Life of the Candy Alchemist,2015,Roguelite,"₩10,500",0%,39,12,51,26775000,14,1,15,7875000
1440350,Staff Only,2020,Roguelite,"₩10,500",0%,18,1,19,9975000,10,1,11,5775000
2336730,Dungeon Survivors,2024,Roguelite,"₩5,600",0%,109,48,157,43960000,79,45,124,34720000
1411920,Get Ogre It,2020,Roguelite,"₩10,740",0%,24,5,29,15573000,14,5,19,10203000
1144130,Smash Dungeon,2023,Roguelite,"₩7,800",0%,12,3,15,5850000,11,3,14,5460000
3181670,Periodicity - Hats and scars,2024,Roguelite,"₩5,600",0%,13,2,15,4200000,10,1,11,3080000
2574030,Snake Crush,2024,Roguelite,"₩4,500",0%,106,11,117,26325000,84,11,95,21375000
428430,Endorlight,2016,Roguelite,"₩1,100",0%,924,549,1473,81015000,75,61,136,7480000
2409540,Momon: Relic Seekers,2023,Roguelite,"₩13,500",0%,14,2,16,10800000,10,2,12,8100000
2331080,Taoism,2024,Roguelite,"₩6,700",0%,18,6,24,8040000,13,6,19,6365000
333760,Vintage Year,2015,Roguelite,"₩4,500",0%,82,21,103,23175000,42,5,47,10575000
2353680,Dice World,2023,Roguelite,"₩5,600",0%,13,1,14,3920000,11,1,12,3360000
2107040,Rumple Town,2023,Roguelite,"₩3,400",0%,27,0,27,4590000,24,0,24,4080000
976120,WARPZONE DRIFTER,2018,Roguelite,"₩1,100",0%,82,20,102,5610000,82,22,104,5720000
2759160,Project Jeff,2024,Roguelite,₩550,50%,11,4,15,412500,9,3,12,330000
1907060,Craft Hero - Prologue,2022,Roguelite,Free,0%,151,8,159,0,145,9,154,0
1188970,Ether Loop,2020,Roguelite,"₩12,500",0%,219,94,313,195625000,177,83,260,162500000
328510,Monsters and Monocles,2016,Roguelite,"₩16,000",0%,73,25,98,78400000,37,21,58,46400000
586350,UBERMOSH:WRAITH,2017,Roguelite,"₩1,100",0%,219,29,248,13640000,627,47,674,37070000
358080,No Turning Back: The Pixel Art Action-Adventure Roguelike,2016,Roguelite,"₩3,400",0%,136,119,255,43350000,16,12,28,4760000
1162480,DIMENSION REIGN - ROGUELIKE DECKBUILDER,2020,Roguelite,"₩18,460",45%,159,68,227,209521000,140,63,203,187369000
2531340,OASIS: Tokyo,2023,Roguelite,"₩7,800",0%,37,5,42,16380000,35,5,40,15600000
2343960,巫族 WITCH RACE,2023,Roguelite,"₩4,500",0%,7,4,11,2475000,6,4,10,2250000
3063070,Magical Animal Farm,2025,Roguelite,Free,0%,0,0,0,0,13,7,20,0
2539880,C.A.R.D.S. RPG: The Misty Battlefield,2024,Roguelite,"₩42,000",0%,43,40,83,174300000,35,39,74,155400000
1041450,RRRR2,2019,Roguelite,"₩2,200",0%,17,5,22,2420000,14,1,15,1650000
2236590,Psionic Awake,2025,Roguelite,"₩5,600",0%,129,65,194,54320000,110,64,174,48720000
2628230,Arcane Blast,2024,Roguelite,"₩11,000",0%,35,15,50,27500000,30,14,44,24200000
1335300,The Warlin of Heroes,2020,Roguelite,"₩7,500",0%,17,8,25,9375000,15,7,22,8250000
1007430,SixCubes,2019,Roguelite,"₩2,200",0%,15,5,20,2200000,11,1,12,1320000
454380,Champions of Breakfast,2016,Roguelite,"₩3,400",0%,178,5,183,31110000,115,27,142,24140000
1263070,Blightbound,2021,Roguelite,"₩21,500",0%,803,451,1254,1348050000,596,350,946,1016950000
882220,Mecha-Tokyo Rush,2018,Roguelite,Free,0%,67,23,90,0,66,25,91,0
2689870,Rekindling The Flame,2023,Roguelite,Free,0%,0,0,0,0,17,6,23,0
386100,Pylon: Rogue,2017,Roguelite,"₩16,000",0%,15,7,22,17600000,12,6,18,14400000
453730,Borstal,2016,Roguelite,"₩3,300",0%,27,15,42,6930000,14,10,24,3960000
605920,VOLTED,2018,Roguelite,"₩5,500",0%,136,27,163,44825000,129,23,152,41800000
2434090,Death Roads: Tournament Prologue,2023,Roguelite,Free,0%,30,8,38,0,31,8,39,0
886370,Multicellular,2018,Roguelite,"₩11,000",0%,35,20,55,30250000,29,17,46,25300000
715660,信徒:献祭,2020,Roguelite,"₩8,500",0%,28,10,38,16150000,24,10,34,14450000
1882550,MECH PUNK,2023,Roguelite,"₩5,600",0%,69,22,91,25480000,58,16,74,20720000
463980,Solitairica,2016,Roguelite,"₩10,500",0%,414,125,539,282975000,315,89,404,212100000
2999990,Rogue Tiles,2024,Roguelite,"₩5,600",0%,26,14,40,11200000,25,15,40,11200000
2445870,Fellowship,2023,Roguelite,"₩7,800",0%,10,8,18,7020000,9,6,15,5850000
1063960,Ritual: Spellcasting RPG,2019,Roguelite,"₩10,500",0%,26,4,30,15750000,11,3,14,7350000
577410,The Pit: Infinity,2019,Roguelite,"₩11,000",0%,190,100,290,159500000,148,84,232,127600000
368610,The Enchanted Cave 2,2015,Roguelite,"₩10,500",0%,713,80,793,416325000,620,77,697,365925000
2658030,Clicker Arena,2024,Roguelite,"₩9,400",0%,57,47,104,48880000,50,46,96,45120000
1213390,Starship Inspector,2021,Roguelite,"₩4,400",0%,31,20,51,11220000,25,20,45,9900000
1049220,Naxia,2019,Roguelite,"₩20,500",0%,63,49,112,114800000,53,44,97,99425000
982040,"Don't Die, Minerva!",2019,Roguelite,"₩13,500",0%,56,14,70,47250000,21,10,31,20925000
2324380,Demons Infernalize,2024,Roguelite,Free,0%,33,17,50,0,33,17,50,0
414950,Star Nomad 2,2015,Roguelite,"₩14,000",0%,113,45,158,110600000,95,44,139,97300000
736240,The Revolt: Awakening,2021,Roguelite,"₩12,500",0%,18,0,18,11250000,11,0,11,6875000
356820,Nemo Dungeon,2019,Roguelite,"₩4,900",0%,50,9,59,14455000,20,0,20,4900000
1027650,Supernova Tactics,2022,Roguelite,"₩11,000",0%,13,6,19,10450000,8,6,14,7700000
2395360,Slime Knight,2023,Roguelite,Free,0%,0,0,0,0,21,4,25,0
1146890,MMX,2019,Roguelite,"₩3,300",0%,19,5,24,3960000,12,1,13,2145000
878420,Woodpunk,2018,Roguelite,"₩15,500",0%,122,48,170,131750000,81,38,119,92225000
1277100,Dungeon & Derision,2020,Roguelite,Free,0%,14,1,15,0,13,2,15,0
3424740,Firework War,2025,Roguelite,Free,0%,0,0,0,0,37,2,39,0
2348280,Whispike Survivors - Sword of the Necromancer,2023,Roguelite,"₩3,400",0%,26,13,39,6630000,23,11,34,5780000
3783540,Voden's Job,2025,Roguelite,Free,0%,0,0,0,0,7,3,10,0
3101770,Wander Hero,2024,Roguelite,"₩13,500",0%,87,23,110,74250000,55,22,77,51975000
2323080,Tiny Survivors,2023,Roguelite,Free,0%,0,0,0,0,199,138,337,0
1221630,Drifting in Space,2020,Roguelite,"₩1,100",0%,10,2,12,660000,8,2,10,550000
462100,Starr Mazer: DSP,2016,Roguelite,"₩10,500",0%,193,74,267,140175000,156,73,229,120225000
913590,Dimension Drifter,2018,Roguelite,"₩13,500",0%,42,15,57,38475000,22,6,28,18900000
974370,Chop is dish,2018,Roguelite,"₩6,700",0%,34,18,52,17420000,24,9,33,11055000
3443440,Dungeon Battles,2025,Roguelite,"₩2,300",0%,12,1,13,1495000,11,1,12,1380000
2621160,Battle Wizard Attack,2024,Roguelite,"₩11,000",0%,26,7,33,18150000,23,7,30,16500000
2955960,Brickorium,2024,Roguelite,Free,0%,0,0,0,0,10,0,10,0
1419510,ULTRA LMAD,2023,Roguelite,Free,0%,0,0,0,0,26,7,33,0
2186010,Shapebreaker - Prologue,2023,Roguelite,Free,0%,0,0,0,0,11,5,16,0
3698060,Popit Game,2025,Roguelite,Free,0%,0,0,0,0,17,5,22,0
739220,Ark Noir,2018,Roguelite,"₩10,500",0%,33,12,45,23625000,32,11,43,22575000
1081470,Born of Fire,2019,Roguelite,Free,0%,65,40,105,0,63,41,104,0
919220,Destiny or Fate,2019,Roguelite,"₩5,500",0%,269,209,478,131450000,78,54,132,36300000
1575830,ArcRunner,2023,Roguelite,"₩21,500",0%,161,66,227,244025000,130,58,188,202100000
2073970,Brave Heroes,2022,Roguelite,"₩5,600",0%,16,8,24,6720000,10,6,16,4480000
2161590,Bike Arena,2022,Roguelite,"₩5,600",0%,7,5,12,3360000,7,3,10,2800000
405550,Jet Set Knights,2016,Roguelite,"₩11,000",0%,65,14,79,43450000,39,9,48,26400000
622370,Freaky Awesome,2017,Roguelite,"₩10,500",0%,146,111,257,134925000,114,90,204,107100000
686770,The Wind and Wilting Blossom,2020,Roguelite,"₩11,000",0%,171,10,181,99550000,153,10,163,89650000
998850,Knights of the Card Table,2018,Roguelite,"₩5,220",0%,23,8,31,8091000,16,7,23,6003000
2411560,Debtors' Club,2024,Roguelite,"₩16,000",0%,50,22,72,57600000,39,18,57,45600000
262810,Super Turbo Demon Busters!,2017,Roguelite,"₩12,500",0%,95,80,175,109375000,45,33,78,48750000
2448270,Mars Survivors,2023,Roguelite,"₩5,600",0%,43,22,65,18200000,40,21,61,17080000
2270120,HiveCorp,2025,Roguelite,"₩5,000",0%,33,12,45,11250000,20,14,34,8500000
444470,Moor,2019,Roguelite,"₩16,500",0%,18,6,24,19800000,13,4,17,14025000
1114870,Lenna's Inception,2020,Roguelite,"₩10,500",0%,237,30,267,140175000,215,29,244,128100000
2968260,EvilPunk,2024,Roguelite,"₩5,600",0%,15,7,22,6160000,13,6,19,5320000
345080,Flame Over,2015,Roguelite,"₩13,000",0%,126,46,172,111800000,97,43,140,91000000
1047860,Dunrog,2020,Roguelite,"₩4,500",0%,26,16,42,9450000,11,7,18,4050000
384500,Zombie Party,2016,Roguelite,"₩10,500",0%,582,102,684,359100000,277,78,355,186375000
458700,Cursor Challenge,2016,Roguelite,"₩3,400",0%,24,16,40,6800000,16,10,26,4420000
1619420,Diebrary,2023,Roguelite,"₩5,600",0%,28,12,40,11200000,16,9,25,7000000
1520270,Kyvir: Rebirth,2021,Roguelite,"₩8,500",0%,327,85,412,175100000,274,82,356,151300000
794350,No Captain Allowed!,2022,Roguelite,"₩11,000",0%,14,9,23,12650000,4,6,10,5500000
2555830,Dino Tower Arena,2025,Roguelite,"₩4,500",0%,0,0,0,0,27,0,27,6075000
1133050,"Good Night, Knight",2021,Roguelite,"₩15,500",0%,38,14,52,40300000,32,14,46,35650000
1266430,Lost In Fantaland,2024,Roguelite,"₩14,500",0%,520,77,597,432825000,480,78,558,404550000
851150,Burning Knight,2020,Roguelite,"₩15,500",0%,91,36,127,98425000,67,35,102,79050000
610960,红石遗迹 - Red Obsidian Remnant,2017,Roguelite,"₩6,000",0%,701,133,834,250200000,568,108,676,202800000
973450,Ancient Abyss,2021,Roguelite,"₩15,500",0%,129,62,191,148025000,107,58,165,127875000
1598910,The Excrawlers,2023,Roguelite,"₩4,640",0%,80,10,90,20880000,72,11,83,19256000
1426900,Dread Nautical,2020,Roguelite,"₩20,500",0%,23,9,32,32800000,12,8,20,20500000
1011070,Nomads of the Fallen Star,2019,Roguelite,"₩13,500",0%,26,11,37,24975000,26,11,37,24975000
2444010,Hector The Cat - Treasure Hunter,2023,Roguelite,"₩2,300",0%,13,0,13,1495000,10,0,10,1150000
1347460,Dark Cards,2020,Roguelite,"₩10,500",0%,19,10,29,15225000,16,7,23,12075000
2316950,Monster Battle,2023,Roguelite,Free,0%,0,0,0,0,27,10,37,0
997950,Folding Edge,2020,Roguelite,"₩4,400",0%,17,2,19,4180000,12,2,14,3080000
815290,Guards of the Gate,2019,Roguelite,"₩10,500",0%,28,13,41,21525000,19,10,29,15225000
1219080,Dice Tactics,2021,Roguelite,Free,0%,9,4,13,0,9,4,13,0
1780450,Buggy Game,2022,Roguelite,"₩3,400",0%,19,0,19,3230000,15,0,15,2550000
342550,Phantasmal: Survival Horror Roguelike,2016,Roguelite,Free,0%,153,197,350,0,156,198,354,0
3173250,SKYGUARD,2025,Roguelite,Free,0%,0,0,0,0,16,5,21,0
794780,Pathogen-病原体,2019,Roguelite,"₩7,500",0%,16,5,21,7875000,14,4,18,6750000
1997980,出牌吧冒险家 Go Poker,2024,Roguelite,"₩1,100",0%,16,2,18,990000,14,2,16,880000
756490,Next Hero,2018,Roguelite,"₩10,500",0%,27,20,47,24675000,20,9,29,15225000
434880,Hieroglyphika,2016,Roguelite,"₩11,000",0%,100,55,155,85250000,89,52,141,77550000
1487840,Chess Destroyer,2020,Roguelite,"₩2,300",0%,18,2,20,2300000,13,3,16,1840000
708970,GOD STARFIGHTER,2020,Roguelite,"₩5,600",0%,30,6,36,10080000,29,5,34,9520000
1962560,Grim Horde,2022,Roguelite,"₩3,400",0%,36,33,69,11730000,34,33,67,11390000
1466100,RavenWeald,2022,Roguelite,Free,0%,15,2,17,0,15,2,17,0
1332940,Dungeons of Clay,2020,Roguelite,"₩11,000",0%,13,6,19,10450000,6,4,10,5500000
1508900,MahjongSchool,2021,Roguelite,"₩1,100",0%,56,24,80,4400000,38,18,56,3080000
329770,4089: Ghost Within,2015,Roguelite,"₩6,700",0%,63,41,104,34840000,45,30,75,25125000
1021690,Game Studio Simulator（我要做游戏）,2019,Roguelite,"₩2,200",0%,145,34,179,19690000,115,34,149,16390000
877080,Seeds of Resilience,2019,Roguelite,"₩14,500",0%,250,111,361,261725000,166,89,255,184875000
597040,Dumbass Drivers!,2017,Roguelite,"₩1,100",0%,59,46,105,5775000,51,39,90,4950000
238280,Legend of Dungeon,2013,Roguelite,"₩10,500",0%,1189,437,1626,853650000,873,340,1213,636825000
283040,Paper Dungeons,2015,Roguelite,"₩5,600",0%,47,45,92,25760000,11,13,24,6720000
837400,Fated Kingdom,2019,Roguelite,"₩10,500",0%,225,76,301,158025000,199,66,265,139125000
1055950,Feels,2019,Roguelite,"₩4,400",0%,12,0,12,2640000,11,0,11,2420000
2060670,Sue Shi Survival,2023,Roguelite,"₩5,600",0%,20,4,24,6720000,20,4,24,6720000
1969100,MIGHT'N MOW'EM: CO-OP SURVIVORS ONLINE,2022,Roguelite,"₩3,900",0%,109,63,172,33540000,87,55,142,27690000
1357410,Road Z : The Last Drive,2020,Roguelite,"₩5,600",0%,32,26,58,16240000,15,5,20,5600000
1055950,Feels,2019,Roguelite,"₩4,400",0%,12,0,12,2640000,11,0,11,2420000
1221240,Tavern Cards,2020,Roguelite,"₩32,000",0%,36,20,56,89600000,109,36,145,232000000
1351900,Dungeon Core,2023,Roguelite,"₩12,500",0%,44,10,54,33750000,37,10,47,29375000
1082720,Click Legends,2019,Roguelite,"₩3,300",0%,20,17,37,6105000,20,17,37,6105000
2726350,Super Dash,2025,Roguelite,"₩2,800",50%,12,0,12,1680000,11,0,11,1540000
1980770,Floor44,2023,Roguelite,"₩8,300",0%,88,45,133,55195000,80,37,117,48555000
1177610,Katana Kata,2020,Roguelite,"₩16,500",0%,50,23,73,60225000,43,21,64,52800000
1060160,Not Dead Yet,2020,Roguelite,"₩9,500",0%,29,15,44,20900000,21,13,34,16150000
1371760,Birthright,2020,Roguelite,"₩20,500",0%,9,4,13,13325000,8,5,13,13325000
1440470,Synthetic Hazard,2020,Roguelite,Free,0%,21,13,34,0,22,13,35,0
1563820,Inside My Mind,2021,Roguelite,"₩10,500",0%,20,7,27,14175000,16,1,17,8925000
2294330,LastRo,2023,Roguelite,Free,0%,0,0,0,0,19,1,20,0
2150910,Spellcats: Auto Card Tactics,2024,Roguelite,"₩11,000",0%,31,14,45,24750000,16,12,28,15400000
1579100,Dungeon and Gravestone,2021,Roguelite,"₩26,000",0%,8,6,14,18200000,7,6,13,16900000
2100200,Idle Zombies Clicker,2022,Roguelite,"₩1,100",0%,11,9,20,1100000,8,6,14,770000
2286110,Hyper Pop,2023,Roguelite,Free,0%,19,11,30,0,20,11,31,0
911550,Din's Legacy,2019,Roguelite,"₩21,500",0%,143,43,186,199950000,131,41,172,184900000
1920650,Contrablade: Stadium Rush,2022,Roguelite,"₩2,640",19%,30,12,42,5544000,27,13,40,5280000
803850,Pixelpunk XL,2018,Roguelite,"₩4,400",0%,34,14,48,10560000,23,11,34,7480000
921710,Galaxy Squad,2019,Roguelite,"₩11,000",0%,318,105,423,232650000,284,94,378,207900000
731420,Roguebreaker,2018,Roguelite,"₩1,100",0%,32,6,38,2090000,20,6,26,1430000
1221230,Derange,2020,Roguelite,"₩5,600",0%,38,19,57,15960000,26,18,44,12320000
1209520,Smart Moves,2020,Roguelite,"₩5,600",0%,14,0,14,3920000,13,0,13,3640000
431840,3DRPG,2016,Roguelite,"₩2,300",0%,158,98,256,29440000,105,56,161,18515000
947290,Arkane Rush,2018,Roguelite,"₩3,400",0%,22,13,35,5950000,22,12,34,5780000
947290,Arkane Rush,2018,Roguelite,"₩3,400",0%,22,13,35,5950000,22,12,34,5780000
431840,3DRPG,2016,Roguelite,"₩2,300",0%,158,98,256,29440000,105,56,161,18515000
527990,Gladiator Trainer,2016,Roguelite,"₩2,300",0%,195,78,273,31395000,173,61,234,26910000
1679360,CTRL Phreak,2024,Roguelite,"₩5,600",0%,26,0,26,7280000,24,0,24,6720000
1812970,Immortal Tactics: War of the Eternals,2022,Roguelite,"₩15,500",0%,82,16,98,75950000,61,16,77,59675000
880870,Donut Arena,2022,Roguelite,"₩5,600",0%,17,0,17,4760000,13,0,13,3640000
3218090,Off Trail,2024,Roguelite,Free,0%,42,5,47,0,43,5,48,0
2195650,Lucky Island,2024,Roguelite,"₩11,000",0%,11,5,16,8800000,7,5,12,6600000
1520420,The Hopebringer,2024,Roguelite,₩780,86%,10,6,16,624000,6,4,10,390000
516030,Insane Robots,2018,Roguelite,"₩20,500",0%,20,4,24,24600000,14,4,18,18450000
833180,Spaceship Commander,2018,Roguelite,"₩11,000",0%,17,9,26,14300000,13,6,19,10450000
1689090,CITY WARS: TOKYO REIGN,2022,Roguelite,"₩13,500",0%,22,9,31,20925000,15,8,23,15525000
1188430,"Deep, In the  Forest",2020,Roguelite,"₩9,900",0%,40,20,60,29700000,25,19,44,21780000
504300,Gangs of Space,2017,Roguelite,Free,0%,321,103,424,0,319,106,425,0
2853180,Seal the Rift,2024,Roguelite,"₩15,500",0%,18,8,26,20150000,16,8,24,18600000
508650,Signal Decay,2019,Roguelite,"₩15,000",0%,53,12,65,48750000,15,10,25,18750000
372080,Kramora's Shadow,2017,Roguelite,"₩5,500",0%,47,10,57,15675000,34,6,40,11000000
453960,Envy the Dead,2016,Roguelite,"₩3,400",0%,156,78,234,39780000,116,57,173,29410000
654660,Pharmakon - Tactical Puzzle,2017,Roguelite,"₩4,400",0%,14,11,25,5500000,7,10,17,3740000
827220,Overclocked: The Aclockalypse,2018,Roguelite,Free,0%,38,16,54,0,39,17,56,0
2369880,Dungeon Survival,2023,Roguelite,"₩4,500",0%,14,8,22,4950000,14,8,22,4950000
2261750,Towers Deck,2023,Roguelite,"₩11,000",0%,30,10,40,22000000,20,9,29,15950000
2147050,Jumping Cat,2023,Roguelite,"₩3,400",0%,44,17,61,10370000,26,12,38,6460000
801210,Spellsword Cards: Demontide,2019,Roguelite,"₩6,700",0%,52,29,81,27135000,47,30,77,25795000
408960,Zombasite,2016,Roguelite,"₩21,500",0%,151,49,200,215000000,139,44,183,196725000
2959310,Warlords of the Deck,2024,Roguelite,"₩8,900",0%,48,8,56,24920000,41,12,53,23585000
801210,Spellsword Cards: Demontide,2019,Roguelite,"₩6,700",0%,52,29,81,27135000,47,30,77,25795000
408960,Zombasite,2016,Roguelite,"₩21,500",0%,151,49,200,215000000,139,44,183,196725000
508410,SKIPCHASER,2018,Roguelite,"₩5,600",0%,51,24,75,21000000,29,15,44,12320000
1015140,10 Miles To Safety,2020,Roguelite,"₩10,500",0%,711,267,978,513450000,630,233,863,453075000
427910,Zavix Tower,2016,Roguelite,"₩10,500",0%,250,93,343,180075000,108,64,172,90300000
2403940,AutoHeroes,2024,Roguelite,"₩2,800",50%,13,10,23,3220000,8,10,18,2520000
3438900,Azazel Gamble 阿撒兹勒赌局,2025,Roguelite,"₩11,000",0%,29,1,30,16500000,21,2,23,12650000
269490,Bardbarian,2014,Roguelite,"₩8,500",0%,1324,171,1495,635375000,688,77,765,325125000
841320,Whitevale Defender,2018,Roguelite,"₩5,500",0%,10,4,14,3850000,9,4,13,3575000
227580,"10,000,000",2013,Roguelite,"₩5,500",0%,2076,227,2303,633325000,1587,176,1763,484825000
421140,Blades of the Righteous,2016,Roguelite,"₩3,300",0%,17,10,27,4455000,9,5,14,2310000
1004560,Everpath,2019,Roguelite,"₩3,300",0%,53,25,78,12870000,44,23,67,11055000
874030,To the Core,2018,Roguelite,Free,0%,159,77,236,0,157,78,235,0
2112200,古巫竞技场 Ancient Witch Arena,2022,Roguelite,"₩3,300",0%,62,24,86,14190000,49,24,73,12045000
3094740,Second Rate Superheroes,2024,Roguelite,"₩5,600",0%,25,6,31,8680000,22,7,29,8120000
1770810,Mines of Frostheim,2021,Roguelite,Free,0%,0,0,0,0,23,6,29,0
973070,Bound By Blades,2022,Roguelite,"₩12,500",0%,111,23,134,83750000,66,19,85,53125000
317610,Prophour23,2014,Roguelite,"₩10,500",0%,52,23,75,39375000,13,9,22,11550000
778410,Dead Ground,2018,Roguelite,"₩5,600",0%,69,43,112,31360000,24,20,44,12320000
656700,RICO,2019,Roguelite,"₩20,500",0%,342,182,524,537100000,252,161,413,423325000
364300,Space Rogue,2016,Roguelite,"₩10,500",0%,289,159,448,235200000,239,152,391,205275000
458660,The Slimeking's Tower,2021,Roguelite,Free,0%,203,73,276,0,204,71,275,0
1568030,Too Many Cooks,2023,Roguelite,"₩5,600",0%,18,0,18,5040000,15,0,15,4200000
3044180,Farm Debt Repay Life:Prologue,2024,Roguelite,Free,0%,0,0,0,0,9,6,15,0
3044180,Farm Debt Repay Life:Prologue,2024,Roguelite,Free,0%,0,0,0,0,9,6,15,0
2151580,Infinite Tao,2023,Roguelite,"₩4,500",0%,688,175,863,194175000,663,176,839,188775000
2003640,Village Heroes,2024,Roguelite,Free,0%,0,0,0,0,72,53,125,0
369110,The Swindle,2015,Roguelite,"₩16,000",0%,390,223,613,490400000,307,181,488,390400000
3194220,Horror Simulator VR: Prologue,2024,Roguelite,Free,0%,6,5,11,0,8,5,13,0
2662810,Dungeon Minesweeper,2024,Roguelite,"₩7,640",0%,14,12,26,9932000,6,6,12,4584000
296010,NeonXSZ,2016,Roguelite,"₩10,500",0%,89,23,112,58800000,68,23,91,47775000
1796950,戦国の木こり,2021,Roguelite,Free,0%,0,0,0,0,19,8,27,0
1419070,Mython Island,2022,Roguelite,"₩11,000",0%,32,9,41,22550000,25,9,34,18700000
255070,Abyss Odyssey,2014,Roguelite,"₩6,200",60%,1576,937,2513,779030000,846,416,1262,391220000
1994960,Survive 10 Minutes Please,2022,Roguelite,Free,0%,18,1,19,0,18,2,20,0
3492360,Agent Dunoz,2025,Roguelite,"₩4,500",0%,12,0,12,2700000,13,2,15,3375000
1344210,Mysteries Of Darkness,2022,Roguelite,"₩5,500",0%,13,1,14,3850000,12,1,13,3575000
1714080,---Red---Tether-->,2022,Roguelite,"₩14,500",0%,77,1,78,56550000,67,1,68,49300000
489260,Brut@l,2017,Roguelite,"₩16,000",0%,117,39,156,124800000,94,28,122,97600000
2304190,Deep Death Dungeon Darkness,2023,Roguelite,"₩13,500",0%,7,4,11,7425000,7,4,11,7425000
1321010,Labyrinth Legend,2020,Roguelite,"₩4,500",40%,41,7,48,10800000,38,5,43,9675000
2615010,Necromantic,2024,Roguelite,"₩7,800",0%,73,45,118,46020000,63,42,105,40950000
653210,Prisoner,2017,Roguelite,"₩3,400",0%,22,17,39,6630000,8,7,15,2550000
209330,A Valley Without Wind,2012,Roguelite,"₩16,500",0%,307,202,509,419925000,122,72,194,160050000
689700,Mad Crown,2018,Roguelite,"₩10,500",0%,119,30,149,78225000,88,28,116,60900000
1039350,StoneTide: Age of Pirates,2020,Roguelite,"₩10,500",0%,28,14,42,22050000,25,13,38,19950000
1955120,Nemire,2024,Roguelite,"₩7,800",0%,15,5,20,7800000,11,5,16,6240000
335830,Distant Star: Revenant Fleet,2015,Roguelite,"₩10,500",0%,194,101,295,154875000,162,95,257,134925000
1221990,Chronicle: Unit Eight,2020,Roguelite,"₩15,500",0%,33,7,40,31000000,14,7,21,16275000
1221990,Chronicle: Unit Eight,2020,Roguelite,"₩15,500",0%,33,7,40,31000000,14,7,21,16275000
2306530,Reign of the Renegade,2023,Roguelite,"₩5,600",0%,59,7,66,18480000,60,7,67,18760000
2858110,Meme Christmas,2024,Roguelite,"₩1,100",0%,19,1,20,1100000,16,0,16,880000
1022010,Oliver's Adventures in the Fairyland,2019,Roguelite,"₩5,500",0%,33,6,39,10725000,29,6,35,9625000
759160,Dungeons & Vampires,2018,Roguelite,"₩3,400",0%,38,34,72,12240000,14,17,31,5270000
374240,Eternal Step,2015,Roguelite,"₩10,500",0%,49,26,75,39375000,20,13,33,17325000
1363210,Live by the Sword: Tactics,2022,Roguelite,"₩16,500",0%,50,20,70,57750000,33,19,52,42900000
2055470,Neko Loop,2022,Roguelite,"₩21,500",0%,24,2,26,27950000,17,1,18,19350000
1955640,Mystical Map,2024,Roguelite,"₩4,500",0%,14,3,17,3825000,12,2,14,3150000
816990,Dead Dust,2018,Roguelite,"₩11,500",0%,53,24,77,44275000,23,8,31,17825000
860660,To Hell with Hell,2020,Roguelite,"₩17,500",0%,56,28,84,73500000,18,19,37,32375000
1093320,Devil's Deck,2022,Roguelite,"₩15,500",0%,187,95,282,218550000,139,78,217,168175000
906740,Voidship: The Long Journey,2019,Roguelite,"₩11,500",0%,109,38,147,84525000,69,32,101,58075000
1665200,Printersim,2021,Roguelite,"₩6,700",0%,22,0,22,7370000,19,0,19,6365000
944120,Abalyte,2018,Roguelite,Free,0%,131,66,197,0,130,67,197,0
1314170,dungeon & heros,2021,Roguelite,"₩6,500",0%,39,13,52,16900000,30,10,40,13000000
2013080,Unders_core,2022,Roguelite,"₩12,500",0%,16,8,24,15000000,15,8,23,14375000
2816710,The Backrooms: Unseen Tapes,2024,Roguelite,"₩1,100",0%,14,5,19,1045000,5,5,10,550000
951430,Dead Age 2: The Zombie Survival RPG,2021,Roguelite,"₩2,920",85%,957,293,1250,182500000,825,261,1086,158556000
2849230,Mask Around,2024,Roguelite,"₩8,900",0%,14,0,14,6230000,14,0,14,6230000
1163560,SuperEpic: The Entertainment War,2019,Roguelite,"₩18,500",0%,72,33,105,97125000,57,25,82,75850000
1711740,Cheftastic!: Buffet Blast,2022,Roguelite,Free,0%,24,0,24,0,25,0,25,0
2202690,Gladiators and Glory,2023,Roguelite,"₩8,900",0%,51,7,58,25810000,49,6,55,24475000
1052080,Resistance is Fruitile,2019,Roguelite,"₩5,360",0%,17,0,17,4556000,10,0,10,2680000
1080060,Axan Ships - Low Poly,2019,Roguelite,Free,0%,10,6,16,0,10,6,16,0
907270,eSports Legend,2018,Roguelite,"₩10,500",0%,746,452,1198,628950000,625,399,1024,537600000
1080060,Axan Ships - Low Poly,2019,Roguelite,Free,0%,10,6,16,0,10,6,16,0
253630,Steam Marines,2014,Roguelite,"₩20,500",0%,166,166,332,340300000,114,106,220,225500000
698110,Reficul VR,2018,Roguelite,"₩20,500",0%,18,10,28,28700000,10,7,17,17425000
369560,The Story Goes On,2018,Roguelite,"₩5,500",0%,102,26,128,35200000,38,16,54,14850000
2496160,Rebel!,2024,Roguelite,Free,0%,14,1,15,0,16,1,17,0
884260,Akane,2018,Roguelite,"₩5,500",0%,2664,125,2789,766975000,0,0,0,0
1551730,Place for Hero,2021,Roguelite,Free,0%,0,0,0,0,12,3,15,0
2160380,Dragonspire,2023,Roguelite,"₩5,600",0%,43,30,73,20440000,35,26,61,17080000
3209020,cr4ckr,2024,Roguelite,Free,0%,7,6,13,0,9,6,15,0
418150,The Madness of Little Emma,2015,Roguelite,"₩9,900",0%,115,29,144,71280000,94,30,124,61380000
2185190,Pumpkin Ripper,2022,Roguelite,"₩3,400",0%,28,3,31,5270000,10,2,12,2040000
1341220,BlackJack Math,2020,Roguelite,"₩1,100",0%,82,14,96,5280000,60,10,70,3850000
1289490,Dungeon Solver,2020,Roguelite,"₩1,100",0%,33,13,46,2530000,26,13,39,2145000
1009350,Keepers Dungeon,2019,Roguelite,"₩4,400",0%,12,1,13,2860000,9,1,10,2200000
1858240,Samurai war era Hunter,2022,Roguelite,Free,0%,8,11,19,0,8,11,19,0
1372430,Spells and Fellas,2022,Roguelite,Free,0%,25,11,36,0,25,12,37,0
2492410,Bootleg Steamer,2024,Roguelite,"₩16,500",0%,23,7,30,24750000,14,7,21,17325000
979800,Haxity,2020,Roguelite,Free,0%,66,19,85,0,65,20,85,0
2876860,Emberdrift,2024,Roguelite,"₩16,500",0%,18,0,18,14850000,15,0,15,12375000
1525490,异世界攻略组 Another World Adventure,2021,Roguelite,"₩6,500",0%,57,16,73,23725000,44,16,60,19500000
531960,Bloody Walls,2016,Roguelite,Free,0%,1140,299,1439,0,1155,307,1462,0
3120880,Food Fight Fiesta: Multi-Use Cards,2025,Roguelite,"₩11,000",0%,16,0,16,8800000,16,0,16,8800000
228320,A Valley Without Wind 2,2012,Roguelite,"₩16,500",0%,102,121,223,183975000,52,59,111,91575000
265990,Rogue's Tale,2014,Roguelite,"₩7,800",0%,517,201,718,280020000,450,167,617,240630000
3676260,Hordelord,2025,Roguelite,"₩5,040",9%,0,0,0,0,10,1,11,2772000
1252710,Cardaclysm,2021,Roguelite,"₩16,500",0%,359,185,544,448800000,256,150,406,334950000
575840,NeverEnd,2017,Roguelite,"₩2,300",0%,63,63,126,14490000,18,8,26,2990000
1465190,古代人生 Ancient Life,2021,Roguelite,"₩5,500",0%,72,78,150,41250000,69,82,151,41525000
1234840,Bone Marrow,2020,Roguelite,"₩6,700",0%,35,17,52,17420000,29,14,43,14405000
2436190,Survivors Will,2023,Roguelite,"₩2,300",0%,11,8,19,2185000,7,7,14,1610000
297210,Famaze,2014,Roguelite,Free,0%,305,77,382,0,310,87,397,0
3174160,Paws and Whiskers,2025,Roguelite,"₩9,900",0%,34,5,39,19305000,19,5,24,11880000
1554970,Rogue Spirit,2023,Roguelite,"₩22,000",0%,135,30,165,181500000,87,28,115,126500000
1797510,Tower of the Sage,2022,Roguelite,"₩1,100",0%,13,6,19,1045000,8,5,13,715000
2292810,ETERNAL DREAMERS -RISING-,2024,Roguelite,"₩1,100",0%,14,0,14,770000,13,0,13,715000
693800,Loco Parentis / 孤女咒怨,2019,Roguelite,"₩13,500",0%,279,235,514,346950000,202,194,396,267300000
1368060,dead run,2020,Roguelite,"₩3,300",0%,9,14,23,3795000,9,13,22,3630000
1303870,Mischance,2021,Roguelite,"₩5,500",0%,11,3,14,3850000,8,3,11,3025000
420790,StarBreak,2016,Roguelite,Free,0%,1009,270,1279,0,1003,283,1286,0
501950,Rogue Islands,2017,Roguelite,Free,0%,65,30,95,0,65,30,95,0
1149400,The Yellow King,2020,Roguelite,"₩9,900",0%,106,112,218,107910000,92,103,195,96525000
1906150,Pixel Trouble,2022,Roguelite,"₩5,500",0%,13,2,15,4125000,10,1,11,3025000
996370,Watch Me Stream My Mental Breakdown,2021,Roguelite,"₩16,500",0%,40,8,48,39600000,18,8,26,21450000
2553840,"Blood, Fuel, Ammo & Speed",2024,Roguelite,"₩11,000",0%,39,6,45,24750000,31,6,37,20350000
269310,Infectonator: Survivors,2016,Roguelite,"₩11,000",0%,742,361,1103,606650000,640,315,955,525250000
1133890,P1R4T3S,2020,Roguelite,"₩10,500",0%,5,6,11,5775000,4,6,10,5250000
2265760,Chosun Zombie Defense,2023,Roguelite,"₩20,500",0%,0,0,0,0,0,0,0,0
1740010,Undead Menace,2021,Roguelite,"₩5,500",0%,6,3,9,2475000,11,2,13,3575000
3449900,Slime Squisher,2025,Roguelite,"₩5,600",0%,4,0,4,1120000,0,0,0,0
3094800,Risk the Dark,2025,Roguelite,"₩10,900",0%,6,0,6,3270000,0,0,0,0
3886190,Magic Cat,2025,Roguelite,"₩5,600",0%,0,0,0,0,0,0,0,0
2452100,Nephilim,2023,Roguelite,"₩18,500",0%,8,7,15,13875000,5,8,13,12025000
3199890,Ô,2025,Roguelite,"₩9,900",0%,0,0,0,0,0,0,0,0
2638210,Brave and Desire,2024,Roguelite,"₩13,500",0%,8,15,23,15525000,8,15,23,15525000
3786930,Seoul Exorcist 1111,2025,Roguelite,"₩19,500",0%,0,0,0,0,0,0,0,0
3644520,Yogoe Hunter,2025,Roguelite,"₩16,500",0%,0,0,0,0,0,0,0,0
3092280,Guardians Of Restoration,2025,Roguelite,"₩11,000",0%,1,0,1,550000,0,0,0,0
1201910,Cook Dungeon,2019,Roguelite,"₩2,300",0%,7,15,22,2530000,7,13,20,2300000
2527600,The Detective Reaper Invites,2024,Roguelite,"₩11,000",0%,39,35,74,40700000,22,34,56,30800000
1051060,Cookie Invaders,2020,Roguelite,"₩16,500",0%,5,2,7,5775000,0,0,0,0
1240530,Dungeon Warriors,2020,Roguelite,"₩3,300",0%,8,9,17,2805000,5,9,14,2310000
1492870,堕星之乱,2021,Roguelite,"₩1,100",0%,15,8,23,1265000,5,8,13,715000
1455130,Number One Rich,2020,Roguelite,"₩6,700",0%,7,12,19,6365000,7,11,18,6030000
314290,Obludia,2014,Roguelite,"₩3,400",0%,35,38,73,12410000,9,15,24,4080000
2866960,Wizlite: Everybody loved RPGs,2024,Roguelite,"₩20,920",25%,10,23,33,34518000,10,24,34,35564000
3061690,Bee Hero: Bug Blaster,2025,Roguelite,"₩16,500",0%,0,0,0,0,0,0,0,0
514410,Gun Brothers,2020,Roguelite,"₩9,300",0%,34,59,93,43245000,20,53,73,33945000
2503890,Bloodecay,2023,Roguelite,"₩3,400",0%,19,30,49,8330000,19,29,48,8160000
3310900,Dungeon Tracer,2025,Roguelite,"₩4,760",15%,0,0,0,0,0,0,0,0
3652900,Later Elevator,2025,Roguelite,"₩4,500",0%,0,0,0,0,0,0,0,0
424060,The Glow,2015,Roguelite,"₩4,400",0%,8,16,24,5280000,4,11,15,3300000
3159770,Beggar to Emperor,2025,Roguelite,"₩16,500",0%,0,0,0,0,0,0,0,0
3149430,Poker Train,2024,Roguelite,Free,0%,0,0,0,0,4,16,20,0
2416920,Groob,2023,Roguelite,"₩2,300",0%,4,7,11,1265000,3,7,10,1150000
1101980,白石洲往事,2019,Roguelite,"₩6,700",0%,16,41,57,19095000,11,36,47,15745000
2752250,Survival Odyssey,2024,Roguelite,"₩9,000",0%,27,18,45,20250000,8,13,21,9450000
3842300,Hell Builder,2025,Roguelite,"₩4,480",19%,0,0,0,0,0,0,0,0
340030,Dungeon of gain,2016,Roguelite,"₩5,600",0%,20,59,79,22120000,14,32,46,12880000
1913940,Underground Dungeon,2022,Roguelite,"₩3,300",0%,8,1,9,1485000,0,0,0,0
1934520,Auto Cast,2023,Roguelite,"₩4,500",0%,4,9,13,2925000,2,9,11,2475000
461400,Massive,2020,Roguelite,"₩9,300",0%,71,33,104,48360000,13,30,43,19995000
1145740,In Search of a Home,2019,Roguelite,"₩1,100",0%,5,10,15,825000,5,10,15,825000
3408690,Soul Cards,2025,Roguelite,"₩5,600",0%,0,0,0,0,0,0,0,0
3157550,Rogumon,2025,Roguelite,"₩3,400",0%,0,0,0,0,0,0,0,0
3565670,Mythic Trials 2,2025,Roguelite,"₩2,300",0%,0,0,0,0,0,0,0,0
1408730,KindFolx,2025,Roguelite,"₩16,500",0%,0,0,0,0,0,0,0,0
3357880,Tower defense for virus,2024,Roguelite,₩640,72%,0,0,0,0,0,0,0,0
3722810,Elliot's Great Symphony,2025,Roguelite,"₩3,400",0%,0,0,0,0,0,0,0,0
2958670,NUNNA,2024,Roguelite,"₩1,100",0%,6,2,8,440000,0,0,0,0
3623660,PalWar,2025,Roguelite,"₩2,300",0%,15,2,17,1955000,0,0,0,0
3030290,Submarine Survivor,2024,Roguelite,"₩5,600",0%,3,0,3,840000,0,0,0,0
2550350,Slime Siege,2024,Roguelite,"₩15,500",0%,0,0,0,0,0,0,0,0
667170,Undead Souls,2020,Roguelite,"₩20,500",0%,1,10,11,11275000,1,10,11,11275000
2895040,Demon's Regalia: Colosseum,2025,Roguelite,"₩11,000",0%,0,0,0,0,0,0,0,0
3138020,Quantum of Hope,2024,Roguelite,"₩1,350",70%,2,0,2,135000,0,0,0,0
3867530,Way to Town,2025,Roguelite,"₩2,300",0%,0,0,0,0,0,0,0,0
315320,Skilltree Saga,2014,Roguelite,"₩11,000",0%,62,129,191,105050000,25,40,65,35750000
1774200,Abeyance,2022,Roguelite,"₩20,500",0%,5,3,8,8200000,0,0,0,0
2714910,Stratum Descent,2024,Roguelite,"₩5,600",0%,7,1,8,2240000,0,0,0,0
3781740,Vanquish Evil,2025,Roguelite,"₩3,400",0%,0,0,0,0,0,0,0,0
1116350,Exsys,2025,Roguelite,"₩9,900",0%,1,2,3,1485000,0,0,0,0
2521530,Damocles Gaze,2023,Roguelite,"₩6,700",0%,5,1,6,2010000,0,0,0,0
2557640,Ronshade,2023,Roguelite,"₩1,100",0%,2,0,2,110000,0,0,0,0
3456970,Death Kid,2025,Roguelite,"₩11,000",0%,17,1,18,9900000,0,0,0,0
924020,Spellrune: Realm of Portals,2018,Roguelite,"₩10,500",0%,12,31,43,22575000,11,31,42,22050000
1945850,Dark ill 暗黑蛊国,2022,Roguelite,"₩6,500",0%,8,11,19,6175000,2,9,11,3575000
3828730,Cross and Gun,2025,Roguelite,"₩5,020",25%,0,0,0,0,0,0,0,0
1062530,Obsidian Crown,2019,Roguelite,"₩2,200",0%,1,1,2,220000,0,0,0,0
1941140,Outcasts of Dungeon:Epic Magic World Fight Rogue Game Simulator,2023,Roguelite,"₩5,600",0%,0,2,2,560000,0,0,0,0
1054640,The Tower of Worth,2019,Roguelite,"₩7,500",0%,8,3,11,4125000,0,0,0,0
2972770,Highway Hijinks,2024,Roguelite,"₩6,700",0%,6,1,7,2345000,0,0,0,0
1964500,The Battle of Sacred Heart,2024,Roguelite,"₩7,800",0%,3,10,13,5070000,2,10,12,4680000
2337710,The Last Survivors,2023,Roguelite,"₩5,600",0%,4,3,7,1960000,0,0,0,0
3800860,Shield Hero,2025,Roguelite,"₩4,500",0%,0,0,0,0,0,0,0,0
3243710,KOTARO Survivor,2025,Roguelite,"₩4,500",0%,0,0,0,0,0,0,0,0
1406490,Quester,2022,Roguelite,"₩10,500",0%,6,0,6,3150000,0,0,0,0
2706880,Lost Pages: Classic,2024,Roguelite,"₩9,900",0%,4,0,4,1980000,0,0,0,0
2308890,Sliding Swords,2023,Roguelite,"₩4,500",0%,1,0,1,225000,0,0,0,0
2571350,Soul of War: Legions,2023,Roguelite,"₩2,300",0%,117,46,163,18745000,0,0,0,0
2818830,Ghost Ascension,2024,Roguelite,"₩1,100",0%,6,0,6,330000,0,0,0,0
3836140,Yggdrasil Defenders,2025,Roguelite,"₩8,900",0%,0,0,0,0,0,0,0,0
3204720,Veilwalkers,2025,Roguelite,"₩8,900",0%,0,0,0,0,0,0,0,0
1170840,Pamp Quest,2020,Roguelite,"₩3,400",0%,7,1,8,1360000,0,0,0,0
1738680,The Dark Tower,2025,Roguelite,"₩6,000",0%,6,0,6,1800000,0,0,0,0
2560250,Observer,2023,Roguelite,"₩4,500",0%,0,0,0,0,0,0,0,0
1012360,Gunslugs : Rogue Tactics,2019,Roguelite,"₩16,500",0%,8,3,11,9075000,0,0,0,0
945500,Steel Dungeon 钢铁地牢,2018,Roguelite,"₩4,400",0%,10,2,12,2640000,0,0,0,0
678870,EatWell,2017,Roguelite,"₩2,200",0%,21,0,21,2310000,0,0,0,0
2682910,The Spellswapper,2023,Roguelite,"₩5,600",0%,4,0,4,1120000,0,0,0,0
1880310,Oogy: Can You Help,2022,Roguelite,"₩20,500",0%,2,1,3,3075000,0,0,0,0
645240,Costumenaut,2017,Roguelite,"₩5,500",0%,7,0,7,1925000,0,0,0,0
3600730,Desktop Standing Card Plates,2025,Roguelite,₩550,50%,8,0,8,220000,0,0,0,0
1539710,DeadBlitZ,2024,Roguelite,"₩27,000",0%,4,0,4,5400000,0,0,0,0
3707610,Delirium: Echoes of the Domino,2025,Roguelite,"₩9,900",0%,0,0,0,0,0,0,0,0
3669050,Void Resurgence,2025,Roguelite,"₩2,720",19%,0,0,0,0,0,0,0,0
2117190,Spliced,2022,Roguelite,"₩7,500",0%,4,0,4,1500000,0,0,0,0
3054470,Rogue Zodiacs,2025,Roguelite,"₩21,500",0%,6,0,6,6450000,0,0,0,0
3091830,Space Duck: Escape,2024,Roguelite,"₩11,000",0%,3,0,3,1650000,0,0,0,0
2519900,The Ten Soul,2024,Roguelite,"₩4,500",0%,0,0,0,0,0,0,0,0
3139930,VTBattle-VTubers aren't about the number of subscribers! It's about power!,2024,Roguelite,"₩9,900",0%,10,0,10,4950000,0,0,0,0
2202720,Enemy at the Gates:The Invincible Sword,2022,Roguelite,"₩3,400",0%,2,0,2,340000,0,0,0,0
2259380,Backroom,2024,Roguelite,"₩3,400",0%,1,4,5,850000,0,0,0,0
2202720,Enemy at the Gates:The Invincible Sword,2022,Roguelite,"₩3,400",0%,2,0,2,340000,0,0,0,0
3830500,工地四重奏,2025,Roguelite,"₩4,500",0%,0,0,0,0,0,0,0,0
3348710,Freeky Faucets Arcade,2025,Roguelite,"₩5,600",0%,8,0,8,2240000,0,0,0,0
3298910,Once a Pawn a King,2025,Roguelite,"₩10,800",19%,0,0,0,0,0,0,0,0
3041130,BUILD SCRAP,2025,Roguelite,"₩7,700",30%,0,0,0,0,0,0,0,0
1465560,Against All Odds,2023,Roguelite,"₩5,600",0%,160,90,250,70000000,0,0,0,0
3067390,Pirates Slayer,2024,Roguelite,"₩56,000",0%,95,5,100,280000000,0,0,0,0
3692890,Border Overload,2025,Roguelite,"₩1,100",0%,0,0,0,0,0,0,0,0
3665740,Hope Town,2025,Roguelite,"₩5,900",0%,0,0,0,0,0,0,0,0
3348510,Tower Arena Survive,2025,Roguelite,"₩5,600",0%,0,0,0,0,0,0,0,0
1909260,Looping Bravery,2022,Roguelite,"₩2,520",55%,13,0,13,1638000,0,0,0,0
3757110,Guardian Grids 2,2025,Roguelite,"₩6,700",0%,0,0,0,0,0,0,0,0
2266980,Cyber Strider,2023,Roguelite,"₩5,600",0%,2,0,2,560000,0,0,0,0
3365400,Dungeon Mana,2025,Roguelite,"₩3,400",0%,5,1,6,1020000,0,0,0,0
1948150,Moonphase Pass,2022,Roguelite,"₩8,500",0%,4,1,5,2125000,0,0,0,0
3280340,Ohjata,2025,Roguelite,"₩4,500",0%,4,0,4,900000,0,0,0,0
251590,Soul Saga,2020,Roguelite,"₩15,500",0%,12,37,49,37975000,12,24,36,27900000
3846410,Protocol Aegirum,2025,Roguelite,"₩2,300",0%,0,0,0,0,0,0,0,0
3601900,Sepulcrum,2025,Roguelite,"₩8,900",0%,0,0,0,0,0,0,0,0
1824070,Rejoinder,2022,Roguelite,"₩5,500",0%,3,2,5,1375000,0,0,0,0
3194600,Disaster Blaster,2025,Roguelite,"₩10,790",0%,9,0,9,4855500,0,0,0,0
2224260,Bloody Heaven,2023,Roguelite,"₩8,900",0%,9,2,11,4895000,0,0,0,0
2669390,Night Feeder,2024,Roguelite,"₩4,500",0%,5,0,5,1125000,0,0,0,0
3266800,EndSeeker,2025,Roguelite,"₩6,700",0%,0,0,0,0,0,0,0,0
1706270,Go Run a Dungeon,2022,Roguelite,"₩16,500",0%,0,2,2,1650000,0,0,0,0
2795760,Duck Dash,2024,Roguelite,"₩2,300",0%,2,1,3,345000,0,0,0,0
1934660,Super Trunko Go,2023,Roguelite,"₩9,900",0%,9,0,9,4455000,0,0,0,0
2959110,Tiny Pixels Vol. 1 - Ninpo Blast,2024,Roguelite,"₩5,600",0%,6,0,6,1680000,0,0,0,0
3395850,Foepower,2025,Roguelite,"₩6,700",0%,6,3,9,3015000,0,0,0,0
2529460,Lonely Turret 2,2023,Roguelite,"₩4,500",0%,4,0,4,900000,0,0,0,0
862490,Fantasy Raiders,2018,Roguelite,"₩15,000",0%,10,4,14,10500000,0,0,0,0
3504430,Soulglass,2025,Roguelite,"₩5,600",0%,0,0,0,0,0,0,0,0
3255480,Riverside of Dice,2024,Roguelite,"₩5,600",0%,3,0,3,840000,0,0,0,0
3330180,RANDOBOUNCE,2025,Roguelite,"₩5,600",0%,0,0,0,0,0,0,0,0
3397340,break.up,2025,Roguelite,"₩4,500",0%,4,0,4,900000,0,0,0,0
1777380,Bullet Grinder,2021,Roguelite,"₩5,500",0%,4,3,7,1925000,0,0,0,0
3139270,Dice with the Devil,2024,Roguelite,"₩5,600",0%,8,0,8,2240000,0,0,0,0
3449870,Heart Keeper,2025,Roguelite,"₩5,600",0%,3,0,3,840000,0,0,0,0
3792060,Bushido Kensei The Last Warrior,2025,Roguelite,"₩7,800",0%,0,0,0,0,0,0,0,0
1352470,Carrot Heart,2022,Roguelite,"₩8,500",0%,8,2,10,4250000,0,0,0,0
2490090,Keep Killing,2023,Roguelite,"₩1,100",0%,2,0,2,110000,0,0,0,0
2163230,Witch Guild Survivor,2023,Roguelite,"₩4,500",0%,3,0,3,675000,0,0,0,0
1230840,Matcha Warriors,2020,Roguelite,"₩8,500",0%,3,0,3,1275000,0,0,0,0
3122720,Defiance Survivors,2024,Roguelite,"₩2,700",0%,2,0,2,270000,0,0,0,0
1408310,Monster Legend,2020,Roguelite,"₩6,500",0%,4,4,8,2600000,0,0,0,0
1780340,Cyber Runner 2048,2021,Roguelite,"₩5,500",0%,3,2,5,1375000,0,0,0,0
1707630,Dungeon Conqueror,2022,Roguelite,"₩4,500",0%,1,0,1,225000,0,0,0,0
2632650,Daemon Sigil,2024,Roguelite,"₩11,000",0%,4,0,4,2200000,0,0,0,0
3696180,Lost World Survivor,2025,Roguelite,"₩5,600",0%,0,0,0,0,0,0,0,0
1673470,Finding A Prince: The Game,2021,Roguelite,"₩5,500",0%,7,1,8,2200000,0,0,0,0
1973840,Space Bees 太空蜜蜂,2022,Roguelite,"₩2,200",0%,8,2,10,1100000,0,0,0,0
3142630,Blazing Balls,2024,Roguelite,"₩5,500",0%,5,0,5,1375000,0,0,0,0
3354080,EggsNeverHurt,2024,Roguelite,"₩1,100",0%,0,0,0,0,0,0,0,0
1253320,Seconds in Space,2020,Roguelite,"₩8,500",0%,1,0,1,425000,0,0,0,0
3243720,Cast Dice Away,2024,Roguelite,"₩3,400",0%,4,0,4,680000,0,0,0,0
2716600,Mystic Labyrinth,2024,Roguelite,"₩3,400",0%,2,0,2,340000,0,0,0,0
2092000,Calamity Sanctuary,2024,Roguelite,"₩3,400",0%,0,0,0,0,0,0,0,0
3733680,Survive the Descent,2025,Roguelite,"₩4,500",0%,0,0,0,0,0,0,0,0
3030490,Direction!LevelUP!,2024,Roguelite,"₩2,300",0%,13,0,13,1495000,0,0,0,0
2796290,Beater: Apocal Undone,2024,Roguelite,"₩11,000",0%,2,1,3,1650000,0,0,0,0
2822640,CrabbleUp,2024,Roguelite,"₩11,000",0%,1,0,1,550000,0,0,0,0
2122080,Last Second,2022,Roguelite,"₩3,300",0%,1,0,1,165000,0,0,0,0
2822640,CrabbleUp,2024,Roguelite,"₩11,000",0%,1,0,1,550000,0,0,0,0
3674790,Russian Survivors,2025,Roguelite,Unknown,0%,0,0,0,0,0,0,0,0
2612670,Iglacia,2023,Roguelite,"₩3,400",0%,1,0,1,170000,0,0,0,0
3580650,ArcanaTris,2025,Roguelite,"₩12,500",0%,0,0,0,0,0,0,0,0
1864830,Emblem of Valor,2025,Roguelite,"₩7,800",0%,13,1,14,5460000,0,0,0,0
2227520,Hookscrap,2023,Roguelite,"₩1,100",0%,5,0,5,275000,0,0,0,0
2764870,Geometry Survivor [0],2024,Roguelite,"₩5,600",0%,6,0,6,1680000,0,0,0,0
3604960,Legacy of Shadows 影の遺産,2025,Roguelite,"₩9,900",0%,0,0,0,0,0,0,0,0
2454480,只因兄弟(BroChicken),2023,Roguelite,"₩4,500",0%,12,2,14,3150000,0,0,0,0
3617460,Will Jump,2025,Roguelite,"₩8,900",0%,2,0,2,890000,0,0,0,0
2557510,Disciples of Varahces,2024,Roguelite,"₩5,600",0%,1,0,1,280000,0,0,0,0
1863170,From Dusk To Dawn,2022,Roguelite,"₩7,800",0%,5,3,8,3120000,0,0,0,0
3062080,Vault,2025,Roguelite,"₩6,700",0%,6,0,6,2010000,0,0,0,0
2137680,RKR - Rush Kill Repeat,2022,Roguelite,"₩3,400",0%,2,0,2,340000,0,0,0,0
3436570,No Room For Error,2025,Roguelite,"₩2,300",0%,6,0,6,690000,0,0,0,0
1751700,Dungeon Arsenal,2021,Roguelite,"₩4,500",0%,7,0,7,1575000,0,0,0,0
1475250,Tiny Strife,2020,Roguelite,"₩4,500",0%,2,0,2,450000,0,0,0,0
2152300,Litha and the Sunhouse,2024,Roguelite,"₩16,500",0%,6,2,8,6600000,0,0,0,0
2258790,Activate: 激活,2023,Roguelite,"₩2,300",0%,3,1,4,460000,0,0,0,0
3781380,Operation Ninurta - Eris Portal,2025,Roguelite,"₩13,500",0%,0,0,0,0,0,0,0,0
3648550,Your Magic Hook,2025,Roguelite,"₩3,400",0%,0,0,0,0,0,0,0,0
3112050,J-Room,2024,Roguelite,"₩4,500",0%,0,1,1,225000,0,0,0,0
3350910,The Fourth Anno,2025,Roguelite,"₩3,400",0%,3,0,3,510000,0,0,0,0
3539690,Bomb Around,2025,Roguelite,"₩5,600",0%,6,1,7,1960000,0,0,0,0
2810380,EnGaCho Dreamy Butterfly,2024,Roguelite,"₩7,800",0%,0,0,0,0,0,0,0,0
3350910,The Fourth Anno,2025,Roguelite,"₩3,400",0%,3,0,3,510000,0,0,0,0
2347460,Survival Sprint,2023,Roguelite,"₩4,500",0%,3,2,5,1125000,0,0,0,0
2174370,Slugmania,2023,Roguelite,"₩2,300",0%,2,0,2,230000,0,0,0,0
2951940,Annuit Coeptis,2024,Roguelite,"₩11,000",0%,2,1,3,1650000,0,0,0,0
3368480,Pest Control in the Crypt,2025,Roguelite,"₩3,400",0%,1,0,1,170000,0,0,0,0
1930350,Fallen Worlds,2025,Roguelite,"₩21,500",0%,5,1,6,6450000,0,0,0,0
1214130,Jumplord,2020,Roguelite,"₩8,500",0%,2,0,2,850000,0,0,0,0
3155780,The Valley: XuGu,2024,Roguelite,"₩7,800",0%,17,3,20,7800000,0,0,0,0
3055550,Security Simulator: Nightshift,2024,Roguelite,"₩8,900",0%,3,0,3,1335000,0,0,0,0
3246080,Day Day Up,2024,Roguelite,"₩2,300",0%,0,0,0,0,0,0,0,0
2471350,Balloons,2023,Roguelite,"₩5,600",0%,1,0,1,280000,0,0,0,0
2793210,Bestiary Survivors,2024,Roguelite,"₩7,800",0%,2,3,5,1950000,0,0,0,0
2774300,BlockArena,2024,Roguelite,"₩4,500",0%,1,0,1,225000,0,0,0,0
2347460,Survival Sprint,2023,Roguelite,"₩4,500",0%,3,2,5,1125000,0,0,0,0
3624800,Momenta,2025,Roguelite,"₩3,400",0%,0,0,0,0,0,0,0,0
3156110,Tribe of Werewolves,2025,Roguelite,"₩3,400",0%,3,1,4,680000,0,0,0,0
1269540,Slash Roll,2020,Roguelite,"₩3,300",0%,6,2,8,1320000,0,0,0,0
1979990,Galactic Escape,2023,Roguelite,"₩11,000",0%,3,0,3,1650000,0,0,0,0
884630,Golden Fall,2019,Roguelite,"₩2,300",0%,3,0,3,345000,0,0,0,0
1707410,Aspect,2022,Roguelite,"₩5,500",0%,8,0,8,2200000,0,0,0,0
1550400,Rocket Cave Adventure,2024,Roguelite,"₩5,600",0%,4,0,4,1120000,0,0,0,0
1829250,The Wizardz Dungeon,2022,Roguelite,"₩2,130",0%,1,0,1,106500,0,0,0,0
1914770,TumbleWeed,2022,Roguelite,"₩3,300",0%,8,0,8,1320000,0,0,0,0
1491480,Grave Complex,2021,Roguelite,"₩10,500",0%,1,0,1,525000,0,0,0,0
1829250,The Wizardz Dungeon,2022,Roguelite,"₩2,130",0%,1,0,1,106500,0,0,0,0
1653860,Battle Rollers,2021,Roguelite,"₩5,600",0%,2,0,2,560000,0,0,0,0
3764530,Vulcard,2025,Roguelite,"₩13,500",0%,0,0,0,0,0,0,0,0
3402160,Prisoners of Ulag'Bol: A Dungeon Crawling Deckbuilder,2025,Roguelite,"₩11,000",0%,3,0,3,1650000,0,0,0,0
1622980,Fire Sale,2021,Roguelite,"₩5,500",0%,0,0,0,0,0,0,0,0
3178880,GirlsStrage,2024,Roguelite,"₩21,500",0%,0,3,3,3225000,0,0,0,0
3376550,4X4 PROGRESS,2025,Roguelite,"₩6,700",0%,2,0,2,670000,0,0,0,0
1576300,Dr Iwan: Evolution,2021,Roguelite,"₩7,500",0%,5,2,7,2625000,0,0,0,0
3613790,Pixel Ronin,2025,Roguelite,"₩3,400",0%,0,0,0,0,0,0,0,0
1545880,Herman Electro,2021,Roguelite,"₩5,600",0%,5,0,5,1400000,0,0,0,0
3006990,Life of Kanji Island,2024,Roguelite,"₩13,620",0%,0,2,2,1362000,0,0,0,0
3167610,Deck of Destiny: Battleforge,2025,Roguelite,"₩3,300",40%,0,0,0,0,0,0,0,0
1578540,A Night Before the Deadline,2021,Roguelite,"₩4,400",0%,14,3,17,3740000,0,0,0,0
3183930,Far Flight,2024,Roguelite,"₩5,600",0%,0,0,0,0,0,0,0,0
3537930,Mobocalypse,2025,Roguelite,"₩5,600",0%,2,1,3,840000,0,0,0,0
3480320,Ax Roguelike,2025,Roguelite,"₩5,600",0%,0,0,0,0,0,0,0,0
2681340,Four Hunters Survivor,2023,Roguelite,"₩1,100",0%,1,1,2,110000,0,0,0,0
1447260,Mystical Echoes,2020,Roguelite,"₩5,500",0%,0,0,0,0,0,0,0,0
2696310,Last Castle Guardians,2024,Roguelite,"₩2,300",0%,1,0,1,115000,0,0,0,0
2804020,Rogue Gladius Survivors,2024,Roguelite,"₩5,600",0%,10,0,10,2800000,0,0,0,0
2542080,Shoot & Sow,2024,Roguelite,"₩5,600",0%,8,0,8,2240000,0,0,0,0
1014200,Markerboard Jungle: Frogs,2022,Roguelite,Unknown,0%,0,1,1,0,0,0,0,0
3737960,Planets Ambrosia,2025,Roguelite,"₩4,500",0%,0,0,0,0,0,0,0,0
2726830,The Otter Ways,2024,Roguelite,"₩5,600",0%,5,1,6,1680000,0,0,0,0
1836390,BLANK SPACE,2022,Roguelite,"₩16,500",0%,4,3,7,5775000,0,0,0,0
2726830,The Otter Ways,2024,Roguelite,"₩5,600",0%,5,1,6,1680000,0,0,0,0
3363570,Symphorix,2025,Roguelite,"₩6,000",0%,0,0,0,0,0,0,0,0
2368570,Bomb Bomb Bomb,2023,Roguelite,"₩7,800",0%,0,0,0,0,0,0,0,0
2607730,Leave Panda Away,2023,Roguelite,Free,0%,4,5,9,0,0,0,0,0
2643090,CyVenge,2023,Roguelite,Free,0%,8,0,8,0,0,0,0,0
3405340,Megabonk,2025,Roguelite,Unknown,0%,0,0,0,0,0,0,0,0
1429260,Robot Rogue,2020,Roguelite,"₩1,100",0%,0,0,0,0,0,0,0,0
3634700,Moonlit Reaper,2025,Roguelite,"₩8,900",0%,4,0,4,1780000,0,0,0,0
1973620,Go To Heck,2022,Roguelite,"₩5,500",0%,2,0,2,550000,0,0,0,0
3026000,Broken Space Traveler,2024,Roguelite,"₩5,600",0%,8,1,9,2520000,0,0,0,0
3363570,Symphorix,2025,Roguelite,"₩6,000",0%,0,0,0,0,0,0,0,0
1388940,城塞騎士/Jousai-kishi,2020,Roguelite,"₩4,400",0%,0,0,0,0,0,0,0,0
1969420,The Struggle of Combat,2022,Roguelite,"₩5,600",0%,11,1,12,3360000,0,0,0,0
2718470,Gems Of Evolution,2025,Roguelite,"₩1,100",0%,6,2,8,440000,0,0,0,0
2948870,Ant Attack,2024,Roguelite,"₩1,100",0%,4,2,6,330000,0,0,0,0
1302310,Pursuit of the Bookkeeper,2020,Roguelite,"₩5,500",0%,0,0,0,0,0,0,0,0
3405340,Megabonk,2025,Roguelite,Unknown,0%,0,0,0,0,0,0,0,0
2385800,A Good Place To Die,2024,Roguelite,"₩2,300",0%,2,2,4,460000,0,0,0,0
3885240,HEGGO,2025,Roguelite,Free,0%,0,0,0,0,0,0,0,0
3150150,Survivor Alliance,2024,Roguelite,"₩1,100",0%,2,2,4,220000,0,0,0,0
2548400,FLOAT,2023,Roguelite,₩980,60%,6,0,6,294000,0,0,0,0
3545210,Tribute of Minos,2025,Roguelite,"₩6,700",0%,1,0,1,335000,0,0,0,0
1404800,Juicy Army,2021,Roguelite,"₩10,500",0%,2,0,2,1050000,0,0,0,0
3349010,Space Escape,2024,Roguelite,"₩3,400",0%,6,1,7,1190000,0,0,0,0
1308980,Dungeon Throne,2020,Roguelite,"₩4,400",0%,7,1,8,1760000,0,0,0,0
2119390,Discvivors,2022,Roguelite,"₩3,300",0%,4,0,4,660000,0,0,0,0
3241680,云梦之音 The Melody of Yunmeng,2024,Roguelite,"₩3,400",0%,1,0,1,170000,0,0,0,0
2820120,Ultimate Shifumi Championship,2024,Roguelite,"₩2,300",0%,1,0,1,115000,0,0,0,0
2452370,A Shadow Cast on Water,2023,Roguelite,"₩4,500",0%,1,0,1,225000,0,0,0,0
3303180,Sweet Slaughter,2025,Roguelite,"₩11,000",0%,0,0,0,0,0,0,0,0
1058510,Zunius,2019,Roguelite,"₩3,400",0%,11,1,12,2040000,0,0,0,0
2460210,Hazy Monochrome Wand,2023,Roguelite,"₩5,600",0%,4,0,4,1120000,0,0,0,0
2473830,Endless Dreamland,2024,Roguelite,"₩1,100",0%,2,0,2,110000,0,0,0,0
3377900,Dice Clash World,2025,Roguelite,"₩11,000",0%,3,0,3,1650000,0,0,0,0
3396810,Gulls of Doom,2025,Roguelite,Unknown,0%,0,0,0,0,0,0,0,0
2998060,Mental Math Madness,2024,Roguelite,"₩1,100",0%,0,1,1,55000,0,0,0,0
3484590,Sea of Dreams Survivors,2025,Roguelite,"₩4,500",0%,0,0,0,0,0,0,0,0
2883490,Gladiatory,2024,Roguelite,"₩3,400",0%,0,2,2,340000,0,0,0,0
3270320,Zero Line,2025,Roguelite,"₩1,100",0%,0,1,1,55000,0,0,0,0
3176790,Tesserarii: The Dice Rolling Roguelike,2025,Roguelite,"₩8,900",0%,3,0,3,1335000,0,0,0,0
2724140,SUS,2024,Roguelite,"₩1,100",0%,2,1,3,165000,0,0,0,0
545840,Convicted Galaxy,2017,Roguelite,"₩15,500",0%,4,0,4,3100000,0,0,0,0
3277650,FIENDRISE,2025,Roguelite,"₩4,500",0%,7,0,7,1575000,0,0,0,0
3292920,Lucky Hand: Roguelike Deck Builder,2025,Roguelite,"₩8,900",0%,1,1,2,890000,0,0,0,0
3347610,DreamBreaker,2025,Roguelite,"₩11,000",0%,0,0,0,0,0,0,0,0
1361630,Grandpurrents,2020,Roguelite,"₩6,500",0%,0,0,0,0,0,0,0,0
3715390,Star Gun,2025,Roguelite,"₩13,500",0%,0,0,0,0,0,0,0,0
3449860,Charta Dungeon - Ambidextrous,2025,Roguelite,"₩4,500",0%,4,1,5,1125000,0,0,0,0
1778200,Minigunner®,2023,Roguelite,"₩11,000",0%,12,0,12,6600000,0,0,0,0
958110,尸毒来袭 - Zombie Virus Attack,2023,Roguelite,"₩2,300",0%,7,1,8,920000,0,0,0,0
2694890,ANNIHILATOR,2023,Roguelite,"₩2,300",0%,0,0,0,0,0,0,0,0
2472740,Chains of the Goddess,2023,Roguelite,"₩1,100",0%,5,1,6,330000,0,0,0,0
2411660,Magic Machine Gun,2023,Roguelite,"₩4,500",0%,3,1,4,900000,0,0,0,0
1778200,Minigunner®,2023,Roguelite,"₩11,000",0%,12,0,12,6600000,0,0,0,0
3713210,BATTLE SHADOW ARENA,2025,Roguelite,"₩5,600",0%,0,0,0,0,0,0,0,0
2776980,Breath,2024,Roguelite,"₩1,100",0%,0,1,1,55000,0,0,0,0
2301690,Vagrant Knight,2023,Roguelite,"₩5,600",0%,0,0,0,0,0,0,0,0
2118550,FastRogue,2022,Roguelite,"₩6,690",0%,1,1,2,669000,0,0,0,0
2699540,Bearly Delivered,2025,Roguelite,"₩5,590",0%,6,0,6,1677000,0,0,0,0
3332000,Fallen Depths,2024,Roguelite,"₩5,600",0%,9,0,9,2520000,0,0,0,0
2999820,Highland Huntress,2024,Roguelite,"₩3,400",0%,0,0,0,0,0,0,0,0
2571290,Golf Odyssey 2 DX,2023,Roguelite,"₩7,800",0%,6,1,7,2730000,0,0,0,0
2899930,Lonely tiny spaceship,2025,Roguelite,"₩2,250",50%,5,2,7,787500,0,0,0,0
3304430,Vasrak Kingdom: Battle on the frontier,2025,Roguelite,"₩4,900",0%,8,0,8,1960000,0,0,0,0
2905120,Spaceborne Survivors,2024,Roguelite,"₩3,400",0%,2,0,2,340000,0,0,0,0
1202830,Cyberception,2020,Roguelite,"₩11,500",0%,1,1,2,1150000,0,0,0,0
867010,Adventure Delivery Service,2018,Roguelite,"₩1,100",0%,12,4,16,880000,0,0,0,0
2623650,Poly Survivor,2023,Roguelite,"₩2,300",0%,1,0,1,115000,0,0,0,0
3210160,16BitSurvivors,2025,Roguelite,"₩5,000",0%,4,1,5,1250000,0,0,0,0
2124560,Jump Journey,2022,Roguelite,"₩1,100",0%,1,1,2,110000,0,0,0,0
2310200,Blood 'N Bullets,2023,Roguelite,"₩2,300",0%,4,0,4,460000,0,0,0,0
3259190,Dead Dawg Delivery Co.,2024,Roguelite,"₩11,000",0%,0,4,4,2200000,0,0,0,0
2084260,Magefall,2022,Roguelite,"₩4,500",0%,1,0,1,225000,0,0,0,0
2694960,Omnimancer,2024,Roguelite,"₩5,490",0%,0,0,0,0,0,0,0,0
3232250,MoveFort,2024,Roguelite,"₩3,400",0%,0,0,0,0,0,0,0,0
3160450,Toward aliens and beyond,2025,Roguelite,₩880,19%,0,1,1,44000,0,0,0,0
3452290,Borrowed Thyme,2025,Roguelite,"₩2,300",0%,0,0,0,0,0,0,0,0
2623650,Poly Survivor,2023,Roguelite,"₩2,300",0%,1,0,1,115000,0,0,0,0
1904480,Absolum,2025,Roguelite,Unknown,0%,0,0,0,0,0,0,0,0
2954640,Outbreak Survivors,2024,Roguelite,"₩2,300",0%,0,1,1,115000,0,0,0,0
1902350,Polar Bear Riding A Ninja,2022,Roguelite,"₩2,300",0%,10,0,10,1150000,0,0,0,0
2846100,Crystal Guard TD,2024,Roguelite,"₩1,100",0%,0,2,2,110000,0,0,0,0
2720540,陨铁山 Falling Mountains,2024,Roguelite,"₩2,650",66%,1,0,1,132500,0,0,0,0
2927520,Tower of Nod,2024,Roguelite,"₩5,600",0%,3,0,3,840000,0,0,0,0
3221000,Fengdu Chronicles of battle,2024,Roguelite,"₩8,900",0%,9,3,12,5340000,0,0,0,0
2671550,Spellz: Mastery or Death,2023,Roguelite,"₩14,500",0%,10,0,10,7250000,0,0,0,0
2427220,Tyrannical Chickens,2024,Roguelite,"₩1,100",0%,1,0,1,55000,0,0,0,0
1245730,Chuck Meowrris,2020,Roguelite,Free,0%,5,0,5,0,0,0,0,0
2738910,Horde Survivor,2025,Roguelite,"₩4,500",0%,0,2,2,450000,0,0,0,0
971530,VoidGate,2022,Roguelite,"₩4,500",0%,4,3,7,1575000,0,0,0,0
2353840,A Storm Unsung,2024,Roguelite,"₩11,000",0%,2,0,2,1100000,0,0,0,0
2333840,Simple Arcade,2023,Roguelite,"₩1,200",0%,2,0,2,120000,0,0,0,0
3566990,Sports Adventure：5 in 1,2025,Roguelite,"₩4,500",0%,0,0,0,0,0,0,0,0
2132190,Capoeirogue,2022,Roguelite,"₩32,000",0%,9,0,9,14400000,0,0,0,0
2353840,A Storm Unsung,2024,Roguelite,"₩11,000",0%,2,0,2,1100000,0,0,0,0
2333840,Simple Arcade,2023,Roguelite,"₩1,200",0%,2,0,2,120000,0,0,0,0
2788000,Broadside Renegades,2024,Roguelite,"₩5,600",0%,9,0,9,2520000,0,0,0,0
2753200,My Grandparent's House,2024,Roguelite,"₩5,600",0%,7,3,10,2800000,0,0,0,0
3810920,Glazed Mirror : Myriad Cards,2025,Roguelite,"₩4,500",0%,0,0,0,0,0,0,0,0
2353800,Shapes & Shots - Prologue,2023,Roguelite,Free,0%,0,0,0,0,0,0,0,0
2058170,Haunted Places,2022,Roguelite,"₩1,150",89%,2,7,9,517500,0,0,0,0
843590,GhostGame,2019,Roguelite,"₩8,500",0%,28,0,28,11900000,0,0,0,0
912070,DESERT KILL,2019,Roguelite,"₩2,800",50%,16,3,19,2660000,0,0,0,0
2175040,Loser's Romance,2022,Roguelite,"₩11,000",0%,5,0,5,2750000,0,0,0,0
2332680,Pporite,2023,Roguelite,"₩2,300",0%,4,1,5,575000,0,0,0,0
2150840,Hearthkeeper,2024,Roguelite,"₩3,400",0%,1,1,2,340000,0,0,0,0
2701310,Shuffled Sky,2024,Roguelite,"₩19,500",0%,2,0,2,1950000,0,0,0,0
1197100,Red Mercenary,2020,Roguelite,"₩12,500",0%,7,4,11,6875000,0,0,0,0
3412230,Kaiju Evolution Survivor,2025,Roguelite,"₩5,600",0%,1,1,2,560000,0,0,0,0
1351980,2945VR,2020,Roguelite,"₩6,500",0%,3,2,5,1625000,0,0,0,0
610710,Sea Of Secrets,2025,Roguelite,"₩5,600",0%,0,0,0,0,0,0,0,0
726450,Hero's Descent,2021,Roguelite,Free,0%,7,0,7,0,0,0,0,0
2897840,Explorer: Adventure Awaits,2024,Roguelite,"₩8,900",0%,0,0,0,0,0,0,0,0
2471060,DIVINE SHOCK,2023,Roguelite,"₩5,000",0%,21,1,22,5500000,0,0,0,0
2913310,Void Mother: Survivor,2024,Roguelite,"₩5,000",0%,1,0,1,250000,0,0,0,0
2471060,DIVINE SHOCK,2023,Roguelite,"₩5,000",0%,21,1,22,5500000,0,0,0,0
610710,Sea Of Secrets,2025,Roguelite,"₩5,600",0%,0,0,0,0,0,0,0,0
3219990,Nebula Strike,2025,Roguelite,"₩4,500",0%,0,0,0,0,0,0,0,0
3135900,Dawn of Survivor,2024,Roguelite,"₩3,400",0%,0,1,1,170000,0,0,0,0
2374410,My Hero After the Fall,2023,Roguelite,"₩6,700",0%,11,2,13,4355000,0,0,0,0
1399910,Crisis Arcana,2020,Roguelite,"₩3,300",0%,3,0,3,495000,0,0,0,0
2759640,Oddment,2024,Roguelite,"₩6,700",0%,3,2,5,1675000,0,0,0,0
745680,Lovehammer 400 000: The Buttlerian Crusade,2023,Roguelite,"₩11,000",0%,3,4,7,3850000,0,0,0,0
867470,Albedon Wars,2019,Roguelite,"₩26,000",0%,6,1,7,9100000,0,0,0,0
1277480,The Shepherd,2022,Roguelite,"₩11,500",0%,5,1,6,3450000,0,0,0,0
1793680,The Holy Chalice,2022,Roguelite,"₩3,300",0%,3,0,3,495000,0,0,0,0
2067910,What The Fortress!?,2022,Roguelite,"₩5,500",0%,4,4,8,2200000,0,0,0,0
1983450,Brave Builder Construct A Climb,2022,Roguelite,"₩5,500",0%,1,0,1,275000,0,0,0,0
1709660,Archie,2021,Roguelite,"₩2,200",0%,2,1,3,330000,0,0,0,0
1029220,Terraforming Earth,2020,Roguelite,"₩11,000",0%,24,1,25,13750000,0,0,0,0
3151530,ChessRogue,2024,Roguelite,"₩1,100",0%,3,0,3,165000,0,0,0,0
1915430,Idylls of the Lunar Maria,2024,Roguelite,"₩9,900",0%,8,0,8,3960000,0,0,0,0
3399880,Wisterix,2025,Roguelite,"₩3,400",0%,0,0,0,0,0,0,0,0
3014930,Wave Defense: Trappist,2025,Roguelite,"₩11,000",0%,1,0,1,550000,0,0,0,0
2742500,Beetle Nest,2024,Roguelite,"₩16,500",0%,6,0,6,4950000,0,0,0,0
2909360,Beat in Zero,2024,Roguelite,"₩11,000",0%,6,3,9,4950000,0,0,0,0
2783860,Rogue Dimensions,2024,Roguelite,"₩5,600",0%,0,0,0,0,0,0,0,0
737660,The Deepest House,2019,Roguelite,"₩8,500",0%,1,0,1,425000,0,0,0,0
3383020,Ghostbreaker Corps,2025,Roguelite,"₩1,100",0%,6,0,6,330000,0,0,0,0
1109170,Happy Grumps,2020,Roguelite,"₩11,000",0%,5,0,5,2750000,0,0,0,0
3907500,Gran Theft Lure,2025,Roguelite,Unknown,0%,0,0,0,0,0,0,0,0
1338920,Space Fat: To the Core,2020,Roguelite,"₩1,100",0%,1,1,2,110000,0,0,0,0
2085870,Land of chaos,2022,Roguelite,"₩2,900",0%,0,2,2,290000,0,0,0,0
3301870,Hydra Hide Land,2025,Roguelite,"₩3,400",0%,3,0,3,510000,0,0,0,0
2543990,Solar War,2025,Roguelite,"₩8,900",0%,0,0,0,0,0,0,0,0
2870470,Troy: The Soldier,2024,Roguelite,Free,0%,5,0,5,0,0,0,0,0
3858270,Poligons,2025,Roguelite,"₩3,400",0%,0,0,0,0,0,0,0,0
1017650,It's a Long Way,2019,Roguelite,"₩5,600",0%,5,0,5,1400000,0,0,0,0
1426340,Super Dream-Weaver,2023,Roguelite,"₩5,600",0%,0,1,1,280000,0,0,0,0
2501400,Let's Fight!  Box,2023,Roguelite,"₩1,100",0%,1,0,1,55000,0,0,0,0
1688710,Stop the Blight,2025,Roguelite,"₩14,500",0%,3,2,5,3625000,0,0,0,0
2324670,Police Heroes,2023,Roguelite,"₩3,400",0%,1,0,1,170000,0,0,0,0
3140250,ViCrew,2025,Roguelite,"₩15,500",0%,8,0,8,6200000,0,0,0,0
1017650,It's a Long Way,2019,Roguelite,"₩5,600",0%,5,0,5,1400000,0,0,0,0
2233830,Bit Oz -Wonder Crusher-,2023,Roguelite,"₩14,500",0%,1,0,1,725000,0,0,0,0
2435710,I HATE (other) Animals!,2023,Roguelite,"₩1,100",0%,1,1,2,110000,0,0,0,0
2233830,Bit Oz -Wonder Crusher-,2023,Roguelite,"₩14,500",0%,1,0,1,725000,0,0,0,0
2435710,I HATE (other) Animals!,2023,Roguelite,"₩1,100",0%,1,1,2,110000,0,0,0,0
1588500,Rogue Sweeper,2023,Roguelite,"₩6,700",0%,2,1,3,1005000,0,0,0,0
3645070,Monkey King: Five Elements Survival,2025,Roguelite,"₩2,300",0%,0,0,0,0,0,0,0,0
2972830,FlameProtector-SlidingKill,2024,Roguelite,"₩1,100",0%,0,0,0,0,0,0,0,0
3363240,かいがらの夢,2024,Roguelite,"₩4,290",0%,1,1,2,429000,0,0,0,0
2443250,Urgent Message,2025,Roguelite,"₩1,100",0%,9,0,9,495000,0,0,0,0
3331170,Pagoda,2025,Roguelite,"₩3,400",0%,0,0,0,0,0,0,0,0
3725620,cozycult,2025,Roguelite,"₩1,100",0%,0,0,0,0,0,0,0,0
2391640,Binding of Elements,2024,Roguelite,"₩7,800",0%,10,1,11,4290000,0,0,0,0
1960650,Dash Around Madly,2022,Roguelite,"₩2,200",0%,1,0,1,110000,0,0,0,0
3725620,cozycult,2025,Roguelite,"₩1,100",0%,0,0,0,0,0,0,0,0
3184570,The Beast in the Silent Valley,2024,Roguelite,"₩3,400",0%,1,0,1,170000,0,0,0,0
1993440,Times Dungeon,2024,Roguelite,"₩11,000",0%,0,2,2,1100000,0,0,0,0
2176580,FlipScapes,2024,Roguelite,"₩18,500",0%,6,0,6,5550000,0,0,0,0
2631650,Nif Nif,2025,Roguelite,"₩21,500",0%,33,2,35,37625000,0,0,0,0
3045150,MareScape,2024,Roguelite,"₩1,100",0%,7,0,7,385000,0,0,0,0
2999180,King's Subsidy,2025,Roguelite,Unknown,0%,0,0,0,0,0,0,0,0
2233820,Vengeful Castle,2023,Roguelite,"₩7,990",0%,3,1,4,1598000,0,0,0,0
2990670,Risk & Riches,2025,Roguelite,"₩8,800",19%,5,0,5,2200000,0,0,0,0
1143570,VolticPistol,2020,Roguelite,"₩5,600",0%,11,1,12,3360000,0,0,0,0
2400420,Land of the Survivors,2024,Roguelite,"₩3,400",0%,13,3,16,2720000,0,0,0,0
2058130,Fortitude invasion,2022,Roguelite,"₩2,760",68%,10,3,13,1794000,0,0,0,0
2734770,Alterhavoc,2024,Roguelite,"₩5,600",0%,0,1,1,280000,0,0,0,0
2985410,UnderKingdom,2024,Roguelite,"₩3,400",0%,0,0,0,0,0,0,0,0
651940,Debris Field,2019,Roguelite,"₩10,500",0%,0,0,0,0,0,0,0,0
1378790,Red River,2025,Roguelite,"₩3,400",0%,0,0,0,0,0,0,0,0
1528980,Pit of Ascension,2021,Roguelite,"₩3,300",0%,4,0,4,660000,0,0,0,0
2076730,Mud Way,2022,Roguelite,"₩1,100",0%,1,1,2,110000,0,0,0,0
2591470,Rough Souls: Adventures,2025,Roguelite,"₩5,600",0%,0,0,0,0,0,0,0,0
3520210,Metal Head Warfare,2025,Roguelite,"₩16,500",0%,7,0,7,5775000,0,0,0,0
3146730,Wizard Survivors,2024,Roguelite,"₩5,600",0%,7,0,7,1960000,0,0,0,0
3149250,Chicken Defense War - Tower Defense,2025,Roguelite,"₩6,700",0%,7,4,11,3685000,0,0,0,0
1149220,P.3,2019,Roguelite,"₩4,400",0%,3,2,5,1100000,0,0,0,0
3405220,Dungeonfell,2025,Roguelite,"₩13,500",0%,13,1,14,9450000,0,0,0,0
2446200,Dice Mayor,2023,Roguelite,"₩4,500",0%,3,2,5,1125000,0,0,0,0
2397830,Hexa Puzzle Saga,2023,Roguelite,"₩1,100",0%,7,1,8,440000,0,0,0,0
2735880,Guardian: Defense to Others,2024,Roguelite,"₩3,400",0%,1,0,1,170000,0,0,0,0
3048790,Best Mayor,2024,Roguelite,"₩1,100",0%,1,1,2,110000,0,0,0,0
1067700,Muspell,2020,Roguelite,"₩16,500",0%,1,1,2,1650000,0,0,0,0
1425670,Shadow Eclipse,2024,Roguelite,"₩5,600",0%,7,0,7,1960000,0,0,0,0
439730,XO-Planets,2016,Roguelite,"₩4,400",0%,13,2,15,3300000,0,0,0,0
3405220,Dungeonfell,2025,Roguelite,"₩13,500",0%,13,1,14,9450000,0,0,0,0
990410,Slashvival,2020,Roguelite,"₩11,000",0%,10,4,14,7700000,0,0,0,0
2025960,海岛守卫 Island guards,2022,Roguelite,"₩4,400",0%,2,1,3,660000,0,0,0,0
2609800,The Hamster's Journey,2024,Roguelite,"₩9,900",0%,5,0,5,2475000,0,0,0,0
2151530,YOU ARE THE DINNER,2023,Roguelite,"₩3,400",0%,0,2,2,340000,0,0,0,0
3636730,Seedovia,2025,Roguelite,Unknown,0%,0,0,0,0,0,0,0,0
3952680,Backrooms Maze 2D,2025,Roguelite,Unknown,0%,0,0,0,0,0,0,0,0
1021370,Slave RPG,2019,Roguelite,"₩5,600",0%,4,0,4,1120000,0,0,0,0
2151530,YOU ARE THE DINNER,2023,Roguelite,"₩3,400",0%,0,2,2,340000,0,0,0,0
1681620,Mines & Dragons,2021,Roguelite,"₩1,100",0%,7,4,11,605000,0,0,0,0
3566730,Naroike,2025,Roguelite,Unknown,0%,0,0,0,0,0,0,0,0
1109880,Just Random Squares,2019,Roguelite,"₩7,500",0%,7,1,8,3000000,0,0,0,0
3478760,HOLD.FOR.HUMANS,2025,Roguelite,Unknown,0%,0,0,0,0,0,0,0,0
821490,BattleCourt,2020,Roguelite,"₩1,100",0%,6,1,7,385000,0,0,0,0
2930410,Cyber Seekers: Conquest,2025,Roguelite,"₩14,850",9%,0,0,0,0,0,0,0,0
2810270,My Rusty Submarine - New Waters,2025,Roguelite,"₩2,300",0%,0,0,0,0,0,0,0,0
2756670,Plumber Survivors,2024,Roguelite,"₩7,800",0%,5,0,5,1950000,0,0,0,0
2764650,Devastating Fog,2024,Roguelite,"₩5,600",0%,4,0,4,1120000,0,0,0,0
3837080,Lightcore Guardians,2025,Roguelite,"₩3,400",0%,0,0,0,0,0,0,0,0
495540,Dashy Square VR,2016,Roguelite,"₩2,200",0%,3,3,6,660000,0,0,0,0
2289660,MoonScavenger,2023,Roguelite,"₩2,300",0%,1,0,1,115000,0,0,0,0
3837080,Lightcore Guardians,2025,Roguelite,"₩3,400",0%,0,0,0,0,0,0,0,0
2315990,孵化之地 wild eclosion,2023,Roguelite,"₩7,800",0%,3,3,6,2340000,0,0,0,0
2169250,Throw Wizard,2022,Roguelite,"₩1,100",0%,1,0,1,55000,0,0,0,0
2886100,Cubint,2024,Roguelite,"₩3,400",0%,2,0,2,340000,0,0,0,0
3552390,Kiwi's Adventure,2025,Roguelite,Free,0%,0,0,0,0,0,0,0,0
3948620,Luminaria,2025,Roguelite,Unknown,0%,0,0,0,0,0,0,0,0
3919140,Sous Raccoon,2025,Roguelite,"₩9,900",9%,0,0,0,0,0,0,0,0
1255680,Hand Cannon Virtuoso,2020,Roguelite,"₩17,500",0%,10,0,10,8750000,0,0,0,0
1507850,Gospel of Abaddon,2021,Roguelite,"₩3,300",0%,16,2,18,2970000,0,0,0,0
2289660,MoonScavenger,2023,Roguelite,"₩2,300",0%,1,0,1,115000,0,0,0,0
3919140,Sous Raccoon,2025,Roguelite,"₩9,900",9%,0,0,0,0,0,0,0,0
2797080,Mercenary Squad Auto Chess,2025,Roguelite,"₩6,700",0%,5,3,8,2680000,0,0,0,0
3583710,SPACE FIGHTER:CODE 1999,2025,Roguelite,"₩5,600",0%,0,0,0,0,0,0,0,0
2258960,Adventure with the Goddess,2023,Roguelite,"₩12,500",0%,5,3,8,5000000,0,0,0,0
2919770,Luck's Labyrinth,2024,Roguelite,"₩1,100",0%,4,0,4,220000,0,0,0,0
2794280,Deck Defense,2025,Roguelite,"₩11,000",0%,0,0,0,0,0,0,0,0
2872910,In Search of Heroes!,2025,Roguelite,"₩8,900",0%,0,0,0,0,0,0,0,0
3676310,Nova Survivors,2025,Roguelite,"₩1,100",0%,6,0,6,330000,0,0,0,0
1902230,Soulbaby: Remastered,2022,Roguelite,"₩16,500",0%,4,0,4,3300000,0,0,0,0
2239470,Void Blitzing,2023,Roguelite,"₩6,700",0%,2,0,2,670000,0,0,0,0
2863780,The Territory of Egg 2,2024,Roguelite,"₩5,600",0%,10,2,12,3360000,0,0,0,0
701740,Modest Kind,2017,Roguelite,"₩4,400",0%,10,7,17,3740000,0,0,0,0
2061850,Aria and the Crystal Kingdom,2023,Roguelite,"₩6,700",0%,5,0,5,1675000,0,0,0,0
1891030,Dummy Dungeon,2024,Roguelite,"₩7,800",0%,6,1,7,2730000,0,0,0,0
942530,Two Till Midnight,2019,Roguelite,"₩5,500",0%,3,1,4,1100000,0,0,0,0
2872910,In Search of Heroes!,2025,Roguelite,"₩8,900",0%,0,0,0,0,0,0,0,0
3043370,Dream Warrior,2024,Roguelite,"₩5,600",0%,6,0,6,1680000,0,0,0,0
2795120,烟花绘梦 Firework Survivor,2024,Roguelite,"₩2,300",0%,10,2,12,1380000,0,0,0,0
3760160,Dungeon Raid: Zero Floor,2025,Roguelite,Free,0%,0,0,0,0,0,0,0,0
1965560,Rogue Warlords,2022,Roguelite,"₩11,000",0%,4,3,7,3850000,0,0,0,0
3642430,Rogue Shapes,2025,Roguelite,"₩2,300",0%,0,0,0,0,0,0,0,0
874330,Me And Dungeons,2018,Roguelite,"₩1,100",0%,9,16,25,1375000,0,0,0,0
3760160,Dungeon Raid: Zero Floor,2025,Roguelite,Free,0%,0,0,0,0,0,0,0,0
2440550,Dungeon Rebound,2023,Roguelite,"₩1,100",0%,4,10,14,770000,0,0,0,0
3859020,Orbital Purge,2025,Roguelite,Unknown,0%,0,0,0,0,0,0,0,0
874330,Me And Dungeons,2018,Roguelite,"₩1,100",0%,9,16,25,1375000,0,0,0,0
2795120,烟花绘梦 Firework Survivor,2024,Roguelite,"₩2,300",0%,10,2,12,1380000,0,0,0,0
3449040,Machick 2,2025,Roguelite,Unknown,0%,0,0,0,0,0,0,0,0
3164730,TheFoolish,2024,Roguelite,"₩3,400",0%,5,0,5,850000,0,0,0,0
1169000,TORINTO,2019,Roguelite,"₩5,600",0%,5,0,5,1400000,0,0,0,0
2065870,Prescience,2024,Roguelite,"₩13,500",0%,13,0,13,8775000,0,0,0,0
375810,The Forgettable Dungeon,2019,Roguelite,"₩20,500",0%,15,5,20,20500000,0,0,0,0
1394940,Nak Sim: Fallen Warriors,2021,Roguelite,"₩13,500",0%,0,1,1,675000,0,0,0,0
1822940,Sorcerer's Tournament,2021,Roguelite,"₩1,100",0%,1,0,1,55000,0,0,0,0
3043960,Stop Them All,2024,Roguelite,"₩3,400",0%,0,0,0,0,0,0,0,0
1542820,Roguely,2021,Roguelite,"₩6,500",0%,6,0,6,1950000,0,0,0,0
1542820,Roguely,2021,Roguelite,"₩6,500",0%,6,0,6,1950000,0,0,0,0
3863460,No Sweet Looks,2025,Roguelite,Unknown,0%,0,0,0,0,0,0,0,0
3951010,UPGRADES & ENEMIES,2025,Roguelite,Unknown,0%,0,0,0,0,0,0,0,0
3795370,Pintern,2025,Roguelite,"₩9,900",9%,0,0,0,0,0,0,0,0
1331650,Troll Patrol,2020,Roguelite,"₩6,500",0%,8,1,9,2925000,0,0,0,0
881060,Fortune and Gloria,2018,Roguelite,"₩1,670",75%,4,3,7,584500,0,0,0,0
2338040,Cards Survivors,2024,Roguelite,"₩11,000",0%,7,3,10,5500000,0,0,0,0
1331650,Troll Patrol,2020,Roguelite,"₩6,500",0%,8,1,9,2925000,0,0,0,0
2396830,Boxed Tower: Actual Tower Defense,2023,Roguelite,Free,0%,0,0,0,0,0,0,0,0
2357100,Knights and Goblins,2023,Roguelite,"₩5,600",0%,4,0,4,1120000,0,0,0,0
3730720,Chains on Sand,2025,Roguelite,Unknown,0%,0,0,0,0,0,0,0,0
2620610,Dungeons of Mysteria,2023,Roguelite,"₩6,700",0%,11,3,14,4690000,0,0,0,0
2192520,Senli 307,2022,Roguelite,"₩3,400",0%,2,0,2,340000,0,0,0,0
2842070,Rockhopper,2024,Roguelite,"₩3,400",0%,3,1,4,680000,0,0,0,0
2143660,Electron Flux,2023,Roguelite,"₩16,500",0%,2,0,2,1650000,0,0,0,0
1588130,MAZE: A VR Adventure,2021,Roguelite,"₩6,500",0%,4,1,5,1625000,0,0,0,0
3025340,I Am The Registered Environmental Engineer,2024,Roguelite,"₩7,800",0%,3,0,3,1170000,0,0,0,0
2116300,Epic Survivors,2022,Roguelite,"₩5,600",0%,3,4,7,1960000,0,0,0,0
460560,Blamdown: Udder Fury,2016,Roguelite,"₩5,500",0%,22,6,28,7700000,0,0,0,0
2116300,Epic Survivors,2022,Roguelite,"₩5,600",0%,3,4,7,1960000,0,0,0,0
1755130,ELE RAMPAGE,2021,Roguelite,Free,0%,0,0,0,0,0,0,0,0
3202950,Fresh Tracks,2025,Roguelite,Unknown,0%,0,0,0,0,0,0,0,0
2350880,FuryDough,2024,Roguelite,"₩2,300",0%,0,0,0,0,0,0,0,0
1542760,Cyber Cult City,2023,Roguelite,"₩12,500",0%,21,1,22,13750000,0,0,0,0
3039990,KannaSchool,2024,Roguelite,"₩12,000",0%,4,0,4,2400000,0,0,0,0
3244140,Zombie Survivors - Eternal Nightfall,2024,Roguelite,"₩1,100",0%,4,0,4,220000,0,0,0,0
778640,Super Bit Adventure: Paragons of Life,2018,Roguelite,"₩1,100",0%,20,2,22,1210000,0,0,0,0
2688520,Hrumka,2024,Roguelite,"₩2,300",0%,0,0,0,0,0,0,0,0
2490300,Deep Nest,2023,Roguelite,"₩5,600",0%,4,1,5,1400000,0,0,0,0
3540510,loopmayor,2025,Roguelite,"₩3,400",0%,0,0,0,0,0,0,0,0
781890,Darkness Restricted,2018,Roguelite,"₩6,500",0%,9,0,9,2925000,0,0,0,0
2078710,Mage Lords of Brams,2023,Roguelite,"₩5,600",0%,0,1,1,280000,0,0,0,0
2801280,Wathan Games,2024,Roguelite,"₩7,800",0%,3,0,3,1170000,0,0,0,0
1273940,Fight with love - deckbuilder datingsim,2021,Roguelite,"₩14,500",0%,4,7,11,7975000,0,0,0,0
2817600,Wizard's Legacy,2024,Roguelite,"₩21,500",0%,3,2,5,5375000,0,0,0,0
3135200,Legacy of Defense,2025,Roguelite,Unknown,0%,0,0,0,0,0,0,0,0
2404010,Cell Wars,2023,Roguelite,"₩5,600",0%,13,0,13,3640000,0,0,0,0
3641990,Mahjong Expedition,2025,Roguelite,"₩9,900",0%,6,0,6,2970000,0,0,0,0
3514760,meYOUw,2025,Roguelite,"₩2,300",0%,0,0,0,0,0,0,0,0
3417780,Yokai Tales,2025,Roguelite,"₩6,700",0%,0,0,0,0,0,0,0,0
1481630,Command Line Pilot,2021,Roguelite,"₩2,300",0%,14,0,14,1610000,0,0,0,0
1082200,ASTRO: The Beginning,2021,Roguelite,"₩10,500",0%,1,3,4,2100000,0,0,0,0
1683140,Anima Forest,2021,Roguelite,"₩1,100",0%,6,0,6,330000,0,0,0,0
3402180,Fighting for Land / 打怪兽抢领地,2025,Roguelite,"₩4,000",0%,3,0,3,600000,0,0,0,0
638060,Majestic Trials,2021,Roguelite,"₩15,500",0%,9,2,11,8525000,0,0,0,0
3106590,Exterminant,2024,Roguelite,"₩3,400",0%,2,1,3,510000,0,0,0,0
3320370,Little Adventure Tale,2025,Roguelite,"₩8,600",0%,0,1,1,430000,0,0,0,0
1864710,Coin Operated Carnage,2022,Roguelite,"₩8,900",0%,4,1,5,2225000,0,0,0,0
2658960,The Lab and Dungeons,2024,Roguelite,"₩6,700",0%,8,1,9,3015000,0,0,0,0
1326760,Grand Attrition,2021,Roguelite,"₩1,100",0%,4,2,6,330000,0,0,0,0
2642070,Block Strategy,2024,Roguelite,"₩12,500",0%,2,2,4,2500000,0,0,0,0
1326760,Grand Attrition,2021,Roguelite,"₩1,100",0%,4,2,6,330000,0,0,0,0
1335350,Kaapelipeli: The Cable Game,2020,Roguelite,Free,0%,5,1,6,0,0,0,0,0
1090910,Rapture,2020,Roguelite,"₩4,500",0%,5,1,6,1350000,0,0,0,0
3712860,Wonder of Blue,2025,Roguelite,Unknown,0%,0,0,0,0,0,0,0,0
2412110,Rogue Labyrinth,2025,Roguelite,Unknown,0%,0,0,0,0,0,0,0,0
1887190,Civilization Simulator,2023,Roguelite,"₩3,400",0%,5,2,7,1190000,0,0,0,0
3314790,CloverPit,2025,Roguelite,Unknown,0%,0,0,0,0,0,0,0,0
1677650,CubeCube,2021,Roguelite,"₩2,200",0%,6,1,7,770000,0,0,0,0
1314600,The Rogue Cavern,2020,Roguelite,"₩2,200",0%,1,1,2,220000,0,0,0,0
1581660,LOOSEPO,2021,Roguelite,"₩1,980",9%,12,2,14,1386000,0,0,0,0
3314790,CloverPit,2025,Roguelite,Unknown,0%,0,0,0,0,0,0,0,0
2567950,Gem Wizard,2023,Roguelite,"₩2,300",0%,4,1,5,575000,0,0,0,0
2532830,Dark Galaxy,2024,Roguelite,"₩4,230",0%,0,0,0,0,0,0,0,0
2899600,dusk shrouded,2024,Roguelite,"₩8,900",0%,0,1,1,445000,0,0,0,0
1314600,The Rogue Cavern,2020,Roguelite,"₩2,200",0%,1,1,2,220000,0,0,0,0
1677650,CubeCube,2021,Roguelite,"₩2,200",0%,6,1,7,770000,0,0,0,0
2532830,Dark Galaxy,2024,Roguelite,"₩4,230",0%,0,0,0,0,0,0,0,0
2526610,Wiki's Wild Ride,2023,Roguelite,"₩11,000",0%,5,0,5,2750000,0,0,0,0
2025000,Trippy Tavern,2022,Roguelite,"₩9,900",0%,3,0,3,1485000,0,0,0,0
2784290,Night Vigil,2024,Roguelite,"₩2,300",0%,0,0,0,0,0,0,0,0
2018310,Dark Old Sun II: Unspace,2024,Roguelite,"₩16,500",0%,17,0,17,14025000,0,0,0,0
2784290,Night Vigil,2024,Roguelite,"₩2,300",0%,0,0,0,0,0,0,0,0
2376450,Lighthouse Of The Souls (LOTS),2025,Roguelite,Unknown,0%,0,0,0,0,0,0,0,0
2085320,Meow Defence,2022,Roguelite,"₩3,400",0%,11,0,11,1870000,0,0,0,0
2085320,Meow Defence,2022,Roguelite,"₩3,400",0%,11,0,11,1870000,0,0,0,0
2352820,Rogues Don't Cry,2025,Roguelite,"₩16,500",0%,1,0,1,825000,0,0,0,0
1418670,Fire survival,2024,Roguelite,"₩6,880",0%,3,4,7,2408000,0,0,0,0
1039910,Buckler 2,2019,Roguelite,"₩4,400",0%,5,1,6,1320000,0,0,0,0
1307730,Rogue Robots,2020,Roguelite,"₩7,500",0%,6,2,8,3000000,0,0,0,0
3911080,36 Zodiac Cycles,2025,Roguelite,Unknown,0%,0,0,0,0,0,0,0,0
1194490,Dethcube,2020,Roguelite,"₩4,400",0%,7,3,10,2200000,0,0,0,0
3554750,Reincarnation in Another World,2025,Roguelite,"₩6,700",0%,5,2,7,2345000,0,0,0,0
1992160,Zombie City Rescue,2023,Roguelite,"₩2,300",0%,0,0,0,0,0,0,0,0
1954570,Death Dungeon,2022,Roguelite,"₩1,100",0%,2,1,3,165000,0,0,0,0
3091990,Rogue Rhythm,2025,Roguelite,"₩8,900",0%,3,0,3,1335000,0,0,0,0
600310,Rogue'n Roll,2017,Roguelite,"₩5,500",0%,24,9,33,9075000,0,0,0,0
840830,Noonie,2018,Roguelite,"₩2,200",0%,2,0,2,220000,0,0,0,0
3554750,Reincarnation in Another World,2025,Roguelite,"₩6,700",0%,5,2,7,2345000,0,0,0,0
2127660,Zimmer,2022,Roguelite,"₩3,400",0%,7,1,8,1360000,0,0,0,0
572480,Orbiz,2019,Roguelite,"₩11,000",0%,5,1,6,3300000,0,0,0,0
2083910,Iron Dungeon,2023,Roguelite,"₩11,000",0%,7,3,10,5500000,0,0,0,0
2733670,Meowhiss the snake,2024,Roguelite,"₩3,400",0%,5,0,5,850000,0,0,0,0
1606450,BunnyShot,2021,Roguelite,"₩1,100",0%,2,0,2,110000,0,0,0,0
2372320,Portable VR,2023,Roguelite,"₩4,500",0%,4,6,10,2250000,0,0,0,0
2315460,Nightsteel Survivors,2023,Roguelite,"₩3,400",0%,1,2,3,510000,0,0,0,0
2329160,Cards and Guns,2024,Roguelite,"₩7,800",0%,13,0,13,5070000,0,0,0,0
3540430,Dungeon Weiqi,2025,Roguelite,"₩7,800",0%,0,0,0,0,0,0,0,0
3289550,To the Eden 末日行者,2025,Roguelite,"₩5,600",0%,0,0,0,0,0,0,0,0
572480,Orbiz,2019,Roguelite,"₩11,000",0%,5,1,6,3300000,0,0,0,0
2315460,Nightsteel Survivors,2023,Roguelite,"₩3,400",0%,1,2,3,510000,0,0,0,0
2605990,Tactics Below,2023,Roguelite,"₩14,500",0%,2,0,2,1450000,0,0,0,0
3289550,To the Eden 末日行者,2025,Roguelite,"₩5,600",0%,0,0,0,0,0,0,0,0
2597280,Tomb Of AnuBI0S,2023,Roguelite,"₩11,000",0%,3,0,3,1650000,0,0,0,0
3455320,Supre-Immune,2025,Roguelite,Unknown,0%,0,0,0,0,0,0,0,0
744610,TAD: That Alien Dude,2018,Roguelite,"₩5,500",0%,1,4,5,1375000,0,0,0,0
2393030,Solo Hunt,2023,Roguelite,"₩4,500",0%,0,2,2,450000,0,0,0,0
2954750,The Dreamers Foresight,2025,Roguelite,Unknown,0%,0,0,0,0,0,0,0,0
3217480,Waystones,2025,Roguelite,Unknown,0%,0,0,0,0,0,0,0,0
751670,Cloud Chasers - Journey of Hope,2018,Roguelite,"₩5,500",0%,10,1,11,3025000,0,0,0,0
1076770,ACardShooter,2019,Roguelite,"₩12,500",0%,6,0,6,3750000,0,0,0,0
1543020,Rise 2.0,2021,Roguelite,"₩1,100",0%,3,0,3,165000,0,0,0,0
2719210,Slime Link,2023,Roguelite,"₩1,100",0%,2,1,3,165000,0,0,0,0
2919340,Project P,2024,Roguelite,Free,0%,0,0,0,0,0,0,0,0
2172380,Lunch Box,2022,Roguelite,"₩2,200",0%,1,0,1,110000,0,0,0,0
2075770,Coin Blitz,2022,Roguelite,"₩1,100",0%,3,1,4,220000,0,0,0,0
591390,a nifty game,2017,Roguelite,"₩7,500",0%,2,1,3,1125000,0,0,0,0
3390470,Land of Anima: Origin of Union,2024,Roguelite,"₩7,800",0%,0,0,0,0,0,0,0,0
2919340,Project P,2024,Roguelite,Free,0%,0,0,0,0,0,0,0,0
3390470,Land of Anima: Origin of Union,2024,Roguelite,"₩7,800",0%,0,0,0,0,0,0,0,0
1543020,Rise 2.0,2021,Roguelite,"₩1,100",0%,3,0,3,165000,0,0,0,0
2172380,Lunch Box,2022,Roguelite,"₩2,200",0%,1,0,1,110000,0,0,0,0
751670,Cloud Chasers - Journey of Hope,2018,Roguelite,"₩5,500",0%,10,1,11,3025000,0,0,0,0
3055200,Huntin' Ducks,2024,Roguelite,"₩1,100",0%,0,0,0,0,0,0,0,0
2783290,Floops Big House Adventure,2024,Roguelite,"₩5,600",0%,9,1,10,2800000,0,0,0,0
2746490,Chronicle Survivors,2024,Roguelite,"₩7,800",0%,3,8,11,4290000,0,0,0,0
1763060,Feral Flowers,2021,Roguelite,"₩5,500",0%,6,0,6,1650000,0,0,0,0
1117840,Azurebreak Heroes,2020,Roguelite,"₩7,500",0%,11,0,11,4125000,0,0,0,0
2014510,COLORIDER,2022,Roguelite,"₩1,100",0%,3,5,8,440000,0,0,0,0
2859510,Chromatrix - Tower Defense,2025,Roguelite,"₩5,600",0%,4,0,4,1120000,0,0,0,0
2265130,Survivor:Stay In The Light,2025,Roguelite,"₩6,700",0%,4,5,9,3015000,0,0,0,0
2746490,Chronicle Survivors,2024,Roguelite,"₩7,800",0%,3,8,11,4290000,0,0,0,0
3353830,LivingBattle,2025,Roguelite,"₩5,240",0%,1,0,1,262000,0,0,0,0
3787190,75 Demons,2025,Roguelite,"₩4,500",0%,0,0,0,0,0,0,0,0
1117840,Azurebreak Heroes,2020,Roguelite,"₩7,500",0%,11,0,11,4125000,0,0,0,0
2766550,Moon Tower,2025,Roguelite,"₩3,400",0%,1,0,1,170000,0,0,0,0
1821530,Break Through The Illusion,2022,Roguelite,"₩1,100",0%,2,0,2,110000,0,0,0,0
2859510,Chromatrix - Tower Defense,2025,Roguelite,"₩5,600",0%,4,0,4,1120000,0,0,0,0
1139660,Marburgh,2020,Roguelite,"₩5,500",0%,3,0,3,825000,0,0,0,0
3430380,Platonic Solids,2025,Roguelite,"₩1,100",0%,2,0,2,110000,0,0,0,0
2792660,Katana's Path,2024,Roguelite,"₩3,400",0%,9,0,9,1530000,0,0,0,0
2711190,Hyperspace Deck Command,2025,Roguelite,Unknown,0%,0,0,0,0,0,0,0,0
3109340,Zoratharion,2025,Roguelite,"₩4,500",0%,2,0,2,450000,0,0,0,0
2702030,Demons are coming!,2024,Roguelite,"₩5,600",0%,3,0,3,840000,0,0,0,0
1125370,Space Grunts 2,2020,Roguelite,"₩11,000",0%,5,1,6,3300000,0,0,0,0
1290480,KaveXplorer,2020,Roguelite,"₩3,300",0%,5,1,6,990000,0,0,0,0
3787190,75 Demons,2025,Roguelite,"₩4,500",0%,0,0,0,0,0,0,0,0
2664970,Cube Survivor,2024,Roguelite,"₩4,500",0%,1,0,1,225000,0,0,0,0
2499590,White Hat,2023,Roguelite,"₩5,600",0%,8,0,8,2240000,0,0,0,0
460540,Temple of Rust,2023,Roguelite,"₩8,900",0%,91,17,108,48060000,0,0,0,0
2118940,Wander Vyrosa,2023,Roguelite,Free,0%,3,1,4,0,0,0,0,0
2388480,HatLand,2023,Roguelite,"₩4,500",0%,0,2,2,450000,0,0,0,0
3430380,Platonic Solids,2025,Roguelite,"₩1,100",0%,2,0,2,110000,0,0,0,0
2665030,Code Has Price,2024,Roguelite,"₩4,500",0%,6,2,8,1800000,0,0,0,0
1250960,Space Redemption,2020,Roguelite,"₩3,400",0%,8,3,11,1870000,0,0,0,0
3245020,Endless Conflict,2024,Roguelite,"₩2,300",0%,2,0,2,230000,0,0,0,0
1050900,Die Bloody Nazi Die!,2019,Roguelite,"₩6,000",0%,5,0,5,1500000,0,0,0,0
3586740,Ellentis,2025,Roguelite,"₩15,500",0%,1,0,1,775000,0,0,0,0
3176490,Denshi Life 2 / デンシライフ 2,2024,Roguelite,"₩7,800",0%,6,0,6,2340000,0,0,0,0
1008970,Cavyrn,2019,Roguelite,"₩5,500",0%,1,1,2,550000,0,0,0,0
3164130,TUONELA,2024,Roguelite,"₩4,500",0%,5,0,5,1125000,0,0,0,0
3414630,Turbotz Testing 20XX,2025,Roguelite,"₩5,600",0%,5,0,5,1400000,0,0,0,0
3182170,Tromblo's Adventure,2025,Roguelite,"₩5,500",0%,0,0,0,0,0,0,0,0
572290,The Existence Abstract,2017,Roguelite,"₩1,100",0%,1,2,3,165000,0,0,0,0
3665660,Space ScrubLords,2025,Roguelite,Free,0%,0,0,0,0,0,0,0,0
3317220,Weaveborn Heroes,2024,Roguelite,"₩3,400",0%,4,0,4,680000,0,0,0,0
3147240,SuperNovem,2024,Roguelite,"₩8,900",0%,1,1,2,890000,0,0,0,0
3547370,Dawnhelm Defense,2025,Roguelite,"₩5,600",0%,0,0,0,0,0,0,0,0
2906660,Conquer Lands,2025,Roguelite,Unknown,0%,0,0,0,0,0,0,0,0
3626480,Amaz'd,2025,Roguelite,Free,0%,0,0,0,0,0,0,0,0
847800,Toybit Quest,2018,Roguelite,"₩4,400",0%,4,0,4,880000,0,0,0,0
2482010,Waspkeeper,2023,Roguelite,"₩5,600",0%,6,1,7,1960000,0,0,0,0
3100330,Circle TD:Defence War,2024,Roguelite,"₩6,700",0%,12,2,14,4690000,0,0,0,0
1347110,Ice Star,2020,Roguelite,"₩8,900",0%,0,1,1,445000,0,0,0,0
1929550,"Stranger Danger or Horror, Quest and Magic",2022,Roguelite,"₩3,300",0%,2,0,2,330000,0,0,0,0
2609150,Monsters and Spirits,2023,Roguelite,"₩1,100",0%,0,1,1,55000,0,0,0,0
3448420,Echoes Of Arcane Realms,2025,Roguelite,"₩5,600",0%,0,0,0,0,0,0,0,0
3530230,End Chess Arrow,2025,Roguelite,Free,0%,0,0,0,0,0,0,0,0
1285070,Bad Run - Turbo Edition,2020,Roguelite,"₩4,500",0%,6,0,6,1350000,0,0,0,0
2723500,Gatebreakers,2025,Roguelite,"₩5,600",0%,0,0,0,0,0,0,0,0
843990,Bullet Hell ADVANCED,2018,Roguelite,"₩99,780",0%,7,3,10,49890000,0,0,0,0
1159590,Lost In Dungeon,2019,Roguelite,"₩1,100",0%,2,6,8,440000,0,0,0,0
1159590,Lost In Dungeon,2019,Roguelite,"₩1,100",0%,2,6,8,440000,0,0,0,0
2723500,Gatebreakers,2025,Roguelite,"₩5,600",0%,0,0,0,0,0,0,0,0
1141860,Trial Of Destiny,2024,Roguelite,"₩6,700",0%,5,0,5,1675000,0,0,0,0
843990,Bullet Hell ADVANCED,2018,Roguelite,"₩99,780",0%,7,3,10,49890000,0,0,0,0
2256550,Choi,2023,Roguelite,"₩8,900",0%,5,0,5,2225000,0,0,0,0
1193210,Hunt the Muglump,2020,Roguelite,"₩4,120",0%,13,3,16,3296000,0,0,0,0
2457280,Errships,2024,Roguelite,"₩11,000",0%,3,0,3,1650000,0,0,0,0
2717610,Void Reaper,2024,Roguelite,"₩4,500",0%,13,1,14,3150000,0,0,0,0
1391550,Amusemos,2021,Roguelite,Free,0%,7,3,10,0,0,0,0,0
2354920,Fallen Force,2024,Roguelite,Free,0%,5,0,5,0,0,0,0,0
1254390,Toxastra,2021,Roguelite,"₩6,500",0%,0,1,1,325000,0,0,0,0
2943760,Tower o-ven,2025,Roguelite,"₩7,700",0%,4,0,4,1540000,0,0,0,0
2337230,Survivors of the Mare Vitalis,2023,Roguelite,"₩4,500",0%,9,1,10,2250000,0,0,0,0
856050,Conjury of Nature,2018,Roguelite,"₩5,600",0%,0,0,0,0,0,0,0,0
1098910,Lannath,2019,Roguelite,"₩6,500",0%,0,0,0,0,0,0,0,0
1041130,Darkest Depths,2019,Roguelite,"₩10,500",0%,13,3,16,8400000,0,0,0,0
3376950,Rabolut: Escape From Hell,2025,Roguelite,Free,0%,1,0,1,0,0,0,0,0
3105690,高温计划 Heat Plan,2024,Roguelite,"₩1,100",0%,1,0,1,55000,0,0,0,0
2301130,Undead Quest,2023,Roguelite,"₩9,900",0%,2,0,2,990000,0,0,0,0
2446170,Hero Trial,2023,Roguelite,"₩5,600",0%,5,0,5,1400000,0,0,0,0
3342610,Bloodmoon,2025,Roguelite,Unknown,0%,0,0,0,0,0,0,0,0
3341140,Qurtys,2025,Roguelite,"₩16,500",0%,0,1,1,825000,0,0,0,0
761570,Beard & Axe,2018,Roguelite,"₩10,500",0%,2,1,3,1575000,0,0,0,0
689300,Monsteria,2017,Roguelite,"₩8,500",0%,5,0,5,2125000,0,0,0,0
2738210,Walls of Rust,2024,Roguelite,"₩5,600",0%,2,0,2,560000,0,0,0,0
1971330,Stonegeon 迷石地牢,2022,Roguelite,"₩7,500",0%,5,4,9,3375000,0,0,0,0
1629680,Artifacting,2021,Roguelite,"₩1,100",0%,1,0,1,55000,0,0,0,0
2738210,Walls of Rust,2024,Roguelite,"₩5,600",0%,2,0,2,560000,0,0,0,0
1001990,WARED,2019,Roguelite,"₩4,400",0%,1,3,4,880000,0,0,0,0
2489310,Black Journey to the West,2024,Roguelite,"₩3,400",0%,4,1,5,850000,0,0,0,0
1188020,Sir Smedieval,2019,Roguelite,"₩5,500",0%,0,0,0,0,0,0,0,0
1690740,Mandacaru,2021,Roguelite,"₩2,200",0%,1,1,2,220000,0,0,0,0
1580500,Cardlike,2022,Roguelite,"₩4,400",0%,1,0,1,220000,0,0,0,0
1831290,与我签订契约，成为救世勇者吧！,2022,Roguelite,"₩4,400",0%,5,1,6,1320000,0,0,0,0
1510890,Micro Annihilation,2021,Roguelite,"₩15,500",0%,18,2,20,15500000,0,0,0,0
898830,In Your Realm,2018,Roguelite,"₩2,300",0%,6,0,6,690000,0,0,0,0
1810460,Super Puzzle Cross,2023,Roguelite,"₩16,500",0%,8,0,8,6600000,0,0,0,0
3286030,Boardguard,2024,Roguelite,"₩4,500",0%,1,0,1,225000,0,0,0,0
949840,ICARUS84,2024,Roguelite,"₩15,500",0%,2,0,2,1550000,0,0,0,0
3273300,LAPPY GAMES,2025,Roguelite,Unknown,0%,0,0,0,0,0,0,0,0
2806840,Arcane Array Arena,2024,Roguelite,"₩2,300",0%,2,0,2,230000,0,0,0,0
3837100,The CodFather,2025,Roguelite,Free,0%,0,0,0,0,0,0,0,0
2957440,Tank Hunter,2025,Roguelite,"₩4,500",0%,7,0,7,1575000,0,0,0,0
1919920,眼球大師 Eyeball Master,2022,Roguelite,"₩2,200",0%,11,0,11,1210000,0,0,0,0
2879550,Rogueformer,2025,Roguelite,"₩1,100",0%,1,0,1,55000,0,0,0,0
788000,RogueVerse,2019,Roguelite,"₩10,500",0%,5,0,5,2625000,0,0,0,0
2485170,Vicious Star: kill All,2023,Roguelite,"₩3,400",0%,3,3,6,1020000,0,0,0,0
2574650,SHAPE HUNTER,2023,Roguelite,"₩2,300",0%,2,1,3,345000,0,0,0,0
3075890,Hostile Lands,2025,Roguelite,"₩8,900",0%,5,0,5,2225000,0,0,0,0
1582280,Sleepy Sunday,2021,Roguelite,"₩8,500",0%,1,0,1,425000,0,0,0,0
2957440,Tank Hunter,2025,Roguelite,"₩4,500",0%,7,0,7,1575000,0,0,0,0
1619970,Minable & Create / ミナクリ,2022,Roguelite,"₩20,500",0%,6,4,10,10250000,0,0,0,0
2219360,String Along,2023,Roguelite,"₩3,400",0%,1,0,1,170000,0,0,0,0
3370170,The underworld of brain damage,2024,Roguelite,"₩5,600",0%,0,0,0,0,0,0,0,0
2099910,Infinity Pinball,2022,Roguelite,"₩11,000",0%,4,3,7,3850000,0,0,0,0
1971830,Dragon Kings,2024,Roguelite,"₩5,600",0%,1,1,2,560000,0,0,0,0
3144400,Gold's Dungeon,2025,Roguelite,"₩4,500",0%,7,1,8,1800000,0,0,0,0
2544500,Get Them Boats: Orca Revenge,2023,Roguelite,"₩1,100",0%,4,1,5,275000,0,0,0,0
3185010,Hounimal,2025,Roguelite,"₩7,800",0%,8,0,8,3120000,0,0,0,0
3551370,魔书射爆（Book Shooter）,2025,Roguelite,Unknown,0%,0,0,0,0,0,0,0,0
1964540,Isolate ME!,2022,Roguelite,"₩3,300",0%,2,0,2,330000,0,0,0,0
3037550,Grove Grown Guardians,2024,Roguelite,"₩5,600",0%,3,0,3,840000,0,0,0,0
2412420,Star Defence,2023,Roguelite,"₩1,100",0%,1,0,1,55000,0,0,0,0
2062430,BALL x PIT,2025,Roguelite,Unknown,0%,0,0,0,0,0,0,0,0
2702340,Bomber Festival,2025,Roguelite,"₩1,100",0%,10,0,10,550000,0,0,0,0
2099910,Infinity Pinball,2022,Roguelite,"₩11,000",0%,4,3,7,3850000,0,0,0,0
2544500,Get Them Boats: Orca Revenge,2023,Roguelite,"₩1,100",0%,4,1,5,275000,0,0,0,0
1964540,Isolate ME!,2022,Roguelite,"₩3,300",0%,2,0,2,330000,0,0,0,0
2054150,Tower Defender VR: Last Adventure,2022,Roguelite,"₩20,500",0%,11,1,12,12300000,0,0,0,0
3551370,魔书射爆（Book Shooter）,2025,Roguelite,Unknown,0%,0,0,0,0,0,0,0,0
3167690,Being John Gogh,2024,Roguelite,"₩3,400",0%,0,1,1,170000,0,0,0,0
3092440,TerraCube,2024,Roguelite,"₩2,300",0%,0,0,0,0,0,0,0,0
1981010,Space Survival,2022,Roguelite,"₩7,500",0%,5,1,6,2250000,0,0,0,0
1981010,Space Survival,2022,Roguelite,"₩7,500",0%,5,1,6,2250000,0,0,0,0
3319270,Armada: Last Light,2025,Roguelite,"₩11,000",0%,2,2,4,2200000,0,0,0,0
2088750,Mystic Gate,2023,Roguelite,"₩11,000",0%,24,3,27,14850000,0,0,0,0
3538850,Entropy Architects,2025,Roguelite,"₩8,900",0%,2,2,4,1780000,0,0,0,0
3553970,Dungeon Story,2025,Roguelite,"₩2,300",0%,4,1,5,575000,0,0,0,0
958690,The Sky Climber,2018,Roguelite,"₩2,200",0%,8,2,10,1100000,0,0,0,0
3557110,Warden of the Crypt,2025,Roguelite,"₩2,300",0%,0,0,0,0,0,0,0,0
2633860,Guild of Rogues,2024,Roguelite,"₩11,000",0%,4,3,7,3850000,0,0,0,0
2473240,Dungeon Evolution: Nemesis,2023,Roguelite,"₩11,000",0%,1,3,4,2200000,0,0,0,0
3114090,League of Abyss,2024,Roguelite,"₩2,300",0%,0,0,0,0,0,0,0,0
3049380,Zaraq,2025,Roguelite,"₩8,900",0%,1,1,2,890000,0,0,0,0
863970,Survive the Rift,2021,Roguelite,"₩13,500",0%,9,1,10,6750000,0,0,0,0
1944810,Gilded Eternal,2024,Roguelite,"₩11,000",0%,6,0,6,3300000,0,0,0,0
3114090,League of Abyss,2024,Roguelite,"₩2,300",0%,0,0,0,0,0,0,0,0
2473240,Dungeon Evolution: Nemesis,2023,Roguelite,"₩11,000",0%,1,3,4,2200000,0,0,0,0
2088750,Mystic Gate,2023,Roguelite,"₩11,000",0%,24,3,27,14850000,0,0,0,0
1644390,HyperFeat,2021,Roguelite,"₩3,300",0%,1,1,2,330000,0,0,0,0
1212960,Knight Dice,2020,Roguelite,"₩3,300",0%,8,4,12,1980000,0,0,0,0
958690,The Sky Climber,2018,Roguelite,"₩2,200",0%,8,2,10,1100000,0,0,0,0
863970,Survive the Rift,2021,Roguelite,"₩13,500",0%,9,1,10,6750000,0,0,0,0
2141470,Bad Writer,2022,Roguelite,"₩6,500",0%,2,2,4,1300000,0,0,0,0
3773810,龙门Longmen,2025,Roguelite,"₩3,400",0%,0,0,0,0,0,0,0,0
1944810,Gilded Eternal,2024,Roguelite,"₩11,000",0%,6,0,6,3300000,0,0,0,0
2548260,The Devil's Typist,2024,Roguelite,"₩1,100",0%,4,2,6,330000,0,0,0,0
1842350,Octane Remix,2023,Roguelite,"₩21,500",0%,5,0,5,5375000,0,0,0,0
2955600,Paranoid,2024,Roguelite,"₩5,600",0%,4,0,4,1120000,0,0,0,0
1928850,STAR MATH: Interstellar Rogue 2,2022,Roguelite,"₩12,500",0%,6,0,6,3750000,0,0,0,0
436850,Stellar Stars,2016,Roguelite,"₩10,500",0%,3,3,6,3150000,0,0,0,0
3272860,DuckLaserDuck,2024,Roguelite,"₩5,500",0%,0,0,0,0,0,0,0,0
3240510,Calypso's Calamity,2024,Roguelite,"₩2,300",0%,1,0,1,115000,0,0,0,0
3381320,Cave Crusade,2025,Roguelite,"₩7,800",0%,0,0,0,0,0,0,0,0
1465060,Tetrogue Dragons,2020,Roguelite,"₩8,500",0%,2,0,2,850000,0,0,0,0
2058220,Artifacts of Eyru,2022,Roguelite,"₩3,400",0%,2,1,3,510000,0,0,0,0
3082750,Dice Dice Dice,2024,Roguelite,"₩3,400",0%,1,0,1,170000,0,0,0,0
1933580,MindSweeper,2022,Roguelite,"₩10,500",0%,2,0,2,1050000,0,0,0,0
1480690,Pangea,2021,Roguelite,"₩7,500",0%,5,1,6,2250000,0,0,0,0
3896030,Freelancers: Rogue Skies,2025,Roguelite,Unknown,0%,0,0,0,0,0,0,0,0
2141470,Bad Writer,2022,Roguelite,"₩6,500",0%,2,2,4,1300000,0,0,0,0
1542000,Thearchy,2021,Roguelite,Free,0%,5,1,6,0,0,0,0,0
2256160,Survive Now,2023,Roguelite,Free,0%,7,2,9,0,0,0,0,0
901000,Serenade of the Sirens,2018,Roguelite,"₩5,500",0%,3,2,5,1375000,0,0,0,0
979880,Fast Food Fighters,2019,Roguelite,"₩15,500",0%,3,0,3,2325000,0,0,0,0
3135450,TowerUp: Breakout,2024,Roguelite,"₩2,300",0%,4,2,6,690000,0,0,0,0
2574550,Culinary Survivors,2023,Roguelite,"₩5,600",0%,3,0,3,840000,0,0,0,0
1153060,Juicy Army: Prologue,2020,Roguelite,Free,0%,7,1,8,0,0,0,0,0
2409160,Treasure Mountain,2023,Roguelite,"₩4,500",0%,0,0,0,0,0,0,0,0
1505500,Fluffy Gore,2021,Roguelite,"₩2,300",0%,7,1,8,920000,0,0,0,0
1516150,Dorpie,2024,Roguelite,"₩4,500",0%,8,0,8,1800000,0,0,0,0
2994940,STEM Defense,2024,Roguelite,"₩11,000",0%,1,0,1,550000,0,0,0,0
3142060,Mine From Here,2024,Roguelite,"₩1,100",0%,3,0,3,165000,0,0,0,0
3417350,Hero Hellspawn - Learn Arithmetic,2025,Roguelite,"₩3,400",0%,1,0,1,170000,0,0,0,0
3430010,The Variant Void,2025,Roguelite,"₩6,700",0%,1,0,1,335000,0,0,0,0
3192670,Downcave,2024,Roguelite,"₩3,400",0%,4,0,4,680000,0,0,0,0
1750810,Wager,2021,Roguelite,"₩1,100",0%,3,1,4,220000,0,0,0,0
1505500,Fluffy Gore,2021,Roguelite,"₩2,300",0%,7,1,8,920000,0,0,0,0
2994940,STEM Defense,2024,Roguelite,"₩11,000",0%,1,0,1,550000,0,0,0,0
3678880,Swarm Sweeper,2025,Roguelite,"₩3,400",0%,0,0,0,0,0,0,0,0
3417350,Hero Hellspawn - Learn Arithmetic,2025,Roguelite,"₩3,400",0%,1,0,1,170000,0,0,0,0
3031100,Wizard Blaster,2024,Roguelite,"₩1,100",0%,0,0,0,0,0,0,0,0
1168530,Babel Climbers,2020,Roguelite,"₩10,500",0%,0,6,6,3150000,0,0,0,0
2361940,Ninja Golf 2,2023,Roguelite,"₩3,400",0%,0,2,2,340000,0,0,0,0
2796980,Magic Card：CZ12,2024,Roguelite,"₩3,400",0%,0,0,0,0,0,0,0,0
1294120,Bragger's Run,2020,Roguelite,"₩4,400",0%,12,0,12,2640000,0,0,0,0
1757970,Oasis: Dark Forest,2021,Roguelite,"₩3,400",0%,9,2,11,1870000,0,0,0,0
1098000,Rifle Storm,2022,Roguelite,"₩16,500",0%,6,2,8,6600000,0,0,0,0
2361940,Ninja Golf 2,2023,Roguelite,"₩3,400",0%,0,2,2,340000,0,0,0,0
1452110,Dominium Mundi,2020,Roguelite,"₩10,000",0%,2,5,7,3500000,0,0,0,0
2833470,BRISK UP,2024,Roguelite,₩880,19%,0,1,1,44000,0,0,0,0
3611940,-Ham Cafe- Ohamu Shokudo Ki,2025,Roguelite,"₩7,800",0%,2,0,2,780000,0,0,0,0
2002720,CubeShooter,2022,Roguelite,"₩2,200",0%,7,2,9,990000,0,0,0,0
1203780,Tiamat's Drink,2020,Roguelite,"₩4,400",0%,10,0,10,2200000,0,0,0,0
1190760,Tales of the Deck,2020,Roguelite,"₩10,500",0%,12,7,19,9975000,0,0,0,0
1284430,Nazi Labs,2020,Roguelite,"₩3,300",0%,6,5,11,1815000,0,0,0,0
3261890,Toy Battlegrounds: Shoot 'Em Up Survival,2025,Roguelite,"₩11,000",0%,1,2,3,1650000,0,0,0,0
1398420,One Last Dungeon,2020,Roguelite,"₩5,500",0%,8,2,10,2750000,0,0,0,0
3246420,Project 0.1,2025,Roguelite,Free,0%,0,0,0,0,0,0,0,0
832380,Reignman（掌控者）,2018,Roguelite,"₩4,400",0%,21,7,28,6160000,0,0,0,0
3180460,4fools1,2025,Roguelite,Free,0%,0,0,0,0,0,0,0,0
832380,Reignman（掌控者）,2018,Roguelite,"₩4,400",0%,21,7,28,6160000,0,0,0,0
551060,Creekside Creep Invasion,2017,Roguelite,"₩10,500",0%,12,3,15,7875000,0,0,0,0
1937030,The Synergist,2022,Roguelite,"₩4,400",0%,0,0,0,0,0,0,0,0
3255570,Cookie Survivors,2024,Roguelite,"₩2,300",0%,1,0,1,115000,0,0,0,0
3135250,Deckception,2024,Roguelite,"₩5,600",0%,5,0,5,1400000,0,0,0,0
1475350,Breath,2020,Roguelite,"₩3,300",0%,10,0,10,1650000,0,0,0,0
2915360,Hide And Seek,2024,Roguelite,"₩2,300",0%,3,2,5,575000,0,0,0,0
2808860,Arcane Chaos,2024,Roguelite,"₩3,400",0%,0,1,1,170000,0,0,0,0
1570610,Herbis,2021,Roguelite,"₩1,100",0%,3,0,3,165000,0,0,0,0
3383290,Eternal Night Glory,2025,Roguelite,Free,0%,0,0,0,0,0,0,0,0
3195660,The Last Strand,2025,Roguelite,"₩16,420",0%,8,0,8,6568000,0,0,0,0
1719040,Morsels,2025,Roguelite,Unknown,0%,0,0,0,0,0,0,0,0
721990,Dead Spawn,2019,Roguelite,"₩5,500",0%,0,2,2,550000,0,0,0,0
2008350,Crush Them！,2022,Roguelite,"₩3,300",0%,6,0,6,990000,0,0,0,0
1555780,鸭子达奇 Duck Duchy,2021,Roguelite,"₩3,300",0%,3,0,3,495000,0,0,0,0
2463480,Alaric's Quest,2025,Roguelite,"₩6,700",0%,0,0,0,0,0,0,0,0
1329400,Space Dogfight,2020,Roguelite,"₩1,100",0%,6,3,9,495000,0,0,0,0
1294630,Shape Storm,2020,Roguelite,Free,0%,8,1,9,0,0,0,0,0
3084740,Command Deck,2025,Roguelite,Unknown,0%,0,0,0,0,0,0,0,0
3600670,Zombie Town Breakout,2025,Roguelite,"₩11,000",0%,1,0,1,550000,0,0,0,0
2640170,Bockito,2023,Roguelite,"₩2,300",0%,4,0,4,460000,0,0,0,0
1902900,The Eternal Battlefields,2022,Roguelite,"₩11,000",0%,1,2,3,1650000,0,0,0,0
1902900,The Eternal Battlefields,2022,Roguelite,"₩11,000",0%,1,2,3,1650000,0,0,0,0
2288470,Aethermancer,2025,Roguelite,Unknown,0%,0,0,0,0,0,0,0,0
1884140,Dungeon Castle,2022,Roguelite,"₩1,100",0%,2,0,2,110000,0,0,0,0
3530200,QuestionBank,2025,Roguelite,Free,0%,0,0,0,0,0,0,0,0
1086060,Tunnel Vision,2019,Roguelite,"₩5,500",0%,3,1,4,1100000,0,0,0,0
3650230,Fortune Paradox,2025,Roguelite,"₩1,960",65%,7,0,7,686000,0,0,0,0
2317080,Asura's Trial,2023,Roguelite,"₩1,100",0%,4,1,5,275000,0,0,0,0
1846240,Land Of Eno,2022,Roguelite,"₩2,200",0%,5,4,9,990000,0,0,0,0
1954010,Escape from Deathmark Dungeon,2022,Roguelite,Free,0%,4,1,5,0,0,0,0,0
2560320,Little Mages,2023,Roguelite,"₩2,300",0%,2,0,2,230000,0,0,0,0
3250760,Redshift,2024,Roguelite,"₩4,500",0%,1,0,1,225000,0,0,0,0
2948020,1000 Seconds,2025,Roguelite,"₩3,400",0%,2,0,2,340000,0,0,0,0
1657570,Tube Rolling,2021,Roguelite,"₩1,100",0%,0,0,0,0,0,0,0,0
3490250,Chemical Combat,2025,Roguelite,Unknown,0%,0,0,0,0,0,0,0,0
2422850,The Unknown,2023,Roguelite,"₩2,300",0%,3,0,3,345000,0,0,0,0
1609800,Akinofa,2021,Roguelite,"₩5,500",0%,2,0,2,550000,0,0,0,0
2202480,Monster&Strategy,2024,Roguelite,"₩7,800",0%,2,0,2,780000,0,0,0,0
2417240,The Isolated Town,2023,Roguelite,"₩11,000",0%,6,0,6,3300000,0,0,0,0
2663140,Standalone: Synergy,2024,Roguelite,"₩1,100",0%,2,4,6,330000,0,0,0,0
1120390,Tri6: Infinite,2020,Roguelite,"₩8,500",0%,6,1,7,2975000,0,0,0,0
3608390,Glow Journey,2025,Roguelite,"₩5,600",0%,4,0,4,1120000,0,0,0,0
2986390,Dead Room,2024,Roguelite,"₩3,400",0%,1,0,1,170000,0,0,0,0
1689360,mine shaft,2023,Roguelite,"₩3,400",0%,0,1,1,170000,0,0,0,0
1263120,Hecaton,2020,Roguelite,"₩2,300",0%,5,2,7,805000,0,0,0,0
3193630,Super Destroyer,2024,Roguelite,"₩6,700",0%,0,0,0,0,0,0,0,0
1450240,Summoner Apprentice,2020,Roguelite,"₩2,200",0%,6,2,8,880000,0,0,0,0
1893590,Cat Follow Me,2022,Roguelite,"₩1,100",0%,5,1,6,330000,0,0,0,0
1450240,Summoner Apprentice,2020,Roguelite,"₩2,200",0%,6,2,8,880000,0,0,0,0
1893590,Cat Follow Me,2022,Roguelite,"₩1,100",0%,5,1,6,330000,0,0,0,0
1937160,The Nightmare Catcher,2022,Roguelite,"₩5,600",0%,47,13,60,16800000,0,0,0,0
839040,Fasaria World: Ancients of Moons + Server,2020,Roguelite,"₩9,590",0%,5,3,8,3836000,0,0,0,0
2800620,The Dungeons Of Algoduul,2024,Roguelite,"₩5,600",0%,4,0,4,1120000,0,0,0,0
3861590,A Hundred Years of Love and Death,2025,Roguelite,Free,0%,0,0,0,0,0,0,0,0
903180,Privateers,2019,Roguelite,"₩10,500",0%,11,2,13,6825000,0,0,0,0
3149940,和！和！和！RogueXMahjong,2024,Roguelite,"₩1,100",0%,1,1,2,110000,0,0,0,0
1138630,Heroes Swipe Right,2020,Roguelite,"₩5,500",0%,4,2,6,1650000,0,0,0,0
1352450,Caterva,2022,Roguelite,"₩3,300",0%,1,4,5,825000,0,0,0,0
3449110,STELA BOSS,2025,Roguelite,"₩1,100",0%,0,0,0,0,0,0,0,0
880770,Cybrus,2018,Roguelite,"₩4,400",0%,3,1,4,880000,0,0,0,0
2433850,Arcane Tower Survivors,2025,Roguelite,Unknown,0%,0,0,0,0,0,0,0,0
2766830,Beast Park,2024,Roguelite,"₩4,500",0%,0,0,0,0,0,0,0,0
2358060,Card Artisan,2025,Roguelite,Unknown,0%,0,0,0,0,0,0,0,0
880770,Cybrus,2018,Roguelite,"₩4,400",0%,3,1,4,880000,0,0,0,0
3449110,STELA BOSS,2025,Roguelite,"₩1,100",0%,0,0,0,0,0,0,0,0
1237240,Crypt Of Shadows,2020,Roguelite,"₩10,500",0%,1,0,1,525000,0,0,0,0
1646240,FukTopia 2,2022,Roguelite,"₩27,000",0%,1,2,3,4050000,0,0,0,0
3351690,Gauntlet,2024,Roguelite,"₩3,400",0%,4,0,4,680000,0,0,0,0
2734180,Cube-Field+,2025,Roguelite,"₩3,400",0%,0,0,0,0,0,0,0,0
1827500,Generations Of Destruction,2021,Roguelite,"₩2,200",0%,2,0,2,220000,0,0,0,0
1573500,Red Measures,2021,Roguelite,"₩3,400",0%,4,1,5,850000,0,0,0,0
2261420,BoxLoop 2,2023,Roguelite,"₩2,300",0%,1,0,1,115000,0,0,0,0
3475770,Meta Card Backpack Legend,2025,Roguelite,Unknown,0%,0,0,0,0,0,0,0,0
1836900,Netherspace 2,2022,Roguelite,"₩8,900",0%,3,0,3,1335000,0,0,0,0
1293740,UFO Stalker,2020,Roguelite,"₩6,500",0%,0,0,0,0,0,0,0,0
2550930,Zombie Battlefield Survivors,2024,Roguelite,"₩3,400",0%,7,2,9,1530000,0,0,0,0
1896510,Nova Slash: Unparalleled Power,2022,Roguelite,"₩1,100",0%,4,2,6,330000,0,0,0,0
1024690,Chaos Village,2019,Roguelite,"₩1,100",0%,3,4,7,385000,0,0,0,0
3238250,ROGUE HANDS!,2025,Roguelite,"₩4,500",0%,3,0,3,675000,0,0,0,0
1776860,Tank Sudoku,2022,Roguelite,"₩3,400",0%,1,0,1,170000,0,0,0,0
1323870,Touch The Floor,2020,Roguelite,"₩1,100",0%,2,0,2,110000,0,0,0,0
968480,Dimensum - Bizzarre Huntseeker,2019,Roguelite,"₩10,500",0%,5,1,6,3150000,0,0,0,0
2452320,Folly Of The Wizards,2025,Roguelite,Unknown,0%,0,0,0,0,0,0,0,0
660200,Transistor Defense,2025,Roguelite,"₩5,600",0%,0,0,0,0,0,0,0,0
1886960,I HUMAN MACHINE,2022,Roguelite,"₩3,400",0%,1,0,1,170000,0,0,0,0
1089800,Axan Ships,2019,Roguelite,"₩11,500",0%,0,1,1,575000,0,0,0,0
3330470,Cats Bounce Ball,2024,Roguelite,"₩2,300",0%,4,2,6,690000,0,0,0,0
3360330,灵魂重生 Reborn the Soul,2025,Roguelite,"₩5,600",0%,5,0,5,1400000,0,0,0,0
1199610,Broken of Darkness,2020,Roguelite,"₩8,900",0%,5,7,12,5340000,0,0,0,0
2719610,PUIQ: Demons,2024,Roguelite,"₩3,400",0%,2,0,2,340000,0,0,0,0
2712670,Axe Ghost,2025,Roguelite,"₩11,000",0%,0,0,0,0,0,0,0,0
1251950,Escape of Mari: The Polar Ladybug,2020,Roguelite,"₩1,100",0%,2,0,2,110000,0,0,0,0
2967790,Solitary Sentinel,2025,Roguelite,"₩7,800",0%,0,0,0,0,0,0,0,0
3085010,Emoji Shooter,2025,Roguelite,"₩7,800",0%,24,0,24,9360000,0,0,0,0
1872280,Physics of life simulator,2025,Roguelite,"₩1,100",0%,1,0,1,55000,0,0,0,0
1763160,I Am 1,2022,Roguelite,"₩20,500",0%,5,0,5,5125000,0,0,0,0
2616890,Chamberflame,2024,Roguelite,"₩8,900",0%,2,0,2,890000,0,0,0,0
3267500,Through the stars,2024,Roguelite,"₩13,500",0%,0,0,0,0,0,0,0,0
1267670,Heartless reseller is Roguelike,2020,Roguelite,"₩1,100",0%,2,3,5,275000,0,0,0,0
2209360,Reclamation of Xanthros,2025,Roguelite,"₩5,600",0%,0,0,0,0,0,0,0,0
2335830,Fist Food,2024,Roguelite,"₩5,600",0%,0,0,0,0,0,0,0,0
3290450,Arcade Manager,2025,Roguelite,"₩16,500",0%,4,2,6,4950000,0,0,0,0
1402130,Archery Arena,2020,Roguelite,"₩1,100",0%,1,0,1,55000,0,0,0,0
2410470,The Dream of Cocoon,2023,Roguelite,"₩11,000",0%,7,0,7,3850000,0,0,0,0
1730380,World of MiniMonsters,2021,Roguelite,"₩3,400",0%,3,0,3,510000,0,0,0,0
3682080,Gambler’s Loop,2025,Roguelite,"₩2,300",0%,0,0,0,0,0,0,0,0
3417340,The Rogue of Nexus,2025,Roguelite,"₩5,600",0%,1,0,1,280000,0,0,0,0
1632960,Luminyte,2021,Roguelite,Free,0%,5,1,6,0,0,0,0,0
1922000,Towerland,2022,Roguelite,"₩6,500",0%,4,1,5,1625000,0,0,0,0
2260260,Hack and Shoot Heroes,2023,Roguelite,"₩5,600",0%,1,8,9,2520000,0,0,0,0
3840890,Lunera,2025,Roguelite,"₩12,500",0%,0,0,0,0,0,0,0,0
3343480,SeedGod,2025,Roguelite,Unknown,0%,0,0,0,0,0,0,0,0
3198820,Passer,2025,Roguelite,"₩16,500",0%,0,0,0,0,0,0,0,0
3884500,TYPE,2025,Roguelite,Unknown,0%,0,0,0,0,0,0,0,0
2899160,AI Fantasy,2024,Roguelite,"₩5,600",0%,2,4,6,1680000,0,0,0,0
3090600,Last Home,2024,Roguelite,"₩3,400",0%,1,0,1,170000,0,0,0,0
3409570,Bricks Smasher,2025,Roguelite,"₩2,300",0%,5,1,6,690000,0,0,0,0
1400920,Flood Fill,2020,Roguelite,"₩2,200",0%,3,0,3,330000,0,0,0,0
3319000,Aggrolotls,2025,Roguelite,"₩3,400",0%,2,0,2,340000,0,0,0,0
2009420,Zaxterion: Space Frenzy!,2022,Roguelite,"₩8,900",0%,8,2,10,4450000,0,0,0,0
2011840,Squad Game,2023,Roguelite,"₩11,000",0%,0,1,1,550000,0,0,0,0
3162140,Void Stealer Bodycam Horror,2024,Roguelite,"₩9,900",0%,8,3,11,5445000,0,0,0,0
2517150,Vagneria,2024,Roguelite,"₩5,600",0%,10,5,15,4200000,0,0,0,0
2985470,Crown's Labyrinth,2024,Roguelite,"₩6,700",0%,0,0,0,0,0,0,0,0
3033470,From The Mystery Zone,2024,Roguelite,"₩4,930",0%,3,4,7,1725500,0,0,0,0
3891810,BrainRot Battle,2025,Roguelite,"₩8,900",0%,0,0,0,0,0,0,0,0
2901990,lone.AI,2025,Roguelite,"₩3,400",0%,0,0,0,0,0,0,0,0
3252270,xukaackque,2024,Roguelite,"₩1,100",0%,1,0,1,55000,0,0,0,0
2200900,The Ranger: A Skyhopper Tale,2022,Roguelite,"₩4,500",0%,2,0,2,450000,0,0,0,0
1416820,Brutal Wizardry,2021,Roguelite,"₩21,500",0%,3,4,7,7525000,0,0,0,0
2107470,Zero to Hero,2023,Roguelite,"₩11,000",0%,0,0,0,0,0,0,0,0
2422990,Weather Dominance,2024,Roguelite,"₩5,600",0%,3,1,4,1120000,0,0,0,0
790030,Hexer,2021,Roguelite,"₩1,100",0%,1,0,1,55000,0,0,0,0
3252420,Launch And Loot,2024,Roguelite,"₩4,450",0%,12,0,12,2670000,0,0,0,0
1733400,The Final Frontier,2021,Roguelite,"₩2,200",0%,1,0,1,110000,0,0,0,0
2205550,Familegion,2025,Roguelite,"₩2,400",0%,4,0,4,480000,0,0,0,0
3837300,Against Tribulation,2025,Roguelite,"₩3,500",0%,0,0,0,0,0,0,0,0
2469490,Elemental World,2024,Roguelite,"₩7,800",0%,11,2,13,5070000,0,0,0,0
3606980,Modulea,2025,Roguelite,"₩3,400",0%,0,0,0,0,0,0,0,0
2161130,Rerun,2023,Roguelite,"₩5,600",0%,7,2,9,2520000,0,0,0,0
2918840,史莱姆的抉择：The Slime's Choice：TSC,2024,Roguelite,"₩5,600",0%,0,1,1,280000,0,0,0,0
1256220,幸存者 星星之火 | Survivor Spark,2020,Roguelite,"₩1,100",0%,14,2,16,880000,0,0,0,0
2408220,That's My Space,2023,Roguelite,"₩5,600",0%,1,0,1,280000,0,0,0,0
3450340,Henshin MyBro!,2025,Roguelite,"₩5,600",0%,16,2,18,5040000,0,0,0,0
3352850,The NAKI Files,2025,Roguelite,Unknown,0%,0,0,0,0,0,0,0,0
2778230,Labyrinthian Lockdown,2024,Roguelite,"₩4,500",0%,3,1,4,900000,0,0,0,0
2795410,Crossed Commands: Collision,2025,Roguelite,Unknown,0%,0,0,0,0,0,0,0,0
2569850,BlindSpell,2024,Roguelite,"₩2,300",0%,1,0,1,115000,0,0,0,0
2266130,勇士末路 The End of Warriors,2023,Roguelite,"₩4,500",0%,10,0,10,2250000,0,0,0,0
2914400,Hot Pot Game,2025,Roguelite,"₩5,600",0%,0,0,0,0,0,0,0,0
3638420,Inspiral: Echoes of Gravity,2025,Roguelite,Unknown,0%,0,0,0,0,0,0,0,0
1297190,One Hundred Courage,2020,Roguelite,"₩1,100",0%,0,0,0,0,0,0,0,0
2844820,Codename Attila,2024,Roguelite,"₩2,300",0%,0,0,0,0,0,0,0,0
1626480,Slime Labs,2021,Roguelite,"₩1,100",0%,2,0,2,110000,0,0,0,0
2619090,Lighark,2024,Roguelite,"₩6,700",0%,6,1,7,2345000,0,0,0,0
3724470,SCALE BULLET ～After Story～,2025,Roguelite,"₩5,600",0%,0,0,0,0,0,0,0,0
620330,Scrapper,2018,Roguelite,"₩10,500",0%,4,1,5,2625000,0,0,0,0
1219420,Millions of Minions: An Underground Adventure,2020,Roguelite,"₩5,500",0%,8,1,9,2475000,0,0,0,0
2981860,Cube Crawler,2025,Roguelite,"₩13,200",19%,0,0,0,0,0,0,0,0
1846390,Einherjar,2022,Roguelite,Free,0%,6,0,6,0,0,0,0,0
2811040,Crystal Survivor,2024,Roguelite,"₩4,500",0%,6,2,8,1800000,0,0,0,0
3542650,Magic Typo,2025,Roguelite,"₩9,900",0%,0,0,0,0,0,0,0,0
1919220,Automoji,2023,Roguelite,"₩5,600",0%,6,0,6,1680000,0,0,0,0
1857220,OtterQuest,2022,Roguelite,"₩5,500",0%,5,0,5,1375000,0,0,0,0
1371000,AnotherOne,2020,Roguelite,"₩3,300",0%,1,0,1,165000,0,0,0,0
3119240,Magic the Wandering,2024,Roguelite,"₩5,600",0%,0,0,0,0,0,0,0,0
367520,Hollow Knight,2017,Metroidvania,"₩16,500",0%,403641,12305,415946,343155450000,0,0,0,0
1369630,ENDER LILIES: Quietus of the Knights,2021,Metroidvania,"₩10,600",60%,37155,2378,39533,20952490000,0,0,0,0
2787320,Revenge of the Savage Planet,2025,Metroidvania,"₩20,470",35%,0,0,0,0,1115,261,1376,1408336000
774361,Blasphemous,2019,Metroidvania,"₩6,500",75%,46393,5091,51484,16732300000,0,0,0,0
312520,Rain World,2017,Metroidvania,"₩27,000",0%,39787,2490,42277,57073950000,0,0,0,0
1147560,Skul: The Hero Slayer,2021,Metroidvania,"₩20,500",0%,51218,3683,54901,56273525000,0,0,0,0
1809540,Nine Sols,2024,Metroidvania,"₩32,000",0%,27488,1408,28896,46233600000,0,0,0,0
588650,Dead Cells,2018,Metroidvania,"₩25,800",0%,163549,4915,168464,217318560000,0,0,0,0
2721890,Öoo,2025,Metroidvania,"₩11,000",0%,0,0,0,0,1372,14,1386,762300000
1057090,Ori and the Will of the Wisps,2020,Metroidvania,"₩29,900",0%,131989,4701,136690,204351550000,0,0,0,0
2394650,Crypt Custodian,2024,Metroidvania,"₩18,480",30%,1861,43,1904,1759296000,1931,60,1991,1839684000
813230,ANIMAL WELL,2024,Metroidvania,"₩25,000",0%,19956,834,20790,25987500000,0,0,0,0
753420,Dungreed,2018,Metroidvania,"₩10,500",0%,8672,621,9293,4878825000,0,0,0,0
261570,Ori and the Blind Forest,2015,Metroidvania,Unknown,0%,54150,3262,57412,0,0,0,0,0
2803280,Dragon Is Dead,2025,Metroidvania,"₩21,500",0%,279,63,342,367650000,444,133,577,620275000
553420,TUNIC,2022,Metroidvania,"₩32,000",0%,13921,1260,15181,24289600000,0,0,0,0
374190,Infernax,2022,Metroidvania,"₩12,300",40%,1848,141,1989,1223235000,1775,134,1909,1174035000
1740720,Have a Nice Death,2023,Metroidvania,"₩27,000",0%,8588,1351,9939,13417650000,0,0,0,0
692850,Bloodstained: Ritual of the Night,2019,Metroidvania,"₩49,800",0%,36999,2486,39485,98317650000,0,0,0,0
1203630,Record of Lodoss War-Deedlit in Wonder Labyrinth-,2021,Metroidvania,"₩20,500",0%,6262,471,6733,6901325000,0,0,0,0
2671230,BLADECHIMERA,2025,Metroidvania,"₩21,500",0%,846,108,954,1025550000,849,127,976,1049200000
571310,SteamWorld Dig 2,2017,Metroidvania,"₩2,050",90%,7243,338,7581,777052500,0,0,0,0
953490,CARRION,2020,Metroidvania,"₩21,500",0%,25814,1496,27310,29358250000,0,0,0,0
894020,Death's Door,2021,Metroidvania,"₩21,500",0%,17444,1224,18668,20068100000,0,0,0,0
851100,Touhou Luna Nights,2019,Metroidvania,"₩18,500",0%,13668,339,14007,12956475000,0,0,0,0
1191630,Shantae and the Seven Sirens,2020,Metroidvania,"₩31,000",0%,1638,181,1819,2819450000,1294,144,1438,2228900000
1374970,Moonscars,2022,Metroidvania,"₩10,250",50%,1006,199,1205,617562500,822,180,1002,513525000
1253920,Rogue Legacy 2,2022,Metroidvania,"₩27,000",0%,13143,1326,14469,19533150000,0,0,0,0
764300,Shantae: Half-Genie Hero Ultimate Edition,2018,Metroidvania,"₩31,000",0%,965,123,1088,1686400000,735,73,808,1252400000
1062110,UNSIGHTED,2021,Metroidvania,"₩8,200",60%,1767,132,1899,778590000,1504,131,1635,670350000
3099000,Guns of Fury,2025,Metroidvania,"₩12,370",25%,466,68,534,330279000,514,77,591,365533500
347800,Ghost Song,2022,Metroidvania,"₩10,250",50%,1045,209,1254,642675000,749,143,892,457150000
345820,Shantae and the Pirate's Curse,2015,Metroidvania,"₩21,000",0%,2653,200,2853,2995650000,1629,104,1733,1819650000
814370,Monster Sanctuary,2020,Metroidvania,"₩20,500",0%,10468,971,11439,11724975000,0,0,0,0
400910,Rabi-Ribi,2016,Metroidvania,"₩19,500",0%,11354,504,11858,11561550000,0,0,0,0
1745510,Lunacid,2023,Metroidvania,"₩15,500",0%,8037,790,8827,6840925000,0,0,0,0
737520,Flynn: Son of Crimson,2021,Metroidvania,"₩6,150",70%,576,100,676,207870000,274,52,326,100245000
764790,The Messenger,2018,Metroidvania,"₩21,500",0%,11059,801,11860,12749500000,0,0,0,0
252410,SteamWorld Dig,2013,Metroidvania,"₩1,050",90%,7697,498,8195,430237500,0,0,0,0
1772830,Rusted Moss,2023,Metroidvania,"₩21,500",0%,1147,133,1280,1376000000,1085,134,1219,1310425000
323220,Vagante,2018,Metroidvania,"₩16,000",0%,4319,521,4840,3872000000,0,0,0,0
3548000,Cosmobreeder Yiffai,2025,Metroidvania,"₩16,500",0%,92,20,112,92400000,100,20,120,99000000
1274600,The Last Faith,2023,Metroidvania,"₩27,930",0%,3295,722,4017,5609740500,0,0,0,0
1796220,Laika: Aged Through Blood,2023,Metroidvania,"₩21,500",0%,4551,358,4909,5277175000,0,0,0,0
283640,Salt and Sanctuary,2016,Metroidvania,"₩19,000",0%,18485,2167,20652,19619400000,0,0,0,0
1747760,Momodora: Moonlit Farewell,2024,Metroidvania,"₩18,500",0%,2547,212,2759,2552075000,0,0,0,0
2365810,Pseudoregalia,2023,Metroidvania,"₩6,700",0%,14588,439,15027,5034045000,0,0,0,0
1478160,Nyaruru Fishy Fight,2023,Metroidvania,"₩5,520",35%,1474,163,1637,451812000,1401,173,1574,434424000
277890,Shantae: Risky's Revenge - Director's Cut,2014,Metroidvania,"₩10,500",0%,1366,225,1591,835275000,995,149,1144,600600000
356650,Death's Gambit: Afterlife,2018,Metroidvania,"₩28,550",0%,4299,974,5273,7527207500,0,0,0,0
1123050,GRIME,2021,Metroidvania,"₩26,000",0%,4936,852,5788,7524400000,0,0,0,0
900270,Reventure,2019,Metroidvania,"₩1,100",0%,8752,472,9224,507320000,0,0,0,0
1716310,AWAKEN - Astral Blade,2024,Metroidvania,"₩21,500",0%,723,125,848,911600000,711,135,846,909450000
200900,Cave Story+,2011,Metroidvania,"₩16,000",0%,7105,539,7644,6115200000,0,0,0,0
3214400,Rainbow Cloud: A GAY RPG,2025,Metroidvania,"₩9,900",0%,0,0,0,0,14,10,24,11880000
1229880,Koumajou Remilia: Scarlet Symphony,2022,Metroidvania,"₩29,800",0%,200,107,307,457430000,142,80,222,330780000
2986450,Metro Gravity,2025,Metroidvania,"₩14,500",0%,0,0,0,0,333,18,351,254475000
2678640,Journey of Realm：Dawn Dew,2025,Metroidvania,"₩11,000",12%,0,0,0,0,393,8,401,220550000
312200,Chasm,2018,Metroidvania,"₩7,170",65%,1817,678,2495,894457500,937,329,1266,453861000
1276800,CONVERGENCE: A League of Legends Story™,2023,Metroidvania,"₩32,000",0%,895,102,997,1595200000,818,101,919,1470400000
332200,Axiom Verge,2015,Metroidvania,"₩21,000",0%,5515,549,6064,6367200000,0,0,0,0
1005450,Vision Soft Reset,2019,Metroidvania,"₩11,000",0%,113,11,124,68200000,117,13,130,71500000
2951770,Leap Year,2024,Metroidvania,"₩5,600",0%,2201,57,2258,632240000,0,0,0,0
1330470,F.I.S.T.: Forged In Shadow Torch,2021,Metroidvania,"₩34,800",0%,5700,803,6503,11315220000,0,0,0,0
535480,Sundered®: Eldritch Edition,2017,Metroidvania,"₩21,500",0%,4067,890,4957,5328775000,0,0,0,0
449610,Monster Boy and the Cursed Kingdom,2019,Metroidvania,"₩32,000",0%,2188,267,2455,3928000000,0,0,0,0
940910,Minoria,2019,Metroidvania,"₩21,500",0%,2022,466,2488,2674600000,1442,295,1737,1867275000
1842730,Nightmare: The Lunatic,2024,Metroidvania,"₩18,500",0%,216,27,243,224775000,175,28,203,187775000
1123450,Chicory: A Colorful Tale,2021,Metroidvania,"₩21,500",0%,3343,77,3420,3676500000,0,0,0,0
2870350,Pipistrello and the Cursed Yoyo,2025,Metroidvania,"₩21,500",0%,0,0,0,0,500,10,510,548250000
835430,La-Mulana 2,2018,Metroidvania,"₩26,000",0%,845,141,986,1281800000,628,120,748,972400000
334940,Yoku's Island Express,2018,Metroidvania,"₩20,500",0%,4640,184,4824,4944600000,0,0,0,0
2371890,Chronicles of the Wolf,2025,Metroidvania,"₩22,800",0%,0,0,0,0,236,48,284,323760000
916730,Gato Roboto,2019,Metroidvania,"₩8,900",0%,4368,254,4622,2056790000,0,0,0,0
393520,Iconoclasts,2018,Metroidvania,"₩21,500",0%,4098,632,4730,5084750000,0,0,0,0
350070,Environmental Station Alpha,2015,Metroidvania,"₩8,500",0%,1228,242,1470,624750000,1132,232,1364,579700000
1352930,HAAK,2022,Metroidvania,"₩18,500",0%,2699,294,2993,2768525000,0,0,0,0
718590,Dark Devotion,2019,Metroidvania,"₩5,120",75%,1762,582,2344,600064000,1360,454,1814,464384000
275390,Guacamelee! Super Turbo Championship Edition,2014,Metroidvania,"₩16,500",0%,6234,499,6733,5554725000,0,0,0,0
421170,Indivisible,2019,Metroidvania,"₩21,500",0%,2501,1017,3518,3781850000,0,0,0,0
668550,8Doors: Arum's Afterlife Adventure,2021,Metroidvania,"₩21,000",0%,1134,320,1454,1526700000,693,184,877,920850000
208750,Apotheon,2015,Metroidvania,"₩16,500",0%,3365,374,3739,3084675000,0,0,0,0
230700,La-Mulana,2013,Metroidvania,"₩16,000",0%,1971,504,2475,1980000000,1536,408,1944,1555200000
1281790,SHEEPO,2020,Metroidvania,"₩4,200",60%,450,14,464,97440000,406,17,423,88830000
1436590,Phoenotopia: Awakening,2021,Metroidvania,"₩20,500",0%,2091,426,2517,2579925000,0,0,0,0
598700,The Vagrant,2018,Metroidvania,"₩4,500",0%,7410,851,8261,1858725000,0,0,0,0
236090,Dust: An Elysian Tail,2013,Metroidvania,"₩16,000",0%,17758,880,18638,14910400000,0,0,0,0
115800,Owlboy,2016,Metroidvania,"₩21,500",0%,4918,956,5874,6314550000,0,0,0,0
1761380,Otherworld Legends 战魂铭人,2024,Metroidvania,Free,0%,802,485,1287,0,852,501,1353,0
233980,UnEpic,2014,Metroidvania,"₩14,000",0%,7297,687,7984,5588800000,0,0,0,0
543260,Wonder Boy: The Dragon's Trap,2017,Metroidvania,"₩20,500",0%,2049,365,2414,2474350000,1595,260,1855,1901375000
2059210,DragonLoop,2025,Metroidvania,"₩9,900",0%,0,0,0,0,257,22,279,138105000
1280080,Faeland,2023,Metroidvania,"₩20,500",0%,202,15,217,222425000,166,16,182,186550000
3199390,INAYAH - Life after Gods,2025,Metroidvania,"₩18,370",0%,159,22,181,166248500,112,33,145,133182500
838310,Bloodstained: Curse of the Moon,2018,Metroidvania,"₩10,500",0%,4028,235,4263,2238075000,0,0,0,0
252030,Valdis Story: Abyssal City,2013,Metroidvania,"₩15,500",0%,2254,434,2688,2083200000,0,0,0,0
861250,Cyber Shadow,2021,Metroidvania,"₩19,800",0%,1182,228,1410,1395900000,986,202,1188,1176120000
368620,Timespinner,2018,Metroidvania,"₩21,000",0%,2494,412,2906,3051300000,0,0,0,0
1205900,Alwa's Legacy,2020,Metroidvania,"₩19,500",0%,497,69,566,551850000,382,57,439,428025000
1420080,Wonder Boy: Asha in Monster World,2021,Metroidvania,"₩21,500",0%,122,26,148,159100000,102,26,128,137600000
1231990,Gestalt: Steam & Cinder,2024,Metroidvania,"₩21,500",0%,1311,321,1632,1754400000,1174,312,1486,1597450000
946030,Axiom Verge 2,2022,Metroidvania,"₩20,500",0%,612,142,754,772850000,527,132,659,675475000
404680,Hob,2017,Metroidvania,"₩21,000",0%,4632,611,5243,5505150000,0,0,0,0
2281940,The Mobius Machine,2024,Metroidvania,"₩21,500",0%,303,51,354,380550000,271,60,331,355825000
549260,Alwa's Awakening,2017,Metroidvania,"₩11,000",0%,674,167,841,462550000,523,131,654,359700000
257850,Hyper Light Drifter,2016,Metroidvania,"₩21,000",0%,16617,1226,17843,18735150000,0,0,0,0
1589570,Dunjungle,2024,Metroidvania,"₩12,800",0%,598,12,610,390400000,573,18,591,378240000
1911360,Trinity Fusion,2023,Metroidvania,"₩21,500",0%,644,87,731,785825000,516,77,593,637475000
2936080,ReSetna,2025,Metroidvania,"₩16,500",0%,129,16,145,119625000,70,17,87,71775000
889770,UnHolY DisAsTeR,2018,Metroidvania,"₩13,500",0%,283,79,362,244350000,277,78,355,239625000
613190,Unworthy,2018,Metroidvania,"₩15,500",0%,651,153,804,623100000,579,145,724,561100000
1046400,Astalon: Tears of the Earth,2021,Metroidvania,"₩21,500",0%,1096,115,1211,1301825000,787,68,855,919125000
387290,Ori and the Blind Forest: Definitive Edition,2016,Metroidvania,"₩19,900",0%,63788,3191,66979,66644105000,0,0,0,0
2680330,HunterX: code name T,2023,Metroidvania,"₩18,500",0%,100,13,113,104525000,86,15,101,93425000
1918450,HunterX,2022,Metroidvania,"₩15,500",0%,548,105,653,506075000,519,114,633,490575000
214770,Guacamelee! Gold Edition,2013,Metroidvania,"₩16,500",0%,5539,411,5950,4908750000,0,0,0,0
1144440,UnderParty,2020,Metroidvania,"₩7,800",0%,673,112,785,306150000,658,116,774,301860000
253840,Shantae: Half-Genie Hero,2016,Metroidvania,"₩21,000",0%,2163,229,2392,2511600000,1761,196,1957,2054850000
3668950,Star Soraight Fantasy: Magic to reach the sky,2025,Metroidvania,"₩9,900",0%,33,4,37,18315000,50,5,55,27225000
1911940,Twilight Monk,2025,Metroidvania,"₩21,500",0%,183,58,241,259075000,162,63,225,241875000
2769080,Kong: Survivor Instinct,2024,Metroidvania,"₩31,960",0%,206,68,274,437852000,180,70,250,399500000
241600,Rogue Legacy,2013,Metroidvania,"₩16,500",0%,17124,1353,18477,15243525000,0,0,0,0
1588380,Blaster Master Zero 3,2021,Metroidvania,"₩16,000",0%,382,50,432,345600000,360,54,414,331200000
3382070,Queen of treasure isle,2025,Metroidvania,"₩9,900",0%,0,0,0,0,48,2,50,24750000
441280,Pharaoh Rebirth+,2016,Metroidvania,"₩10,500",0%,305,27,332,174300000,281,28,309,162225000
1924430,Cookie Cutter: Overkill Edition,2023,Metroidvania,"₩21,500",0%,912,255,1167,1254525000,590,148,738,793350000
319480,Odallus: The Dark Call,2015,Metroidvania,"₩11,000",0%,1165,155,1320,726000000,749,83,832,457600000
1000760,Foregone,2021,Metroidvania,"₩20,500",0%,1102,248,1350,1383750000,1042,244,1286,1318150000
1037020,ScourgeBringer,2020,Metroidvania,"₩17,500",0%,2614,381,2995,2620625000,0,0,0,0
1402120,9 Years of Shadows,2023,Metroidvania,"₩21,500",0%,1985,603,2588,2782100000,1488,395,1883,2024225000
814680,Unbound: Worlds Apart,2021,Metroidvania,"₩20,500",0%,1013,187,1200,1230000000,910,186,1096,1123400000
1517970,Aeterna Noctis,2021,Metroidvania,"₩32,000",0%,1339,417,1756,2809600000,1128,337,1465,2344000000
841600,Aura of Worlds,2024,Metroidvania,"₩16,500",0%,96,7,103,84975000,71,5,76,62700000
1549750,Vomitoreum,2021,Metroidvania,"₩10,500",0%,839,79,918,481950000,763,75,838,439950000
332610,Mystik Belle,2015,Metroidvania,"₩16,000",0%,192,26,218,174400000,145,26,171,136800000
1347970,Patch Quest,2023,Metroidvania,"₩17,000",0%,2479,168,2647,2249950000,1870,119,1989,1690650000
1068360,Fearmonium,2021,Metroidvania,"₩2,970",78%,409,68,477,70834500,369,70,439,65191500
1085220,Figment 2: Creed Valley,2023,Metroidvania,"₩27,000",0%,1100,73,1173,1583550000,742,47,789,1065150000
1729180,Last Vanguard,2025,Metroidvania,"₩21,500",0%,42,11,53,56975000,42,9,51,54825000
248190,Knytt Underground,2013,Metroidvania,"₩7,500",0%,391,70,461,172875000,173,38,211,79125000
844850,Tower Hunter: Erza's Trial,2019,Metroidvania,"₩18,500",0%,1330,500,1830,1692750000,1220,498,1718,1589150000
201420,Toki Tori 2+,2013,Metroidvania,"₩16,500",0%,889,157,1046,862950000,619,92,711,586575000
1220150,Blue Fire,2021,Metroidvania,"₩20,500",0%,2339,530,2869,2940725000,1465,300,1765,1809125000
1413660,Elderand,2023,Metroidvania,"₩21,500",0%,534,171,705,757875000,370,110,480,516000000
1426490,LOST EPIC,2022,Metroidvania,"₩19,500",0%,803,301,1104,1076400000,732,299,1031,1005225000
1215280,Mask of Mists,2020,Metroidvania,"₩16,500",0%,153,29,182,150150000,129,26,155,127875000
789760,DEAD OR SCHOOL,2019,Metroidvania,"₩26,000",0%,2336,433,2769,3599700000,0,0,0,0
787850,Heroine Anthem Zero 2 : Scalescars Oath,2022,Metroidvania,"₩23,000",0%,628,136,764,878600000,595,139,734,844100000
205730,Insanely Twisted Shadow Planet,2012,Metroidvania,"₩16,000",0%,754,113,867,693600000,483,66,549,439200000
2168150,Teslagrad Remastered,2023,Metroidvania,"₩10,900",0%,136,37,173,94285000,115,29,144,78480000
302790,Momodora III,2014,Metroidvania,"₩2,200",0%,1315,85,1400,154000000,1135,85,1220,134200000
612390,Dandara: Trials of Fear Edition,2018,Metroidvania,"₩16,500",0%,945,226,1171,966075000,672,118,790,651750000
203510,Fortune Summoners,2012,Metroidvania,"₩21,000",0%,727,128,855,897750000,646,123,769,807450000
2056220,Bloody Hell,2023,Metroidvania,Free,0%,5840,123,5963,0,0,0,0,0
401360,The Aquatic Adventure of the Last Human,2016,Metroidvania,"₩10,500",0%,355,115,470,246750000,304,113,417,218925000
249590,Teslagrad,2013,Metroidvania,"₩10,500",0%,2050,380,2430,1275750000,1394,285,1679,881475000
1311070,Greak: Memories of Azur,2021,Metroidvania,"₩20,500",0%,1071,298,1369,1403225000,707,177,884,906100000
1056180,Cathedral,2019,Metroidvania,"₩16,500",0%,313,104,417,344025000,207,69,276,227700000
2382240,Awita: Journey of Hope,2025,Metroidvania,"₩10,800",19%,0,0,0,0,39,19,58,31320000
2108060,The Ramsey,2023,Metroidvania,"₩19,500",0%,54,4,58,56550000,38,4,42,40950000
1557410,BLACK WITCHCRAFT,2022,Metroidvania,"₩12,000",0%,117,26,143,85800000,105,26,131,78600000
1776840,Overbowed,2024,Metroidvania,"₩9,900",0%,53,4,57,28215000,56,5,61,30195000
2815150,Hollow Floor,2024,Metroidvania,"₩3,400",0%,63,1,64,10880000,60,3,63,10710000
1597960,Ninja Brigade feat. Jonah Weingarten,2025,Metroidvania,"₩21,600",0%,22,0,22,23760000,10,0,10,10800000
286100,You Have to Win the Game,2014,Metroidvania,Free,0%,5271,404,5675,0,0,0,0,0
1096180,Ato,2020,Metroidvania,"₩15,500",0%,414,12,426,330150000,304,6,310,240250000
2642520,Princess Pomu and the 5 Moons,2025,Metroidvania,"₩13,500",0%,0,0,0,0,16,2,18,12150000
891170,The Witch & The 66 Mushrooms,2020,Metroidvania,"₩7,800",0%,168,22,190,74100000,156,21,177,69030000
463270,Ghost 1.0,2016,Metroidvania,"₩14,000",0%,1889,187,2076,1453200000,1702,189,1891,1323700000
834760,Robot Wants It All,2019,Metroidvania,"₩21,500",0%,148,19,167,179525000,138,19,157,168775000
1132910,ITORAH,2022,Metroidvania,"₩22,000",0%,563,187,750,825000000,422,164,586,644600000
896520,Stay Out of the House,2022,Metroidvania,"₩15,500",0%,1409,79,1488,1153200000,1296,83,1379,1068725000
1262040,Super Mombo Quest,2021,Metroidvania,"₩21,500",0%,706,20,726,780450000,635,26,661,710575000
3575260,Only Sliding,2025,Metroidvania,"₩5,600",0%,0,0,0,0,32,2,34,9520000
1264880,Watcher Chronicles,2022,Metroidvania,"₩20,500",0%,140,22,162,166050000,106,23,129,132225000
603020,Skautfold: Usurper,2018,Metroidvania,"₩10,500",0%,230,100,330,173250000,206,89,295,154875000
311190,Super Panda Adventures,2014,Metroidvania,"₩5,500",0%,876,62,938,257950000,666,43,709,194975000
1134520,Dark Light,2022,Metroidvania,"₩18,500",0%,552,145,697,644725000,458,129,587,542975000
1008830,孙悟空大战机器金刚 / Sun Wukong VS Robot,2019,Metroidvania,"₩3,300",0%,89,11,100,16500000,69,10,79,13035000
2433860,The Shaman's Ark,2025,Metroidvania,"₩11,000",0%,0,0,0,0,30,0,30,16500000
1622800,Super Dungeon Maker,2023,Metroidvania,"₩21,500",0%,417,63,480,516000000,314,60,374,402050000
262960,Castle In The Darkness,2015,Metroidvania,"₩6,500",0%,959,292,1251,406575000,878,277,1155,375375000
726340,Alchemist's Castle,2017,Metroidvania,"₩1,100",0%,103,30,133,7315000,52,12,64,3520000
1756020,Super Roboy,2025,Metroidvania,"₩16,500",0%,94,3,97,80025000,79,4,83,68475000
2615430,Witchroid Vania: A Magical Girl’s Fantastical Adventures,2025,Metroidvania,"₩17,000",0%,40,3,43,36550000,46,4,50,42500000
1405950,pear potion🍐,2021,Metroidvania,"₩2,200",0%,21,0,21,2310000,67,4,71,7810000
717310,Aggelos,2018,Metroidvania,"₩16,500",0%,464,132,596,491700000,384,108,492,405900000
909820,Songbird Symphony,2019,Metroidvania,"₩18,500",0%,581,65,646,597550000,480,53,533,493025000
553640,ICEY,2016,Metroidvania,"₩13,000",0%,24297,2629,26926,17501900000,0,0,0,0
460700,Song of the Deep,2016,Metroidvania,"₩16,000",0%,713,129,842,673600000,416,79,495,396000000
950300,REDO!,2019,Metroidvania,"₩10,500",0%,192,24,216,113400000,170,25,195,102375000
713160,After Death,2017,Metroidvania,"₩15,000",0%,137,15,152,114000000,122,15,137,102750000
1001800,KUNAI,2020,Metroidvania,"₩4,220",75%,446,116,562,118582000,317,100,417,87987000
730920,Super Skelemania,2017,Metroidvania,"₩5,500",0%,95,8,103,28325000,84,8,92,25300000
450440,Creepy Castle,2016,Metroidvania,"₩10,500",0%,205,23,228,119700000,184,20,204,107100000
205230,Hell Yeah! Wrath of the Dead Rabbit,2012,Metroidvania,"₩16,000",0%,3132,543,3675,2940000000,526,93,619,495200000
1853760,Frogmonster,2024,Metroidvania,"₩21,500",0%,439,12,451,484825000,444,14,458,492350000
880220,~Azur Ring~virgin and slave's phylacteries,2020,Metroidvania,"₩4,400",60%,172,76,248,54560000,152,78,230,50600000
603530,A Robot Named Fight!,2017,Metroidvania,"₩14,500",0%,752,103,855,619875000,675,92,767,556075000
603530,A Robot Named Fight!,2017,Metroidvania,"₩14,500",0%,752,103,855,619875000,675,92,767,556075000
341020,Chronicles of Teddy,2015,Metroidvania,"₩16,000",0%,221,96,317,253600000,181,78,259,207200000
1414470,Yeomna : The Legend of Dongbaek,2022,Metroidvania,"₩20,500",0%,39,34,73,74825000,24,33,57,58425000
586880,Mini Ghost,2017,Metroidvania,"₩2,200",0%,388,24,412,45320000,347,22,369,40590000
2226980,Iron Diamond,2024,Metroidvania,"₩2,220",75%,40,4,44,4884000,40,5,45,4995000
1774220,Jubilee,2021,Metroidvania,"₩5,250",50%,85,2,87,22837500,68,2,70,18375000
1449730,Scarlet City of Devils,2025,Metroidvania,"₩9,900",0%,33,1,34,16830000,19,1,20,9900000
1138960,Biomass,2020,Metroidvania,"₩16,500",0%,87,16,103,84975000,77,16,93,76725000
1035760,Glimmer in Mirror,2023,Metroidvania,"₩12,770",27%,669,223,892,569542000,558,186,744,475044000
2620730,DEVIATOR,2024,Metroidvania,"₩7,200",19%,643,274,917,330120000,562,264,826,297360000
447780,LostWinds,2016,Metroidvania,"₩10,500",0%,578,130,708,371700000,448,92,540,283500000
1573390,Lila’s Sky Ark,2022,Metroidvania,"₩13,000",0%,123,18,141,91650000,77,10,87,56550000
612140,Weebish Mines,2017,Metroidvania,"₩3,300",0%,14,1,15,2475000,13,1,14,2310000
339200,Oceanhorn: Monster of Uncharted Seas,2015,Metroidvania,"₩16,000",0%,1649,421,2070,1656000000,1037,243,1280,1024000000
699670,Feudal Alloy,2019,Metroidvania,"₩1,750",90%,644,258,902,78925000,555,249,804,70350000
3384890,Ascent DX,2025,Metroidvania,Free,0%,0,0,0,0,215,4,219,0
1843110,Makis Adventure,2023,Metroidvania,"₩11,000",0%,115,7,122,67100000,64,6,70,38500000
264060,Full Bore,2014,Metroidvania,"₩16,000",0%,202,35,237,189600000,66,9,75,60000000
1466230,The Holy Gosh Darn,2024,Metroidvania,"₩21,270",24%,219,4,223,237160500,194,4,198,210573000
1090020,JETBOY,2021,Metroidvania,"₩6,500",0%,16,1,17,5525000,9,1,10,3250000
1173200,Metal Unit,2021,Metroidvania,"₩15,500",0%,2312,484,2796,2166900000,1610,378,1988,1540700000
3895180,Azaran: The Demon Bottle,2025,Metroidvania,"₩2,300",0%,0,0,0,0,28,2,30,3450000
366320,Seasons after Fall,2016,Metroidvania,"₩11,800",0%,2451,582,3033,1789470000,0,0,0,0
2638340,The Legend of Lumina,2024,Metroidvania,Free,0%,87,1,88,0,96,3,99,0
1677380,Astronium,2022,Metroidvania,"₩3,400",0%,37,3,40,6800000,35,1,36,6120000
1677380,Astronium,2022,Metroidvania,"₩3,400",0%,37,3,40,6800000,35,1,36,6120000
437100,My Night Job,2016,Metroidvania,"₩11,000",0%,84,9,93,51150000,45,9,54,29700000
1127970,Retro Machina,2021,Metroidvania,"₩18,500",0%,203,31,234,216450000,159,24,183,169275000
269650,Dex,2015,Metroidvania,"₩20,500",0%,2972,446,3418,3503450000,0,0,0,0
1577660,Trash Quest,2021,Metroidvania,"₩3,300",0%,99,5,104,17160000,95,5,100,16500000
629090,Horace,2019,Metroidvania,"₩15,500",0%,535,130,665,515375000,286,46,332,257300000
837460,Batbarian: Testament of the Primordials,2020,Metroidvania,"₩16,500",0%,222,54,276,227700000,160,42,202,166650000
2564860,Castaway,2024,Metroidvania,"₩8,900",0%,153,50,203,90335000,141,52,193,85885000
960190,Maytroid. I swear it's a nice game too,2018,Metroidvania,"₩2,200",0%,152,37,189,20790000,137,37,174,19140000
1083310,OUTBUDDIES DX,2019,Metroidvania,"₩19,500",0%,186,79,265,258375000,126,57,183,178425000
231160,The Swapper,2013,Metroidvania,"₩16,000",0%,6929,440,7369,5895200000,0,0,0,0
640700,Narvas,2022,Metroidvania,"₩9,500",0%,19,7,26,12350000,14,6,20,9500000
341170,Adventures of Chris,2020,Metroidvania,"₩15,500",0%,158,25,183,141825000,104,9,113,87575000
1122050,Gensokyo Night Festival,2019,Metroidvania,"₩13,500",0%,3473,1093,4566,3082050000,0,0,0,0
2066220,Eris and the fading kingdom,2022,Metroidvania,"₩4,500",0%,9,2,11,2475000,8,2,10,2250000
3343360,End's Reach,2025,Metroidvania,"₩11,000",0%,8,0,8,4400000,10,0,10,5500000
1259760,The Sacred Acorn,2024,Metroidvania,"₩21,500",0%,31,4,35,37625000,24,5,29,31175000
2447120,Veiled Edge,2024,Metroidvania,"₩13,200",19%,30,0,30,19800000,20,0,20,13200000
2176510,Jrago The Demon Hunter,2023,Metroidvania,"₩11,000",0%,20,3,23,12650000,16,3,19,10450000
319140,Xeodrifter,2014,Metroidvania,"₩11,000",0%,634,200,834,458700000,546,172,718,394900000
763180,Anima Flux,2024,Metroidvania,"₩21,500",0%,102,18,120,129000000,54,14,68,73100000
1010830,Mech Chip,2019,Metroidvania,"₩5,600",0%,30,3,33,9240000,28,3,31,8680000
2781190,DragonLoop: Prologue,2025,Metroidvania,Free,0%,41,3,44,0,66,6,72,0
2848390,Nine Lives Ninja: Explore!,2024,Metroidvania,"₩1,100",0%,25,2,27,1485000,18,1,19,1045000
2675390,Shadow King,2023,Metroidvania,"₩5,600",0%,28,2,30,8400000,29,2,31,8680000
1720790,Door3:Insignia,2021,Metroidvania,"₩12,500",0%,13,2,15,9375000,10,2,12,7500000
318530,Wings of Vi,2014,Metroidvania,"₩16,000",0%,996,252,1248,998400000,784,161,945,756000000
1898610,Hands of Necromancy,2022,Metroidvania,"₩5,600",0%,287,47,334,93520000,257,38,295,82600000
2640520,Cat Warrior,2024,Metroidvania,"₩4,500",0%,0,0,0,0,61,20,81,18225000
670510,ColorBlend FX: Desaturation,2024,Metroidvania,"₩11,000",0%,35,1,36,19800000,18,1,19,10450000
2071360,Astronite - Landing on Neplea,2022,Metroidvania,Free,0%,0,0,0,0,148,28,176,0
1602370,DurDanto,2024,Metroidvania,"₩23,960",0%,12,2,14,16772000,10,1,11,13178000
537990,Heroine Anthem Zero -Sacrifice-,2016,Metroidvania,"₩10,500",0%,468,260,728,382200000,346,212,558,292950000
2280510,Side Scape,2023,Metroidvania,"₩8,900",0%,33,3,36,16020000,34,3,37,16465000
1640400,Janosik 2,2024,Metroidvania,"₩9,900",0%,45,1,46,22770000,36,1,37,18315000
418120,Cally's Caves 3,2016,Metroidvania,"₩7,500",0%,443,104,547,205125000,279,61,340,127500000
216290,Gateways,2012,Metroidvania,"₩5,500",0%,222,25,247,67925000,168,19,187,51425000
284180,Magicians & Looters,2014,Metroidvania,"₩7,500",0%,111,17,128,48000000,64,12,76,28500000
1177640,ROCKETRON,2020,Metroidvania,"₩6,700",0%,60,12,72,24120000,48,9,57,19095000
1690190,Portal Walk,2025,Metroidvania,"₩4,200",25%,9,0,9,1890000,11,0,11,2310000
800190,The Adventures of Elena Temple: Definitive Edition,2018,Metroidvania,"₩1,120",80%,59,3,62,3472000,40,2,42,2352000
1444420,WOMG Lite version,2021,Metroidvania,Free,0%,14,3,17,0,15,3,18,0
1885670,SAOMI,2022,Metroidvania,"₩1,360",60%,64,3,67,4556000,64,3,67,4556000
1888380,Byte The Bullet,2024,Metroidvania,"₩6,700",0%,33,3,36,12060000,28,2,30,10050000
2207540,Pages of Time: Prologue,2022,Metroidvania,Free,0%,0,0,0,0,2658,82,2740,0
1297390,Inexistence Rebirth,2020,Metroidvania,"₩6,600",0%,90,37,127,41910000,69,26,95,31350000
600510,GINSHA,2023,Metroidvania,"₩16,900",0%,19,2,21,17745000,18,2,20,16900000
552390,Druid,2017,Metroidvania,"₩3,400",0%,201,65,266,45220000,175,58,233,39610000
530890,Haydee,2016,Metroidvania,"₩15,500",0%,5506,987,6493,5032075000,0,0,0,0
1000000,ASCENXION,2021,Metroidvania,"₩10,500",0%,33,7,40,21000000,24,7,31,16275000
2531010,Fallen Prince,2023,Metroidvania,"₩3,400",0%,12,1,13,2210000,10,1,11,1870000
863940,Treasure Adventure Game,2021,Metroidvania,Free,0%,44,4,48,0,45,4,49,0
1256520,Bone Appetit,2020,Metroidvania,"₩8,500",0%,62,12,74,31450000,59,12,71,30175000
603930,Battle Princess Madelyn,2018,Metroidvania,"₩20,500",0%,108,41,149,152725000,64,37,101,103525000
2085800,Kalinur,2022,Metroidvania,"₩2,300",0%,460,17,477,54855000,439,18,457,52555000
1429740,Raji: Prologue,2020,Metroidvania,Free,0%,536,71,607,0,535,73,608,0
2840860,Bloom Thrice,2025,Metroidvania,"₩11,000",0%,0,0,0,0,16,1,17,9350000
530890,Haydee,2016,Metroidvania,"₩15,500",0%,5506,987,6493,5032075000,0,0,0,0
2226660,Plague of Yamorn,2023,Metroidvania,"₩6,700",0%,40,5,45,15075000,35,5,40,13400000
290040,Retro Game Crunch,2014,Metroidvania,"₩1,100",90%,331,87,418,22990000,221,52,273,15015000
463730,Bioframe Outpost,2024,Metroidvania,"₩27,000",0%,20,0,20,27000000,15,0,15,20250000
545880,Super Gear Quest,2020,Metroidvania,"₩16,500",0%,19,4,23,18975000,16,2,18,14850000
2342390,SUGAMENIA,2024,Metroidvania,"₩11,000",0%,18,1,19,10450000,9,1,10,5500000
2356150,Arcane Assembly,2024,Metroidvania,"₩8,900",0%,88,31,119,52955000,88,32,120,53400000
1688080,Aeternum Vale,2022,Metroidvania,"₩4,500",0%,21,3,24,5400000,14,3,17,3825000
1270670,Touhou Double Focus,2021,Metroidvania,"₩9,400",0%,63,23,86,40420000,60,24,84,39480000
598230,Ascender,2017,Metroidvania,"₩9,900",0%,16,3,19,9405000,12,3,15,7425000
1524350,ReversEstory,2021,Metroidvania,"₩5,600",0%,71,10,81,22680000,64,9,73,20440000
3149660,Jenny's Adventures,2025,Metroidvania,Free,0%,0,0,0,0,11,2,13,0
552610,Ninja Smasher!,2016,Metroidvania,"₩5,600",0%,18,3,21,5880000,17,3,20,5600000
288020,Rex Rocket,2014,Metroidvania,"₩1,100",0%,197,65,262,14410000,129,53,182,10010000
3642110,JK Girl Samurai - AOI no mon,2025,Metroidvania,"₩2,300",0%,23,10,33,3795000,26,9,35,4025000
454410,GIGA WRECKER,2017,Metroidvania,"₩21,000",0%,563,162,725,761250000,523,156,679,712950000
3747140,Fourmiworld,2025,Metroidvania,Free,0%,0,0,0,0,23,1,24,0
2814760,Immortals Must Die,2024,Metroidvania,"₩5,600",0%,14,3,17,4760000,12,3,15,4200000
454410,GIGA WRECKER,2017,Metroidvania,"₩21,000",0%,563,162,725,761250000,523,156,679,712950000
607400,Necrosphere,2017,Metroidvania,"₩8,500",0%,130,14,144,61200000,106,11,117,49725000
3115150,Vyanka's Memories,2024,Metroidvania,"₩11,000",0%,45,0,45,24750000,13,0,13,7150000
1288930,Hargrave,2020,Metroidvania,Free,0%,237,19,256,0,236,20,256,0
1839590,Moonlaw,2021,Metroidvania,Free,0%,0,0,0,0,81,33,114,0
2079500,Colorless World,2022,Metroidvania,"₩2,300",0%,13,2,15,1725000,11,1,12,1380000
463220,Dungeon of Zolthan,2016,Metroidvania,"₩1,100",0%,403,122,525,28875000,299,84,383,21065000
2562900,Eden Genesis,2024,Metroidvania,"₩27,000",0%,100,7,107,144450000,70,4,74,99900000
1745520,REDSHOT,2022,Metroidvania,"₩11,000",0%,20,4,24,13200000,12,4,16,8800000
479110,Hunter's Legacy,2016,Metroidvania,"₩7,500",0%,39,13,52,19500000,31,9,40,15000000
1399750,Beholgar,2022,Metroidvania,"₩2,850",70%,231,77,308,43890000,209,62,271,38617500
1193760,WarriOrb: Prologue,2019,Metroidvania,Free,0%,351,45,396,0,348,47,395,0
677910,Life on Mars Remake,2017,Metroidvania,"₩18,500",0%,38,3,41,37925000,29,3,32,29600000
2222310,Disavowed,2022,Metroidvania,Free,0%,0,0,0,0,12,2,14,0
1663930,ColorBlend FX: Desaturation Prologue,2021,Metroidvania,Free,0%,0,0,0,0,66,6,72,0
694990,Goblin and Coins II,2023,Metroidvania,"₩4,500",0%,21,2,23,5175000,13,2,15,3375000
1397760,Pulse Jumper,2021,Metroidvania,Free,0%,18,4,22,0,19,4,23,0
3597480,HOMESICKNESS,2025,Metroidvania,"₩8,900",0%,26,0,26,11570000,35,3,38,16910000
1444750,DreamWatcher,2020,Metroidvania,Free,0%,60,12,72,0,60,12,72,0
2705890,Goodboy Galaxy,2024,Metroidvania,"₩27,000",0%,113,4,117,157950000,85,3,88,118800000
1133200,Escape Zolstar,2019,Metroidvania,"₩3,300",0%,10,0,10,1650000,10,0,10,1650000
870140,Treasure Hunter Man 2,2018,Metroidvania,"₩2,200",0%,16,1,17,1870000,14,1,15,1650000
1998200,God Edge,2022,Metroidvania,"₩2,200",60%,14,1,15,1650000,13,1,14,1540000
1428840,10mg: SNAAAK,2020,Metroidvania,"₩2,200",0%,16,1,17,1870000,13,1,14,1540000
2346470,All Goblin,2023,Metroidvania,"₩5,600",0%,27,2,29,8120000,23,2,25,7000000
822540,Escape From Tethys,2018,Metroidvania,"₩5,500",0%,309,137,446,122650000,81,26,107,29425000
2346470,All Goblin,2023,Metroidvania,"₩5,600",0%,27,2,29,8120000,23,2,25,7000000
2055490,A Game with a Kitty 1 & Darkside Adventures,2022,Metroidvania,Free,0%,0,0,0,0,17,0,17,0
800240,Ghostly Matter,2018,Metroidvania,"₩10,800",0%,30,15,45,24300000,25,16,41,22140000
1311660,Friendly Fire,2020,Metroidvania,Free,0%,966,56,1022,0,966,62,1028,0
393600,Robot Exploration Squad,2015,Metroidvania,"₩3,300",0%,22,8,30,4950000,11,1,12,1980000
1340770,Artifacts,2020,Metroidvania,"₩4,400",0%,9,3,12,2640000,9,3,12,2640000
1256380,FPS Infinite,2020,Metroidvania,Free,0%,96,17,113,0,98,17,115,0
1989150,Thread,2022,Metroidvania,"₩11,500",0%,19,4,23,13225000,18,4,22,12650000
1013650,Tiny Dangerous Dungeons,2019,Metroidvania,"₩5,600",0%,82,4,86,24080000,73,5,78,21840000
2212390,AOI,2022,Metroidvania,"₩5,600",0%,31,12,43,12040000,30,12,42,11760000
1489850,Dispersio 2,2021,Metroidvania,Free,0%,21,8,29,0,21,8,29,0
1783090,Marmoset,2021,Metroidvania,"₩1,100",0%,36,5,41,2255000,31,3,34,1870000
1651610,Last Night of Winter,2022,Metroidvania,"₩10,500",0%,59,6,65,34125000,27,5,32,16800000
1412170,Janosik,2020,Metroidvania,Free,0%,598,40,638,0,602,45,647,0
1936990,FROGUE,2024,Metroidvania,"₩13,500",0%,36,1,37,24975000,26,1,27,18225000
1072110,Tartapolis,2021,Metroidvania,"₩11,000",0%,15,3,18,9900000,9,3,12,6600000
1515490,System Purge,2022,Metroidvania,"₩5,500",0%,161,5,166,45650000,157,8,165,45375000
2547400,The Spectral Web: Hitodama,2023,Metroidvania,"₩3,400",0%,22,0,22,3740000,18,0,18,3060000
790360,WarriOrb,2020,Metroidvania,"₩13,500",0%,136,35,171,115425000,93,29,122,82350000
482330,Legends of the Universe - StarCore,2016,Metroidvania,"₩2,300",0%,94,27,121,13915000,78,28,106,12190000
2179450,Massi,2022,Metroidvania,"₩5,600",0%,5,1,6,1680000,10,1,11,3080000
570110,"Tim-Tim 2: ""The Almighty Gnome""",2022,Metroidvania,"₩8,900",0%,14,1,15,6675000,14,1,15,6675000
2328990,Dystobel,2024,Metroidvania,"₩6,700",0%,24,0,24,8040000,12,0,12,4020000
1971260,Orc Tales: Olgob The Bold,2023,Metroidvania,"₩5,600",0%,22,1,23,6440000,16,1,17,4760000
2357950,Q2 HUMANITY,2024,Metroidvania,"₩9,900",0%,47,4,51,25245000,43,3,46,22770000
2126590,Brichi Quest,2023,Metroidvania,Free,0%,5,2,7,0,12,2,14,0
771700,Airhead,2024,Metroidvania,"₩21,500",0%,53,4,57,61275000,16,1,17,18275000
1267170,Carestia,2021,Metroidvania,"₩4,500",0%,19,1,20,4500000,11,1,12,2700000
2571500,Speedollama,2024,Metroidvania,"₩9,900",0%,21,1,22,10890000,18,0,18,8910000
884350,The Unfolding Engine: Paint a Game,2018,Metroidvania,Free,0%,24,6,30,0,24,6,30,0
588110,One Dog Story,2017,Metroidvania,"₩8,450",0%,405,109,514,217165000,178,77,255,107737500
2646060,Luna's Light,2024,Metroidvania,"₩6,700",0%,36,8,44,14740000,23,8,31,10385000
2500570,Little Droid,2024,Metroidvania,"₩7,800",0%,13,1,14,5460000,10,2,12,4680000
1823170,Cosmos Bit,2022,Metroidvania,"₩5,600",0%,74,7,81,22680000,72,8,80,22400000
1090060,Weapon Hacker,2020,Metroidvania,"₩10,500",0%,33,2,35,18375000,23,2,25,13125000
1222540,Gastova: The Witches of Arkana,2022,Metroidvania,"₩16,500",0%,31,0,31,25575000,19,0,19,15675000
820620,Spooky Ghosts Dot Com,2018,Metroidvania,"₩5,600",0%,41,7,48,13440000,34,8,42,11760000
512120,Nakiti Generations,2017,Metroidvania,"₩7,500",0%,17,14,31,11625000,13,10,23,8625000
1668650,Maya Star,2022,Metroidvania,"₩5,600",0%,7,3,10,2800000,7,3,10,2800000
394540,Spaceport Hope,2016,Metroidvania,"₩2,300",0%,372,110,482,55430000,309,98,407,46805000
510240,forma.8,2017,Metroidvania,"₩10,500",0%,43,9,52,27300000,32,7,39,20475000
1080040,Moo Lander,2022,Metroidvania,"₩19,900",0%,44,5,49,48755000,20,3,23,22885000
1373740,Prehistoric Dude,2020,Metroidvania,"₩5,600",0%,16,3,19,5320000,13,3,16,4480000
1960070,RIN: The Last Child,2024,Metroidvania,"₩21,500",0%,44,26,70,75250000,31,27,58,62350000
227200,Waking Mars,2012,Metroidvania,"₩10,500",0%,1054,133,1187,623175000,575,71,646,339150000
1366260,Soul Device,2023,Metroidvania,"₩5,600",0%,13,2,15,4200000,12,2,14,3920000
1489590,Astronite,2022,Metroidvania,"₩15,500",0%,124,37,161,124775000,101,39,140,108500000
2790020,Space Sprouts,2025,Metroidvania,"₩12,500",0%,45,0,45,28125000,38,0,38,23750000
985590,Necrolepsy,2019,Metroidvania,"₩5,500",0%,33,0,33,9075000,28,0,28,7700000
2266400,The Last Duskreaper,2023,Metroidvania,Free,0%,0,0,0,0,10,1,11,0
3337340,Templar,2025,Metroidvania,Free,0%,0,0,0,0,24,6,30,0
3410640,Rogue Worlds,2025,Metroidvania,Free,0%,0,0,0,0,46,0,46,0
1823030,Cursed Broom,2024,Metroidvania,"₩11,000",0%,16,2,18,9900000,11,2,13,7150000
1294750,Dr. Atominus,2020,Metroidvania,"₩1,980",55%,15,4,19,1881000,12,4,16,1584000
1823370,Berry,2021,Metroidvania,Free,0%,0,0,0,0,118,1,119,0
1741030,Sanae Toumaden X2,2022,Metroidvania,"₩8,900",0%,15,5,20,8900000,10,5,15,6675000
3234730,"Blue Rabbit, Black Future",2024,Metroidvania,Free,0%,0,0,0,0,9,2,11,0
2027350,Wanderer,2022,Metroidvania,"₩5,500",0%,17,7,24,6600000,37,11,48,13200000
752500,Ghoulboy - Dark Sword of Goblin,2017,Metroidvania,"₩1,650",70%,180,75,255,21037500,119,33,152,12540000
818410,Space Hole 2018,2019,Metroidvania,"₩4,500",0%,44,6,50,11250000,25,0,25,5625000
3450800,Bloodline,2025,Metroidvania,Free,0%,0,0,0,0,11,3,14,0
562290,Zahalia: The Knights of Galiveth,2017,Metroidvania,"₩1,100",0%,22,20,42,2310000,19,16,35,1925000
316970,The Waste Land,2014,Metroidvania,"₩10,500",0%,51,49,100,52500000,43,43,86,45150000
405970,Flat Kingdom Paper's Cut Edition,2016,Metroidvania,"₩8,500",0%,145,53,198,84150000,40,12,52,22100000
1427620,Caapora Adventure - Ojibe's Revenge,2022,Metroidvania,"₩4,500",0%,23,5,28,6300000,21,5,26,5850000
3469500,Golden Knight,2025,Metroidvania,"₩4,500",0%,19,0,19,4275000,11,0,11,2475000
355140,Traps N' Gemstones,2015,Metroidvania,"₩5,500",0%,19,6,25,6875000,19,5,24,6600000
1575430,The Bounty Huntress,2021,Metroidvania,"₩4,400",0%,16,7,23,5060000,14,7,21,4620000
610570,Paradox Soul,2018,Metroidvania,"₩5,600",0%,39,40,79,22120000,21,22,43,12040000
1841270,Unstrong,2021,Metroidvania,Free,0%,0,0,0,0,11,4,15,0
1891740,Lost Wish: In the desperate world,2022,Metroidvania,"₩4,500",0%,22,6,28,6300000,18,6,24,5400000
871210,Lamp Chronicle,2021,Metroidvania,"₩14,900",0%,52,26,78,58110000,43,24,67,49915000
926450,Thibalryn,2019,Metroidvania,Free,0%,27,6,33,0,27,6,33,0
2167040,Pocket Witch,2022,Metroidvania,"₩2,300",0%,39,1,40,4600000,39,1,40,4600000
1570850,Frauki's Adventure!,2021,Metroidvania,Free,0%,35,9,44,0,35,10,45,0
2074600,Pentacore,2023,Metroidvania,"₩11,000",0%,7,4,11,6050000,7,4,11,6050000
2365560,IguaRPG,2023,Metroidvania,"₩5,600",0%,25,0,25,7000000,16,0,16,4480000
1047870,Something Ate My Alien,2020,Metroidvania,"₩17,500",0%,54,6,60,52500000,35,5,40,35000000
1881160,Covid Carl,2022,Metroidvania,"₩2,830",0%,15,2,17,2405500,12,2,14,1981000
205690,1000 Amps,2012,Metroidvania,"₩5,500",0%,265,71,336,92400000,99,31,130,35750000
845840,Laser Maze,2019,Metroidvania,"₩5,500",0%,17,3,20,5500000,15,2,17,4675000
602880,Powernaut VANGARDT,2017,Metroidvania,"₩1,100",0%,30,8,38,2090000,29,9,38,2090000
1475170,Boots Versus Plants,2021,Metroidvania,"₩11,000",0%,21,9,30,16500000,19,4,23,12650000
716150,Nakawak: Expanded Color Edition,2017,Metroidvania,"₩5,500",0%,22,7,29,7975000,22,7,29,7975000
1699960,Falta,2021,Metroidvania,"₩5,600",0%,37,1,38,10640000,28,1,29,8120000
1535780,Imp of the Sun,2022,Metroidvania,"₩20,500",0%,138,66,204,209100000,96,47,143,146575000
1803760,Windmills,2023,Metroidvania,"₩9,990",0%,32,9,41,20479500,32,9,41,20479500
576050,Other Worlds India,2017,Metroidvania,"₩1,100",0%,81,51,132,7260000,68,44,112,6160000
1033780,Lootbox Lyfe,2020,Metroidvania,"₩5,500",0%,31,6,37,10175000,23,6,29,7975000
1711700,Souno's Curse,2024,Metroidvania,"₩11,000",0%,16,5,21,11550000,6,4,10,5500000
623380,Cybermotion,2017,Metroidvania,"₩8,500",0%,70,16,86,36550000,61,13,74,31450000
1295260,Clockwork Calamity in Mushroom World: What would you do if the time stopped ticking?,2021,Metroidvania,Free,0%,57,2,59,0,55,4,59,0
764470,Gear Path,2017,Metroidvania,"₩1,100",0%,13,4,17,935000,9,2,11,605000
325880,Crystal Catacombs,2015,Metroidvania,"₩8,500",0%,38,49,87,36975000,12,10,22,9350000
383270,Hue,2016,Metroidvania,"₩16,000",0%,9736,788,10524,8419200000,1401,105,1506,1204800000
498620,The Shadowland,2016,Metroidvania,"₩5,600",0%,64,45,109,30520000,45,27,72,20160000
1941740,The Adventures of Poppe,2022,Metroidvania,"₩5,600",0%,40,9,49,13720000,27,7,34,9520000
447800,LostWinds 2: Winter of the Melodias,2016,Metroidvania,"₩10,500",0%,264,55,319,167475000,242,39,281,147525000
555710,Zolg,2016,Metroidvania,"₩1,100",0%,178,46,224,12320000,155,44,199,10945000
2578940,NO Logic,2023,Metroidvania,"₩3,400",0%,36,5,41,6970000,33,4,37,6290000
268770,Treasure Adventure World,2018,Metroidvania,"₩11,000",0%,227,50,277,152350000,160,48,208,114400000
2421690,Palladium,2023,Metroidvania,"₩11,000",0%,15,2,17,9350000,13,0,13,7150000
3642660,Fear the Timeloop - Prologue,2025,Metroidvania,Free,0%,0,0,0,0,176,22,198,0
455110,Pertinence,2016,Metroidvania,"₩4,400",0%,27,10,37,8140000,5,6,11,2420000
1428710,The Tarnishing of Juxtia,2022,Metroidvania,"₩25,130",0%,396,183,579,727513500,331,170,501,629506500
1953670,Quetzal's Call,2025,Metroidvania,"₩11,000",0%,25,1,26,14300000,28,4,32,17600000
1235830,Dark Water : Slime Invader,2021,Metroidvania,"₩15,500",0%,165,9,174,134850000,119,9,128,99200000
1098080,3000th Duel,2019,Metroidvania,"₩15,500",0%,438,169,607,470425000,341,114,455,352625000
1163560,SuperEpic: The Entertainment War,2019,Metroidvania,"₩18,500",0%,72,33,105,97125000,57,25,82,75850000
851280,MindSeize,2020,Metroidvania,"₩16,500",0%,226,71,297,245025000,151,59,210,173250000
1452260,8 Bit Space,2020,Metroidvania,"₩5,500",0%,27,2,29,7975000,26,2,28,7700000
2181710,Me With Me,2022,Metroidvania,"₩2,110",0%,37,1,38,4009000,35,1,36,3798000
3719080,Elysian Siege,2025,Metroidvania,Free,0%,0,0,0,0,26,2,28,0
748880,External Visions,2017,Metroidvania,Free,0%,43,13,56,0,45,14,59,0
408060,SAVAGE: The Shard of Gosen,2019,Metroidvania,"₩18,500",0%,60,15,75,69375000,48,15,63,58275000
1022010,Oliver's Adventures in the Fairyland,2019,Metroidvania,"₩5,500",0%,33,6,39,10725000,29,6,35,9625000
1492120,Summit,2023,Metroidvania,"₩5,600",0%,9,2,11,3080000,8,2,10,2800000
1101800,10mg: Always Down,2020,Metroidvania,"₩1,100",0%,37,1,38,2090000,32,1,33,1815000
635250,Evil Genome 光明重影,2017,Metroidvania,"₩15,500",0%,356,162,518,401450000,275,129,404,313100000
386340,MegaSphere,2015,Metroidvania,"₩15,500",0%,87,42,129,99975000,61,36,97,75175000
1015190,Double Damnation,2022,Metroidvania,Free,0%,0,0,0,0,17,5,22,0
487160,Trials of Azra,2016,Metroidvania,"₩8,900",0%,108,14,122,54290000,94,14,108,48060000
471700,Greedy Guns,2017,Metroidvania,"₩16,000",0%,67,14,81,64800000,31,13,44,35200000
293440,Elliot Quest,2014,Metroidvania,"₩10,500",0%,137,50,187,98175000,61,27,88,46200000
487160,Trials of Azra,2016,Metroidvania,"₩8,900",0%,108,14,122,54290000,94,14,108,48060000
1969000,Yupitergrad 2: The Lost Station,2023,Metroidvania,"₩19,500",0%,17,3,20,19500000,13,3,16,15600000
2222930,Project RyME,2024,Metroidvania,"₩16,500",0%,14,2,16,13200000,14,2,16,13200000
1747560,Chronicles of 2 Heroes: Amaterasu's Wrath,2023,Metroidvania,"₩6,450",70%,50,10,60,19350000,24,10,34,10965000
496310,Momento Temporis: Light from the Deep,2016,Metroidvania,"₩5,500",0%,36,12,48,13200000,12,8,20,5500000
1089930,Aeon Must Die!,2021,Metroidvania,"₩22,800",0%,64,52,116,132240000,44,43,87,99180000
928990,Undungeon,2021,Metroidvania,"₩4,300",80%,237,131,368,79120000,154,79,233,50095000
313960,Exodus,2014,Metroidvania,"₩1,100",0%,15,12,27,1485000,14,12,26,1430000
628320,Roah,2019,Metroidvania,"₩26,000",0%,56,17,73,94900000,42,16,58,75400000
511010,TAIKER,2016,Metroidvania,"₩5,500",0%,23,15,38,10450000,21,16,37,10175000
698040,Legends of the Universe - Cosmic Bounty,2018,Metroidvania,"₩2,300",0%,22,10,32,3680000,17,9,26,2990000
528010,Eternal Return,2017,Metroidvania,"₩5,000",0%,20,15,35,8750000,14,12,26,6500000
1472540,Save me Mr Tako: Definitive Edition,2021,Metroidvania,"₩15,500",0%,35,8,43,33325000,21,9,30,23250000
2194820,Koboo: The Tree Spirit - Prologue,2024,Metroidvania,Free,0%,0,0,0,0,27,3,30,0
1522230,Wild West Crops,2021,Metroidvania,"₩5,600",0%,13,3,16,4480000,9,2,11,3080000
2473310,Fledge,2024,Metroidvania,"₩5,600",0%,17,1,18,5040000,14,1,15,4200000
933450,Wenjia,2018,Metroidvania,"₩9,500",0%,295,75,370,175750000,179,60,239,113525000
1867070,Darxanadon,2022,Metroidvania,"₩1,100",0%,44,21,65,3575000,43,22,65,3575000
525380,Demon Peak,2017,Metroidvania,Free,0%,162,70,232,0,161,73,234,0
1079200,Piko Piko,2022,Metroidvania,"₩11,550",30%,81,53,134,77385000,61,52,113,65257500
727510,Void Memory,2017,Metroidvania,Free,0%,151,73,224,0,154,76,230,0
1882120,Destinesia,2023,Metroidvania,"₩16,000",0%,10,4,14,11200000,9,4,13,10400000
1633460,罪印 Seal of sins,2021,Metroidvania,"₩3,300",0%,13,5,18,2970000,9,5,14,2310000
329380,Stealth Inc 2: A Game of Clones,2015,Metroidvania,"₩16,000",0%,777,253,1030,824000000,85,32,117,93600000
1882120,Destinesia,2023,Metroidvania,"₩16,000",0%,10,4,14,11200000,9,4,13,10400000
418670,Pankapu,2016,Metroidvania,"₩13,000",0%,816,435,1251,813150000,182,64,246,159900000
1879680,Candle Knight,2023,Metroidvania,"₩16,600",0%,35,10,45,37350000,20,10,30,24900000
1867070,Darxanadon,2022,Metroidvania,"₩1,100",0%,44,21,65,3575000,43,22,65,3575000
2447920,Quebec Mortis,2023,Metroidvania,"₩9,900",0%,14,0,14,6930000,13,0,13,6435000
444720,Inexistence,2016,Metroidvania,"₩6,500",0%,242,126,368,119600000,195,109,304,98800000
1962030,Blade Jumper,2022,Metroidvania,"₩7,500",0%,41,7,48,18000000,15,5,20,7500000
314370,boxlife,2016,Metroidvania,"₩1,100",0%,114,31,145,7975000,70,20,90,4950000
931860,Sydney Hunter and the Curse of the Mayan,2019,Metroidvania,"₩10,500",0%,77,11,88,46200000,52,7,59,30975000
1562020,Abyss of Neptune,2021,Metroidvania,Free,0%,0,0,0,0,141,67,208,0
2751580,Templar 2,2024,Metroidvania,"₩1,700",50%,17,3,20,1700000,14,3,17,1445000
263980,Out There Somewhere,2016,Metroidvania,"₩4,860",0%,6433,483,6916,1680588000,0,0,0,0
1724300,The Little Brave,2025,Metroidvania,"₩12,500",0%,28,6,34,21250000,12,1,13,8125000
1124560,Fallen Angel,2020,Metroidvania,"₩15,500",0%,119,44,163,126325000,81,36,117,90675000
986310,Recompile,2021,Metroidvania,"₩20,500",0%,112,52,164,168100000,90,45,135,138375000
319450,Chariot,2014,Metroidvania,"₩16,000",0%,360,81,441,352800000,244,50,294,235200000
265790,Residue: Final Cut,2014,Metroidvania,"₩2,200",0%,69,44,113,12430000,25,9,34,3740000
255070,Abyss Odyssey,2014,Metroidvania,"₩6,200",60%,1576,937,2513,779030000,846,416,1262,391220000
1952400,New Horizon,2022,Metroidvania,"₩6,500",0%,13,13,26,8450000,13,13,26,8450000
224760,FEZ,2013,Metroidvania,"₩10,500",0%,14425,1137,15562,8170050000,0,0,0,0
569290,Metamorfose S,2017,Metroidvania,"₩5,600",0%,209,52,261,73080000,186,52,238,66640000
391600,King Lucas,2016,Metroidvania,"₩5,600",0%,98,49,147,41160000,53,32,85,23800000
3507680,Stone 4 Souls,2025,Metroidvania,"₩11,000",0%,8,3,11,6050000,7,4,11,6050000
3328410,Slumbering Feline,2025,Metroidvania,Free,0%,0,0,0,0,18,10,28,0
2319920,Cantirium: God Slayer,2023,Metroidvania,"₩8,900",0%,15,11,26,11570000,7,10,17,7565000
746000,Haxor,2019,Metroidvania,"₩7,500",0%,15,7,22,8250000,6,5,11,4125000
600130,Valfaris,2019,Metroidvania,"₩26,000",0%,2093,441,2534,3294200000,1346,219,1565,2034500000
2840530,Winnie-The-Pooh Taste Test,2024,Metroidvania,Free,0%,17,6,23,0,17,6,23,0
1557510,Myastere -Ruins of Deazniff-,2021,Metroidvania,"₩20,500",0%,23,11,34,34850000,15,11,26,26650000
1621420,After Shadows,2021,Metroidvania,"₩15,500",0%,8,5,13,10075000,6,5,11,8525000
251410,Dark Matter,2013,Metroidvania,"₩11,000",0%,112,146,258,141900000,81,113,194,106700000
3262210,Jungle Jim,2024,Metroidvania,Free,0%,7,4,11,0,8,4,12,0
517320,GunGirl 2,2016,Metroidvania,Free,0%,150,13,163,0,152,13,165,0
356580,Aerannis,2015,Metroidvania,"₩1,490",0%,93,41,134,9983000,56,26,82,6109000
2161590,Bike Arena,2022,Metroidvania,"₩5,600",0%,7,5,12,3360000,7,3,10,2800000
568070,Mable & The Wood,2019,Metroidvania,"₩15,500",0%,44,36,80,62000000,27,21,48,37200000
3776680,Sunfluffs,2025,Metroidvania,"₩13,500",0%,0,0,0,0,34,0,34,22950000
1769100,Cosmic: A Journey Among Shadows,2025,Metroidvania,"₩18,500",0%,19,7,26,24050000,12,6,18,16650000
305740,Pitiri 1977,2014,Metroidvania,"₩4,500",0%,67,50,117,26325000,16,9,25,5625000
597860,Nightmare Boy,2017,Metroidvania,"₩10,440",0%,25,16,41,21402000,17,12,29,15138000
956310,Musashi vs Cthulhu,2024,Metroidvania,"₩5,600",0%,53,4,57,15960000,34,2,36,10080000
1309940,Lorera,2020,Metroidvania,Free,0%,37,9,46,0,38,10,48,0
798240,CRYEP,2018,Metroidvania,"₩13,500",0%,22,5,27,18225000,15,0,15,10125000
1727130,Legends of Dionysos,2024,Metroidvania,"₩11,000",0%,17,4,21,11550000,10,3,13,7150000
262370,A.N.N.E,2019,Metroidvania,"₩16,500",0%,20,17,37,30525000,9,9,18,14850000
1229890,Koumajou Remilia Ⅱ: Stranger's Requiem,2023,Metroidvania,"₩29,800",0%,55,8,63,93870000,40,9,49,73010000
492610,One Day : The Sun Disappeared,2016,Metroidvania,"₩1,100",0%,14,23,37,2035000,14,14,28,1540000
1234120,AeternoBlade,2020,Metroidvania,"₩11,500",0%,21,13,34,19550000,14,13,27,15525000
1433430,Level 20,2020,Metroidvania,"₩1,100",0%,15,0,15,825000,14,0,14,770000
503480,Mahluk:Dark Demon,2016,Metroidvania,"₩1,320",70%,108,56,164,10824000,62,29,91,6006000
789950,INFERNIUM,2018,Metroidvania,"₩31,000",0%,121,64,185,286750000,104,59,163,252650000
777820,The Quest for the BIG KEY,2018,Metroidvania,"₩2,200",0%,19,4,23,2530000,10,3,13,1430000
219890,Antichamber,2013,Metroidvania,"₩21,000",0%,16269,846,17115,17970750000,0,0,0,0
315340,A.R.E.S. Extinction Agenda EX,2014,Metroidvania,"₩10,500",0%,145,54,199,104475000,109,47,156,81900000
315850,Amazing Princess Sarah,2014,Metroidvania,"₩5,600",0%,152,74,226,63280000,129,67,196,54880000
736240,The Revolt: Awakening,2021,Metroidvania,"₩12,500",0%,18,0,18,11250000,11,0,11,6875000
1051900,Exit Limbo: Opening,2020,Metroidvania,"₩11,000",0%,29,12,41,22550000,22,11,33,18150000
817220,The Forestale,2019,Metroidvania,"₩4,400",0%,32,1,33,7260000,21,1,22,4840000
1211540,bobo robot,2020,Metroidvania,"₩3,300",0%,62,7,69,11385000,38,5,43,7095000
843360,Rift Keeper,2019,Metroidvania,"₩10,500",0%,57,23,80,42000000,27,20,47,24675000
818360,Wildbus,2019,Metroidvania,"₩7,800",0%,47,7,54,21060000,11,4,15,5850000
1119010,Flippin Kaktus,2022,Metroidvania,"₩12,500",0%,9,5,14,8750000,5,5,10,6250000
537000,Nelo,2017,Metroidvania,"₩5,500",0%,101,40,141,38775000,92,39,131,36025000
645380,Heroes of Umbra,2018,Metroidvania,"₩11,000",0%,41,7,48,26400000,33,7,40,22000000
1112050,Time For Quest,2019,Metroidvania,"₩8,900",0%,24,7,31,13795000,13,6,19,8455000
453350,Vaccine War,2016,Metroidvania,"₩8,500",0%,22,8,30,12750000,10,6,16,6800000
2176430,Testament: The Order of High Human,2023,Metroidvania,"₩21,500",0%,46,56,102,109650000,34,48,82,88150000
306440,Oblitus,2015,Metroidvania,"₩16,000",0%,68,67,135,108000000,57,52,109,87200000
1147280,Column on the Sea,2019,Metroidvania,"₩11,500",0%,10,2,12,6900000,9,2,11,6325000
2056830,The Lost Key,2024,Metroidvania,"₩7,800",0%,18,8,26,10140000,17,9,26,10140000
556710,Marrow,2016,Metroidvania,"₩5,250",50%,35,13,48,12600000,32,12,44,11550000
2523310,Lingo 2,2025,Metroidvania,"₩11,000",0%,286,12,298,163900000,308,16,324,178200000
209330,A Valley Without Wind,2012,Metroidvania,"₩16,500",0%,307,202,509,419925000,122,72,194,160050000
1991090,Falling Elevator,2022,Metroidvania,"₩1,100",0%,12,5,17,935000,12,1,13,715000
675910,Visual Out,2018,Metroidvania,"₩10,500",0%,12,3,15,7875000,11,2,13,6825000
1130710,Bookbound Brigade,2020,Metroidvania,"₩20,500",0%,25,11,36,36900000,9,7,16,16400000
432950,Orange Moon,2017,Metroidvania,"₩10,500",0%,73,34,107,56175000,23,13,36,18900000
574500,Gearend,2017,Metroidvania,"₩5,500",0%,11,1,12,3300000,10,1,11,3025000
1253520,Heidelberg 1693,2021,Metroidvania,"₩15,500",0%,66,14,80,62000000,49,12,61,47275000
1611540,Magic Frame,2021,Metroidvania,"₩1,100",0%,13,11,24,1320000,12,8,20,1100000
331400,Luna: Shattered Hearts: Episode 1,2014,Metroidvania,"₩3,400",0%,20,46,66,11220000,10,8,18,3060000
1209490,Exit the Gungeon,2020,Metroidvania,"₩11,000",0%,2655,870,3525,1938750000,0,0,0,0
785880,OVERWHELM,2018,Metroidvania,"₩10,500",0%,198,34,232,121800000,181,34,215,112875000
1120810,Eastern Exorcist,2021,Metroidvania,"₩18,500",0%,5497,993,6490,6003250000,0,0,0,0
2251320,Sylvio And The Mountain Giants,2023,Metroidvania,Free,0%,8,2,10,0,10,2,12,0
268990,The Dishwasher: Vampire Smile,2017,Metroidvania,"₩10,500",0%,1461,78,1539,807975000,1418,91,1509,792225000
1290110,Ginseng Hero,2020,Metroidvania,"₩3,300",0%,29,10,39,6435000,26,7,33,5445000
931000,"URUZ ""Return of The Er Kishi""",2020,Metroidvania,"₩5,600",0%,439,129,568,159040000,407,121,528,147840000
2830480,Gentoo Rescue,2025,Metroidvania,"₩17,200",19%,34,0,34,29240000,59,0,59,50740000
3004090,Unbodied,2024,Metroidvania,"₩4,500",0%,22,0,22,4950000,18,0,18,4050000
1695260,Timothy and the Tower of Mu,2022,Metroidvania,"₩12,500",0%,22,12,34,21250000,10,10,20,12500000
506760,Twisty's Asylum Escapades,2016,Metroidvania,"₩5,500",0%,33,27,60,16500000,33,21,54,14850000
406090,Enigmoon,2015,Metroidvania,"₩20,500",0%,557,198,755,773875000,5,5,10,10250000
510490,The Fall Part 2: Unbound,2018,Metroidvania,"₩17,500",0%,540,125,665,581875000,488,122,610,533750000
303260,TRISTOY,2015,Metroidvania,"₩7,800",0%,94,63,157,61230000,40,22,62,24180000
1027480,Birth of a Hunter,2019,Metroidvania,Free,0%,12,7,19,0,11,7,18,0
2402650,Rusty's Day Off: Episode One - Janitor on Duty,2024,Metroidvania,"₩16,500",0%,12,2,14,11550000,10,2,12,9900000
1726160,If you win...you lose !,2022,Metroidvania,Free,0%,0,0,0,0,8,8,16,0
1726160,If you win...you lose !,2022,Metroidvania,Free,0%,0,0,0,0,8,8,16,0
436530,Bullshot,2016,Metroidvania,"₩1,000",0%,197,80,277,13850000,159,71,230,11500000
246680,Secrets of Rætikon,2014,Metroidvania,"₩11,000",0%,290,194,484,266200000,115,52,167,91850000
361600,Luna Sky,2015,Metroidvania,"₩14,500",0%,141,90,231,167475000,13,7,20,14500000
2584050,Slaughter: The Lost Outpost,2023,Metroidvania,"₩5,600",0%,25,7,32,8960000,10,2,12,3360000
1203470,Earth Analog,2021,Metroidvania,"₩27,000",0%,69,37,106,143100000,61,33,94,126900000
1296860,Enter Digiton,2020,Metroidvania,"₩10,500",0%,24,9,33,17325000,15,9,24,12600000
459760,Exotic Matter,2018,Metroidvania,"₩20,500",0%,16,12,28,28700000,7,6,13,13325000
516120,Juno's Darkest Hour,2016,Metroidvania,"₩3,400",0%,17,4,21,3570000,15,3,18,3060000
1003830,Cold Silence,2019,Metroidvania,Free,0%,8,2,10,0,10,3,13,0
420790,StarBreak,2016,Metroidvania,Free,0%,1009,270,1279,0,1003,283,1286,0
2067330,Fateless Night,2023,Metroidvania,"₩5,600",0%,13,0,13,3640000,10,0,10,2800000
392410,Toy Odyssey: The Lost and Found,2016,Metroidvania,"₩16,000",0%,214,110,324,259200000,88,41,129,103200000
228320,A Valley Without Wind 2,2012,Metroidvania,"₩16,500",0%,102,121,223,183975000,52,59,111,91575000
1476230,Elmarion: the Lost Temple,2024,Metroidvania,"₩15,500",0%,74,30,104,80600000,65,30,95,73625000
1927250,Happy Mining,2023,Metroidvania,"₩6,500",0%,32,10,42,13650000,23,10,33,10725000
674480,Unformed 破妄,2020,Metroidvania,"₩15,500",0%,33,10,43,33325000,19,9,28,21700000
271640,Humanity Asset,2014,Metroidvania,"₩2,200",0%,156,348,504,55440000,13,16,29,3190000
603400,FOX n FORESTS,2018,Metroidvania,"₩10,500",0%,137,44,181,95025000,108,30,138,72450000
467910,EPΘCH,2016,Metroidvania,"₩1,100",0%,40,12,52,2860000,18,11,29,1595000
474210,BUTCHER,2016,Metroidvania,"₩10,500",0%,1102,172,1274,668850000,846,104,950,498750000
1051580,Skjoldur Story,2021,Metroidvania,"₩15,500",0%,28,6,34,26350000,14,5,19,14725000
589510,Shovel Knight: Specter of Torment,2017,Metroidvania,"₩10,500",0%,442,26,468,245700000,402,26,428,224700000
1901130,A Difficult Game About ROLLING - ReUpRise,2024,Metroidvania,"₩11,000",0%,12,3,15,8250000,9,1,10,5500000
425670,Seraph,2016,Metroidvania,"₩4,500",0%,434,117,551,123975000,294,78,372,83700000
757940,Raygun Gadabout,2025,Metroidvania,"₩19,350",9%,0,0,0,0,0,0,0,0
1126710,魔法使いハナビィ Hanaby the Witch,2019,Metroidvania,"₩15,000",0%,46,1,47,35250000,43,1,44,33000000
267360,MURI,2013,Metroidvania,"₩11,000",0%,433,45,478,262900000,286,21,307,168850000
733180,Destroy Space Aliens,2017,Metroidvania,"₩4,400",0%,11,6,17,3740000,8,5,13,2860000
1198210,Dogworld,2021,Metroidvania,"₩15,500",0%,102,4,106,82150000,98,3,101,78275000
1490460,Exorcist Fairy,2021,Metroidvania,"₩14,500",0%,212,111,323,234175000,166,101,267,193575000
573780,Xenon Valkyrie,2017,Metroidvania,"₩10,500",0%,84,45,129,67725000,76,44,120,63000000
599960,Dogolrax,2017,Metroidvania,"₩5,500",0%,215,94,309,84975000,199,94,293,80575000
2666610,Wings of Endless,2025,Metroidvania,"₩14,500",0%,26,4,30,21750000,23,5,28,20300000
1078510,Alluris,2019,Metroidvania,"₩10,500",0%,157,14,171,89775000,125,14,139,72975000
2163760,Bitter Belief,2022,Metroidvania,"₩1,100",0%,10,7,17,935000,6,8,14,770000
1249070,AeternoBlade II: Infinity,2020,Metroidvania,"₩29,000",0%,50,12,62,89900000,31,9,40,58000000
1649740,Hunt the Night,2023,Metroidvania,"₩21,500",0%,368,104,472,507400000,251,88,339,364425000
1441670,SJ-19 Learns To Love!,2021,Metroidvania,"₩7,800",0%,0,0,0,0,43,0,43,16770000
1189780,Wallachia: Reign of Dracula,2020,Metroidvania,"₩10,500",0%,119,50,169,88725000,112,50,162,85050000
264280,99 Levels To Hell,2014,Metroidvania,"₩5,500",0%,367,237,604,166100000,199,139,338,92950000
927250,Bladed fury,2018,Metroidvania,"₩10,500",0%,2726,424,3150,1653750000,0,0,0,0
944120,Abalyte,2018,Metroidvania,Free,0%,131,66,197,0,130,67,197,0
1237490,Redneck Ed: Astro Monsters Show,2020,Metroidvania,"₩4,990",0%,36,32,68,16966000,23,28,51,12724500
369070,Slain: Back from Hell,2016,Metroidvania,"₩13,500",0%,1668,664,2332,1574100000,1168,477,1645,1110375000
95300,Capsized,2011,Metroidvania,"₩11,000",0%,825,257,1082,595100000,467,110,577,317350000
290770,The Fall,2014,Metroidvania,"₩10,500",0%,3228,445,3673,1928325000,0,0,0,0
92300,A.R.E.S.: Extinction Agenda,2011,Metroidvania,"₩5,500",0%,629,279,908,249700000,406,166,572,157300000
260250,Blood of the Werewolf,2013,Metroidvania,"₩5,500",0%,364,252,616,169400000,236,164,400,110000000
3628840,Ember Fall,2025,Metroidvania,"₩3,400",0%,0,0,0,0,0,0,0,0
1622640,Nihilsearch,2022,Metroidvania,"₩10,500",0%,9,8,17,8925000,4,8,12,6300000
295610,Inescapable,2014,Metroidvania,"₩3,400",0%,49,75,124,21080000,20,33,53,9010000
364480,Red Goblin: Cursed Forest,2015,Metroidvania,"₩5,600",0%,14,24,38,10640000,6,13,19,5320000
1067250,Dead Castle / 不思议魔城,2019,Metroidvania,"₩1,100",0%,6,16,22,1210000,5,13,18,990000
2503890,Bloodecay,2023,Metroidvania,"₩3,400",0%,19,30,49,8330000,19,29,48,8160000
3281100,Jumper Jon,2025,Metroidvania,"₩11,000",0%,0,0,0,0,0,0,0,0
322440,Red Goddess: Inner World,2015,Metroidvania,"₩10,500",0%,37,36,73,38325000,12,19,31,16275000
1013100,Mage,2019,Metroidvania,"₩3,300",0%,9,1,10,1650000,0,0,0,0
3480850,Maiden,2025,Metroidvania,"₩32,000",0%,0,0,0,0,0,0,0,0
2376780,Battery Samurai,2023,Metroidvania,"₩3,400",0%,9,1,10,1700000,0,0,0,0
2311940,Dungeon X Dungeon,2023,Metroidvania,"₩11,000",0%,1,5,6,3300000,0,0,0,0
769110,Barbarian Souls,2019,Metroidvania,"₩16,500",0%,34,69,103,84975000,22,37,59,48675000
2414500,Limos' Lair,2023,Metroidvania,"₩2,300",0%,10,0,10,1150000,0,0,0,0
1167380,Neither Day nor Night,2020,Metroidvania,"₩5,600",0%,10,9,19,5320000,5,9,14,3920000
663290,Dead by Death,2018,Metroidvania,"₩3,300",0%,12,15,27,4455000,5,13,18,2970000
486130,Best Buds vs Bad Guys,2016,Metroidvania,"₩5,600",0%,17,15,32,8960000,5,10,15,4200000
3724570,Winslow,2025,Metroidvania,"₩1,100",0%,0,0,0,0,0,0,0,0
2146970,Plateman,2024,Metroidvania,"₩9,900",0%,14,2,16,7920000,0,0,0,0
2089040,La Sombra,2024,Metroidvania,"₩4,500",0%,14,1,15,3375000,0,0,0,0
2524590,Soul's Majesty Rise of Gilda,2023,Metroidvania,"₩1,100",0%,17,1,18,990000,0,0,0,0
1823750,NECROTOPIA,2022,Metroidvania,"₩12,500",0%,4,3,7,4375000,0,0,0,0
1650570,Red and White,2021,Metroidvania,"₩12,500",0%,0,0,0,0,0,0,0,0
2984080,Vlad Voievod Dracula: Dungeons of Egrigoz,2024,Metroidvania,"₩3,400",0%,5,0,5,850000,0,0,0,0
1080440,Dark Blood,2019,Metroidvania,"₩13,500",0%,1,11,12,8100000,1,11,12,8100000
1099090,Outpost Delta,2020,Metroidvania,"₩18,500",0%,8,2,10,9250000,0,0,0,0
3225740,Dark Cooking,2024,Metroidvania,"₩56,000",0%,0,0,0,0,0,0,0,0
1518240,PATHFINDER 08,2021,Metroidvania,"₩1,100",0%,4,2,6,330000,0,0,0,0
3225780,Destroyed Base,2024,Metroidvania,"₩56,000",0%,0,0,0,0,0,0,0,0
3225780,Destroyed Base,2024,Metroidvania,"₩56,000",0%,0,0,0,0,0,0,0,0
2436150,King Story: Prologue,2023,Metroidvania,"₩1,100",0%,4,0,4,220000,0,0,0,0
2819920,OOLO,2025,Metroidvania,"₩16,120",25%,0,0,0,0,0,0,0,0
2449630,Tower of Pandemonium,2023,Metroidvania,"₩16,500",0%,1,0,1,825000,0,0,0,0
1728410,THORN DEMON HUNTER,2022,Metroidvania,"₩6,500",0%,3,3,6,1950000,0,0,0,0
2005750,Collapse Relapse,2022,Metroidvania,"₩4,400",0%,4,1,5,1100000,0,0,0,0
1305260,SteamDolls - Order Of Chaos,2025,Metroidvania,"₩21,500",0%,18,1,19,20425000,0,0,0,0
1499960,Poor Lucas and the Evil Duke,2023,Metroidvania,"₩2,300",0%,2,0,2,230000,0,0,0,0
1875120,Marsmare: Alienation,2024,Metroidvania,"₩2,300",0%,12,0,12,1380000,0,0,0,0
1316060,Smelted Kin,2020,Metroidvania,"₩5,500",0%,7,4,11,3025000,0,0,0,0
2228960,Ninja VS Zombies,2022,Metroidvania,"₩3,400",0%,3,1,4,680000,0,0,0,0
453880,Ninja Outbreak,2016,Metroidvania,"₩11,000",0%,7,3,10,5500000,0,0,0,0
3347430,小石游记 Little Stone Journey,2024,Metroidvania,"₩1,100",0%,1,0,1,55000,0,0,0,0
3870310,Quarion,2025,Metroidvania,Unknown,0%,0,0,0,0,0,0,0,0
2058660,Maelstrom,2022,Metroidvania,"₩5,500",0%,3,1,4,1100000,0,0,0,0
2373860,Jessica's Uncomfortable Hanukkah Adventure,2023,Metroidvania,"₩4,500",0%,3,0,3,675000,0,0,0,0
1553990,TheLastHope,2021,Metroidvania,"₩6,500",0%,1,0,1,325000,0,0,0,0
3116080,DeltaPhysics,2024,Metroidvania,"₩5,600",0%,0,0,0,0,0,0,0,0
1667160,入替人-ReplaceR-,2021,Metroidvania,"₩1,100",0%,83,13,96,5280000,0,0,0,0
1818580,Creator's Asteroid,2021,Metroidvania,"₩6,700",0%,4,0,4,1340000,0,0,0,0
461830,Adventure Apes and the Mayan Mystery,2016,Metroidvania,"₩3,300",0%,15,7,22,3630000,0,0,0,0
3133560,Demon Quest,2025,Metroidvania,"₩5,600",0%,3,0,3,840000,0,0,0,0
3303560,Gridvania,2024,Metroidvania,"₩3,400",0%,0,0,0,0,0,0,0,0
3370400,Cake Space Shooter,2024,Metroidvania,"₩1,100",0%,9,9,18,990000,0,0,0,0
2097920,Fly to hope,2022,Metroidvania,"₩1,100",0%,3,2,5,275000,0,0,0,0
2313700,Constance,2025,Metroidvania,Unknown,0%,0,0,0,0,0,0,0,0
2256770,Old Shadow,2023,Metroidvania,"₩4,500",0%,6,4,10,2250000,0,0,0,0
1387300,Joy the Pug,2021,Metroidvania,"₩1,100",0%,2,1,3,165000,0,0,0,0
3146930,Aldoria,2024,Metroidvania,"₩5,600",0%,0,1,1,280000,0,0,0,0
1742510,Wreckdigger,2021,Metroidvania,Free,0%,6,2,8,0,0,0,0,0
2866220,Chicken with Robot Legs,2025,Metroidvania,Unknown,0%,0,0,0,0,0,0,0,0
2613580,Captured Nightmare,2023,Metroidvania,"₩3,400",0%,0,0,0,0,0,0,0,0
1929860,Virtue's Heaven,2025,Metroidvania,"₩21,500",0%,6,0,6,6450000,0,0,0,0
436360,Robo's World: The Zarnok Fortress,2016,Metroidvania,"₩10,500",0%,17,5,22,11550000,0,0,0,0
2589550,Dino,2024,Metroidvania,"₩2,300",0%,0,0,0,0,0,0,0,0
2783860,Rogue Dimensions,2024,Metroidvania,"₩5,600",0%,0,0,0,0,0,0,0,0
847570,How About Spikes,2018,Metroidvania,"₩2,200",0%,4,3,7,770000,0,0,0,0
2155650,Slayer Of Sin,2022,Metroidvania,"₩1,100",0%,2,2,4,220000,0,0,0,0
1917820,Strongloween: The Escape,2024,Metroidvania,"₩15,500",0%,3,0,3,2325000,0,0,0,0
1578380,10K & The Kriminal World - Sammy's Attack,2022,Metroidvania,"₩11,500",0%,1,0,1,575000,0,0,0,0
364900,Red Bit Ninja,2015,Metroidvania,"₩5,500",0%,9,23,32,8800000,0,0,0,0
2263260,House of Shadow,2023,Metroidvania,Free,0%,8,0,8,0,0,0,0,0
495540,Dashy Square VR,2016,Metroidvania,"₩2,200",0%,3,3,6,660000,0,0,0,0
2347180,Cat & Gold,2023,Metroidvania,"₩8,090",0%,2,0,2,809000,0,0,0,0
2083580,Oblige Of CHAOS,2022,Metroidvania,"₩21,500",0%,1,3,4,4300000,0,0,0,0
1214130,Jumplord,2020,Metroidvania,"₩8,500",0%,2,0,2,850000,0,0,0,0
3199200,RedCloak,2024,Metroidvania,"₩2,300",0%,0,0,0,0,0,0,0,0
509620,Last Stitch Goodnight,2017,Metroidvania,"₩10,500",0%,8,2,10,5250000,0,0,0,0
1339080,Neon Fusion,2020,Metroidvania,"₩8,500",0%,2,1,3,1275000,0,0,0,0
1230840,Matcha Warriors,2020,Metroidvania,"₩8,500",0%,3,0,3,1275000,0,0,0,0
3053970,Block Bot: Puzzle Journey,2024,Metroidvania,"₩2,300",0%,1,0,1,115000,0,0,0,0
1839320,The Future Project,2023,Metroidvania,"₩4,400",60%,6,3,9,1980000,0,0,0,0
2858190,Prism Break,2024,Metroidvania,"₩2,300",0%,0,0,0,0,0,0,0,0
1034870,Norman's Night In,2019,Metroidvania,"₩9,500",0%,6,3,9,4275000,0,0,0,0
3120270,The Castle Of Xanxillia,2024,Metroidvania,"₩21,610",0%,0,0,0,0,0,0,0,0
1628060,Project E.V.A. Remake,2021,Metroidvania,"₩5,600",0%,1,3,4,1120000,0,0,0,0
606030,Meganoid,2017,Metroidvania,"₩12,500",0%,9,5,14,8750000,0,0,0,0
2173170,Bob's Journey,2022,Metroidvania,"₩4,560",0%,0,0,0,0,0,0,0,0
1388140,Arwinia,2020,Metroidvania,"₩3,300",0%,3,2,5,825000,0,0,0,0
3021750,Rolled: A Pinball Nightmare,2024,Metroidvania,"₩5,600",0%,0,2,2,560000,0,0,0,0
1270020,PowerBots Retro,2021,Metroidvania,"₩2,300",0%,0,0,0,0,0,0,0,0
2831900,Crab Attack,2025,Metroidvania,"₩13,500",0%,0,0,0,0,0,0,0,0
2083320,Omega Warp,2024,Metroidvania,"₩16,500",0%,7,0,7,5775000,0,0,0,0
2461980,Faunamorph,2025,Metroidvania,"₩11,000",0%,2,4,6,3300000,0,0,0,0
3282280,Astronaut Adventure,2024,Metroidvania,"₩2,300",0%,0,0,0,0,0,0,0,0
2524340,Corrupt,2023,Metroidvania,"₩11,000",0%,10,2,12,6600000,0,0,0,0
1371180,Star Rover,2020,Metroidvania,"₩16,500",0%,1,0,1,825000,0,0,0,0
1439960,The Doomed Knight,2025,Metroidvania,Unknown,0%,0,0,0,0,0,0,0,0
982990,Muzzleloaded,2018,Metroidvania,"₩2,200",0%,4,2,6,660000,0,0,0,0
2523430,Please Leave a Message,2023,Metroidvania,"₩5,600",0%,0,0,0,0,0,0,0,0
3582850,Orange You Glad i Didn't Say Banana,2025,Metroidvania,Free,0%,0,0,0,0,0,0,0,0
1156480,My Very Own Light,2021,Metroidvania,"₩20,500",0%,1,1,2,2050000,0,0,0,0
3177590,Ichiro,2024,Metroidvania,"₩3,400",0%,1,0,1,170000,0,0,0,0
2260650,Arcadia: Colony,2023,Metroidvania,"₩5,600",0%,12,2,14,3920000,0,0,0,0
1971810,Mawthorne,2022,Metroidvania,"₩10,500",0%,0,2,2,1050000,0,0,0,0
1865650,Aldebaran Legend,2022,Metroidvania,"₩7,000",0%,3,1,4,1400000,0,0,0,0
1777130,Demon Runner The Forsaken,2021,Metroidvania,"₩3,400",0%,3,1,4,680000,0,0,0,0
3289000,Shadows Of Lir'Ah,2024,Metroidvania,"₩2,300",0%,1,0,1,115000,0,0,0,0
2257790,Trapers Platformer,2023,Metroidvania,"₩2,300",0%,11,3,14,1610000,0,0,0,0
506710,The Colony: New Haven Chronicles,2025,Metroidvania,"₩10,500",0%,0,0,0,0,0,0,0,0
1900320,Lumnis,2024,Metroidvania,"₩18,500",0%,0,1,1,925000,0,0,0,0
1250990,Summoners Mist,2020,Metroidvania,"₩9,900",0%,1,0,1,495000,0,0,0,0
1563210,Nitrojet,2023,Metroidvania,"₩16,500",0%,5,0,5,4125000,0,0,0,0
2954750,The Dreamers Foresight,2025,Metroidvania,Unknown,0%,0,0,0,0,0,0,0,0
2541440,3am in Leicester,2023,Metroidvania,"₩1,100",0%,0,2,2,110000,0,0,0,0
2126620,Super DynoStory,2022,Metroidvania,"₩13,500",0%,13,0,13,8775000,0,0,0,0
1375440,Avoidvania,2021,Metroidvania,"₩11,500",0%,7,0,7,4025000,0,0,0,0
1653520,Project Delta,2023,Metroidvania,"₩11,000",0%,2,1,3,1650000,0,0,0,0
1857840,Xolotl,2022,Metroidvania,"₩1,100",0%,8,2,10,550000,0,0,0,0
2599560,Ataraxie,2024,Metroidvania,"₩5,600",0%,11,2,13,3640000,0,0,0,0
600520,Cryogear,2020,Metroidvania,"₩18,500",0%,10,1,11,10175000,0,0,0,0
2526860,Exodus,2024,Metroidvania,"₩1,100",0%,7,1,8,440000,0,0,0,0
2089750,Super Spyroxo Adventures: Island of Dnfoo,2024,Metroidvania,"₩14,500",0%,5,1,6,4350000,0,0,0,0
1258960,Alpha Particle,2021,Metroidvania,"₩11,000",0%,6,1,7,3850000,0,0,0,0
1258960,Alpha Particle,2021,Metroidvania,"₩11,000",0%,6,1,7,3850000,0,0,0,0
1922990,Far Star,2023,Metroidvania,"₩9,900",0%,6,0,6,2970000,0,0,0,0
662550,Beraltors,2019,Metroidvania,"₩5,600",0%,6,1,7,1960000,0,0,0,0
1258840,Stimuli,2020,Metroidvania,"₩5,500",0%,6,1,7,1925000,0,0,0,0
3931170,MONUMENTUM,2025,Metroidvania,Unknown,0%,0,0,0,0,0,0,0,0
2517150,Vagneria,2024,Metroidvania,"₩5,600",0%,10,5,15,4200000,0,0,0,0
1285070,Bad Run - Turbo Edition,2020,Metroidvania,"₩4,500",0%,6,0,6,1350000,0,0,0,0
1565440,Timeless Dual,2022,Metroidvania,"₩15,500",0%,0,0,0,0,0,0,0,0
2401350,Timeless Rain,2025,Metroidvania,Unknown,0%,0,0,0,0,0,0,0,0
2401350,Timeless Rain,2025,Metroidvania,Unknown,0%,0,0,0,0,0,0,0,0
1274720,SOULBOUND,2021,Metroidvania,"₩10,500",0%,3,3,6,3150000,0,0,0,0
1495240,Deep Enigma,2021,Metroidvania,"₩5,500",0%,0,2,2,550000,0,0,0,0
954780,Zombie Soldier,2018,Metroidvania,"₩1,100",0%,4,6,10,550000,0,0,0,0
1180840,SoulfulLand,2020,Metroidvania,"₩6,500",0%,1,0,1,325000,0,0,0,0
2751850,Secrets Under Eco,2024,Metroidvania,Free,0%,6,3,9,0,0,0,0,0
1438430,Ralf's Adventure: Aztec Mystery,2021,Metroidvania,"₩6,500",0%,1,1,2,650000,0,0,0,0
3452390,Ancient Ocean: The Fall of Atlantis,2025,Metroidvania,"₩4,500",0%,2,0,2,450000,0,0,0,0
1465830,Torto: Cursed Divine,2020,Metroidvania,"₩1,100",0%,2,0,2,110000,0,0,0,0
3020370,Archetype and the Four Winds of Hell,2024,Metroidvania,"₩11,000",0%,4,0,4,2200000,0,0,0,0
1583180,Super Vili,2021,Metroidvania,"₩5,600",0%,6,0,6,1680000,0,0,0,0
2505200,Shadows Labyrinth,2025,Metroidvania,"₩7,800",0%,2,0,2,780000,0,0,0,0
1696740,Ubirajara,2021,Metroidvania,"₩2,200",0%,0,0,0,0,0,0,0,0
1142890,Heart in the Dark,2019,Metroidvania,"₩16,500",0%,1,0,1,825000,0,0,0,0
1100340,Battle Droid T1,2019,Metroidvania,"₩5,500",0%,0,0,0,0,0,0,0,0
1390420,Billy Saves the World,2024,Metroidvania,"₩11,000",0%,10,1,11,6050000,0,0,0,0
1007470,Raven: The Last Neko Slayer,2019,Metroidvania,"₩5,600",0%,0,0,0,0,0,0,0,0
1796500,Twinland,2021,Metroidvania,"₩4,870",35%,7,1,8,1948000,0,0,0,0
3319330,Makis Adventure: Level Editor,2024,Metroidvania,Free,0%,5,1,6,0,0,0,0,0
453810,Blasting Agent: Ultimate Edition,2016,Metroidvania,"₩3,300",0%,17,22,39,6435000,9,19,28,4620000
1026430,Book of Eos,2019,Metroidvania,"₩3,400",0%,7,1,8,1360000,0,0,0,0
2095960,Isostasy,2022,Metroidvania,"₩5,500",0%,2,0,2,550000,0,0,0,0
2083330,An old school adventure FPS - Go To Hell,2022,Metroidvania,"₩5,600",0%,2,0,2,560000,0,0,0,0
1881710,Bitlands,2022,Metroidvania,"₩5,500",0%,7,0,7,1925000,0,0,0,0
1321350,LV99: Final Fortress,2020,Metroidvania,"₩9,500",0%,5,0,5,2375000,0,0,0,0
950890,Game Master Plus,2019,Metroidvania,"₩7,500",0%,9,2,11,4125000,0,0,0,0
1909280,Alchemist Arena,2022,Metroidvania,"₩1,100",0%,0,0,0,0,0,0,0,0
3401850,Erandique,2025,Metroidvania,"₩4,500",0%,0,0,0,0,0,0,0,0
1903690,Princess Pyro,2022,Metroidvania,"₩5,500",0%,3,0,3,825000,0,0,0,0
3632460,Typingvania,2025,Metroidvania,Unknown,0%,0,0,0,0,0,0,0,0
1186590,Unnamed Adventure/无名之旅,2019,Metroidvania,"₩3,300",0%,1,2,3,495000,0,0,0,0
2223150,Marquee Candle,2025,Metroidvania,"₩1,100",0%,0,0,0,0,0,0,0,0
967290,Mò The Frog,2018,Metroidvania,"₩1,100",0%,6,2,8,440000,0,0,0,0
1550800,Omega-Altro,2021,Metroidvania,"₩2,200",0%,1,0,1,110000,0,0,0,0
1825510,Resurrection of mind,2024,Metroidvania,"₩8,900",0%,0,3,3,1335000,0,0,0,0
3625820,Hollowroot,2025,Metroidvania,"₩5,600",0%,1,0,1,280000,0,0,0,0
1620970,Blue Rabbit,2021,Metroidvania,"₩5,500",0%,2,1,3,825000,0,0,0,0
3397090,SOLDIER ADVENTURE,2024,Metroidvania,"₩1,100",0%,0,0,0,0,0,0,0,0
1582740,Reknum Cheri Dreamland,2021,Metroidvania,"₩7,500",0%,14,4,18,6750000,0,0,0,0
1288380,Two Bit Hero,2020,Metroidvania,"₩8,500",0%,2,5,7,2975000,0,0,0,0
1825850,Pixel Game Maker Series MEDIUM-NAUT,2021,Metroidvania,"₩16,500",0%,7,1,8,6600000,0,0,0,0
3822140,The Mine,2025,Metroidvania,"₩3,400",0%,0,0,0,0,0,0,0,0
518140,Lectrovolt II,2016,Metroidvania,"₩3,300",0%,4,5,9,1485000,0,0,0,0
1825850,Pixel Game Maker Series MEDIUM-NAUT,2021,Metroidvania,"₩16,500",0%,7,1,8,6600000,0,0,0,0
2555220,Lovanium - The Rising Suns,2024,Metroidvania,"₩8,900",0%,9,1,10,4450000,0,0,0,0
2874550,Bones Beneath,2025,Metroidvania,"₩14,500",0%,4,0,4,2900000,0,0,0,0
1694970,Jude,2021,Metroidvania,"₩12,500",0%,0,2,2,1250000,0,0,0,0
512700,Duckles: the Jigsaw Witch,2016,Metroidvania,"₩5,500",0%,8,17,25,6875000,0,0,0,0
721350,Where Are My Friends?,2017,Metroidvania,"₩4,400",0%,26,6,32,7040000,0,0,0,0
1855240,PRINCESS,2022,Metroidvania,"₩21,500",0%,2,0,2,2150000,0,0,0,0
2593130,Stress testing,2023,Metroidvania,"₩3,400",0%,0,0,0,0,0,0,0,0
2143450,Strong Moon,2022,Metroidvania,"₩7,500",0%,1,0,1,375000,0,0,0,0
1112200,Rize of the Summonds,2019,Metroidvania,Unknown,0%,1,1,2,0,0,0,0,0
3469310,Wheel of Words: Crossword,2025,Metroidvania,"₩2,300",0%,0,2,2,230000,0,0,0,0
1666240,Crimson Glaive Sigma,2021,Metroidvania,"₩5,600",0%,5,0,5,1400000,0,0,0,0
2005710,Wizcave,2022,Metroidvania,"₩6,700",0%,5,0,5,1675000,0,0,0,0
2332960,Ed's world story,2023,Metroidvania,"₩4,500",0%,2,0,2,450000,0,0,0,0
1811330,Lord Ambermaze,2025,Metroidvania,Unknown,0%,0,0,0,0,0,0,0,0
1839780,Cat Dimension,2022,Metroidvania,"₩1,040",89%,3,0,3,156000,0,0,0,0
886390,A Roll-Back Story,2018,Metroidvania,"₩2,300",0%,10,8,18,2070000,0,0,0,0
1218930,XECUTER,2020,Metroidvania,"₩2,300",0%,1,0,1,115000,0,0,0,0
1789440,Ani Leaving Sirius,2021,Metroidvania,"₩5,600",0%,6,0,6,1680000,0,0,0,0
2543920,Nameless adventure,2025,Metroidvania,Free,0%,0,0,0,0,0,0,0,0
2508950,DreadFall,2023,Metroidvania,"₩21,500",0%,2,0,2,2150000,0,0,0,0
1995930,Count Pumpcula,2024,Metroidvania,"₩11,000",0%,9,4,13,7150000,0,0,0,0
1501640,Fallen Rebellion,2021,Metroidvania,"₩3,400",0%,1,0,1,170000,0,0,0,0
2515960,Validus mortis,2023,Metroidvania,"₩7,800",0%,2,1,3,1170000,0,0,0,0
3594280,AVTale,2025,Metroidvania,Unknown,0%,0,0,0,0,0,0,0,0
869640,Angry Giant,2021,Metroidvania,"₩4,500",0%,11,1,12,2700000,0,0,0,0
2422850,The Unknown,2023,Metroidvania,"₩2,300",0%,3,0,3,345000,0,0,0,0
2417700,The Malice Kingdom,2023,Metroidvania,"₩2,300",0%,9,1,10,1150000,0,0,0,0
3499440,Full Effect,2025,Metroidvania,"₩11,000",0%,2,0,2,1100000,0,0,0,0
1798350,Panda Punch,2022,Metroidvania,"₩5,600",0%,7,2,9,2520000,0,0,0,0
2156270,Taxi Taxi Sim,2022,Metroidvania,"₩5,600",0%,16,5,21,5880000,0,0,0,0
3574220,For Aerolite,2025,Metroidvania,"₩14,020",15%,0,0,0,0,0,0,0,0
1082620,PhilGood,2019,Metroidvania,"₩10,500",0%,4,1,5,2625000,0,0,0,0
1139130,BioMech,2019,Metroidvania,"₩11,000",0%,4,5,9,4950000,0,0,0,0
689480,Leon's crusade (La cruzada de León),2017,Metroidvania,"₩1,100",0%,6,7,13,715000,0,0,0,0
2935950,Hidden in Clickville,2024,Metroidvania,"₩2,300",0%,5,0,5,575000,0,0,0,0
3264710,Mishaka Ubivaka,2024,Metroidvania,"₩3,400",0%,10,0,10,1700000,0,0,0,0
3264710,Mishaka Ubivaka,2024,Metroidvania,"₩3,400",0%,10,0,10,1700000,0,0,0,0
1298850,Lihue,2021,Metroidvania,"₩20,500",0%,13,2,15,15375000,0,0,0,0
613610,Silver Island,2017,Metroidvania,"₩6,500",0%,9,0,9,2925000,0,0,0,0
1565450,STERN,2022,Metroidvania,"₩10,500",0%,9,0,9,4725000,0,0,0,0
3191770,Slitherise,2025,Metroidvania,"₩5,500",0%,0,0,0,0,0,0,0,0
890480,Widget Satchel,2019,Metroidvania,"₩15,500",0%,10,4,14,10850000,0,0,0,0
2588480,Subenishiki,2023,Metroidvania,"₩4,500",0%,0,0,0,0,0,0,0,0
2026260,Ocnus Theory,2023,Metroidvania,"₩13,500",0%,12,1,13,8775000,0,0,0,0
2439660,The lost adventure,2023,Metroidvania,"₩27,000",0%,0,4,4,5400000,0,0,0,0
3658940,Rey: Shattered Darkness,2025,Metroidvania,Unknown,0%,0,0,0,0,0,0,0,0
1082460,Ninja Turdle,2020,Metroidvania,"₩2,300",0%,13,1,14,1610000,0,0,0,0
968480,Dimensum - Bizzarre Huntseeker,2019,Metroidvania,"₩10,500",0%,5,1,6,3150000,0,0,0,0
3616230,GLYPHS,2025,Metroidvania,"₩3,400",0%,2,1,3,510000,0,0,0,0
1993440,Times Dungeon,2024,Metroidvania,"₩11,000",0%,0,2,2,1100000,0,0,0,0
1158460,SULVER'S JOURNEY,2020,Metroidvania,"₩15,500",0%,1,0,1,775000,0,0,0,0
2157450,Stunts Contest Monster Car,2022,Metroidvania,"₩9,900",0%,9,6,15,7425000,0,0,0,0
1880310,Oogy: Can You Help,2022,Metroidvania,"₩20,500",0%,2,1,3,3075000,0,0,0,0
676850,Guardian,2017,Metroidvania,"₩1,100",0%,12,4,16,880000,0,0,0,0
1688730,Perry the Pumpkin,2023,Metroidvania,"₩5,500",0%,0,1,1,275000,0,0,0,0
1934350,Wildfox Surfing Paradise,2022,Metroidvania,"₩3,300",0%,1,0,1,165000,0,0,0,0
1311220,Johann Weiss,2020,Metroidvania,"₩6,500",0%,12,6,18,5850000,0,0,0,0
1145000,The Rainbow World,2019,Metroidvania,"₩1,100",0%,6,0,6,330000,0,0,0,0
1435790,Escape Simulator,2021,Puzzle,"₩11,940",40%,16281,1027,17308,10332876000,0,0,0,0
2995920,It Takes Two Friend's Pass,2021,Puzzle,Unknown,0%,0,0,0,0,0,0,0,0
477160,Human Fall Flat,2016,Puzzle,"₩20,500",0%,202253,11387,213640,218981000000,0,0,0,0
3097560,Liar's Bar,2024,Puzzle,"₩7,800",0%,44341,4209,48550,18934500000,0,0,0,0
1127500,Mini Motorways,2021,Puzzle,"₩10,500",0%,20615,817,21432,11251800000,0,0,0,0
2835570,Buckshot Roulette,2024,Puzzle,"₩3,400",0%,91745,3796,95541,16241970000,0,0,0,0
1274570,DEVOUR,2021,Puzzle,"₩11,000",0%,75057,7457,82514,45382700000,0,0,0,0
1509960,PICO PARK,2021,Puzzle,"₩5,500",0%,25879,2620,28499,7837225000,0,0,0,0
1135690,Unpacking,2021,Puzzle,"₩10,250",50%,32883,2418,35301,18091762500,0,0,0,0
2525310,Drop Duchy,2025,Puzzle,"₩13,200",19%,1225,141,1366,901560000,1572,194,1766,1165560000
2787320,Revenge of the Savage Planet,2025,Puzzle,"₩20,470",35%,0,0,0,0,1115,261,1376,1408336000
860510,Little Nightmares II,2021,Puzzle,"₩29,800",0%,40494,2548,43042,64132580000,0,0,0,0
1159830,Scene Investigators,2023,Puzzle,"₩16,200",40%,611,191,802,649620000,574,191,765,619650000
1721470,Poppy Playtime,2021,Puzzle,Free,0%,84113,14801,98914,0,0,0,0,0
1190000,Car Mechanic Simulator 2021,2021,Puzzle,"₩27,000",0%,28630,1211,29841,40285350000,0,0,0,0
3060170,Chained in the Backrooms,2025,Puzzle,"₩3,400",0%,305,144,449,76330000,376,194,570,96900000
3035120,Is This Seat Taken?,2025,Puzzle,"₩8,990",10%,0,0,0,0,1388,43,1431,643234500
753640,Outer Wilds,2020,Puzzle,"₩29,500",0%,80833,3655,84488,124619800000,0,0,0,0
239030,"Papers, Please",2013,Puzzle,"₩11,000",0%,72168,2019,74187,40802850000,0,0,0,0
3339880,OFF,2025,Puzzle,"₩14,020",15%,0,0,0,0,757,48,805,564305000
420530,OneShot,2016,Puzzle,"₩6,600",40%,52785,919,53704,17722320000,0,0,0,0
287980,Mini Metro,2015,Puzzle,"₩10,500",0%,15064,608,15672,8227800000,0,0,0,0
736260,Baba Is You,2019,Puzzle,"₩15,500",0%,21441,480,21921,16988775000,0,0,0,0
1931770,Chants of Sennaar,2023,Puzzle,"₩22,800",0%,22075,378,22453,25596420000,0,0,0,0
1594940,Little Witch in the Woods,2022,Puzzle,"₩18,000",0%,7251,891,8142,7327800000,0,0,0,0
1569580,Blue Prince,2025,Puzzle,"₩32,000",0%,7306,1096,8402,13443200000,0,0,0,0
1332010,Stray,2022,Puzzle,"₩35,000",0%,152312,4295,156607,274062250000,0,0,0,0
1515210,The Past Within,2022,Puzzle,"₩4,020",40%,14362,794,15156,3046356000,0,0,0,0
341800,Keep Talking and Nobody Explodes,2015,Puzzle,"₩16,500",0%,15346,401,15747,12991275000,0,0,0,0
865360,We Were Here Together,2019,Puzzle,"₩14,500",0%,13321,2608,15929,11548525000,0,0,0,0
1392860,Little Nightmares III,2025,Puzzle,"₩49,840",0%,0,0,0,0,0,0,0,0
2721890,Öoo,2025,Puzzle,"₩11,000",0%,0,0,0,0,1372,14,1386,762300000
2482920,Flower in Us,2025,Puzzle,"₩8,500",0%,0,0,0,0,211,16,227,96475000
2754380,The Roottrees are Dead,2025,Puzzle,"₩21,500",0%,2459,63,2522,2711150000,0,0,0,0
2325290,Sky: Children of the Light,2024,Puzzle,Free,0%,0,0,0,0,0,0,0,0
2394650,Crypt Custodian,2024,Puzzle,"₩18,480",30%,1861,43,1904,1759296000,1931,60,1991,1839684000
2275490,Kaizen: A Factory Story,2025,Puzzle,"₩21,500",0%,0,0,0,0,406,40,446,479450000
1167630,Teardown,2022,Puzzle,"₩33,000",0%,104653,4809,109462,180612300000,0,0,0,0
837470,Untitled Goose Game,2020,Puzzle,"₩21,500",0%,21184,920,22104,23761800000,0,0,0,0
3431040,That's not my Neighbor,2025,Puzzle,"₩3,400",0%,1746,301,2047,347990000,0,0,0,0
683320,GRIS,2018,Puzzle,"₩16,500",0%,80404,3044,83448,68844600000,0,0,0,0
1057090,Ori and the Will of the Wisps,2020,Puzzle,"₩29,900",0%,131989,4701,136690,204351550000,0,0,0,0
653530,Return of the Obra Dinn,2018,Puzzle,"₩21,500",0%,28093,923,29016,31192200000,0,0,0,0
1585220,Melatonin,2022,Puzzle,"₩16,500",0%,6752,354,7106,5862450000,0,0,0,0
1901370,Ib,2022,Puzzle,"₩13,500",0%,4343,43,4386,2960550000,0,0,0,0
590380,Into the Breach,2018,Puzzle,"₩15,500",0%,19126,1090,20216,15667400000,0,0,0,0
1858650,In Sink: A Co-op Escape Adventure,2024,Puzzle,"₩16,500",0%,0,0,0,0,768,105,873,720225000
424840,Little Nightmares,2017,Puzzle,"₩24,800",0%,104472,5724,110196,136643040000,0,0,0,0
677160,We Were Here Too,2018,Puzzle,"₩11,000",0%,7976,1949,9925,5458750000,0,0,0,0
2544570,LumineNight,2024,Puzzle,"₩27,000",0%,204,28,232,313200000,198,32,230,310500000
965580,Root,2020,Puzzle,"₩15,500",0%,3971,442,4413,3420075000,0,0,0,0
1062160,Poly Bridge 2,2020,Puzzle,"₩15,500",0%,7387,367,7754,6009350000,0,0,0,0
790740,Tick Tock: A Tale for Two,2019,Puzzle,"₩6,500",0%,9497,1559,11056,3593200000,0,0,0,0
1217390,Some Some Convenience Store,2020,Puzzle,"₩15,000",0%,2958,120,3078,2308500000,2770,115,2885,2163750000
641990,The Escapists 2,2017,Puzzle,"₩5,250",75%,28948,3000,31948,8386350000,0,0,0,0
813230,ANIMAL WELL,2024,Puzzle,"₩25,000",0%,19956,834,20790,25987500000,0,0,0,0
558990,Opus Magnum,2017,Puzzle,"₩21,500",0%,5848,153,6001,6451075000,0,0,0,0
2420660,Neva,2024,Puzzle,"₩21,500",0%,6580,396,6976,7499200000,0,0,0,0
2296990,We Were Here Expeditions: The FriendShip,2023,Puzzle,"₩4,500",0%,20306,2028,22334,5025150000,0,0,0,0
1240210,There Is No Game: Wrong Dimension,2020,Puzzle,"₩13,500",0%,22907,523,23430,15815250000,0,0,0,0
1225570,Unravel Two,2020,Puzzle,"₩22,000",0%,5994,1566,7560,8316000000,0,0,0,0
1808680,Snufkin: Melody of Moominvalley,2024,Puzzle,"₩12,900",40%,2942,80,3022,1949190000,0,0,0,0
1172450,Carto,2020,Puzzle,"₩6,150",70%,8247,294,8541,2626357500,0,0,0,0
359840,Shift Happens,2017,Puzzle,"₩18,000",0%,3192,861,4053,3647700000,0,0,0,0
1301390,No Umbrellas Allowed,2021,Puzzle,"₩20,500",0%,1074,257,1331,1364275000,1018,254,1272,1303800000
466130,White Day: A Labyrinth Named School,2017,Puzzle,"₩32,000",0%,3238,765,4003,6404800000,0,0,0,0
2714620,Duck Detective: The Ghost of Glamping,2025,Puzzle,"₩11,000",0%,902,7,909,499950000,1400,29,1429,785950000
2738490,Sol Cesto,2025,Puzzle,"₩13,500",0%,844,35,879,593325000,1588,101,1689,1140075000
1608230,Planet of Lana,2023,Puzzle,"₩21,500",0%,4899,340,5239,5631925000,0,0,0,0
282140,SOMA,2015,Puzzle,"₩9,600",70%,43530,1835,45365,21775200000,0,0,0,0
210970,The Witness,2016,Puzzle,"₩43,000",0%,16069,2868,18937,40714550000,0,0,0,0
553420,TUNIC,2022,Puzzle,"₩32,000",0%,13921,1260,15181,24289600000,0,0,0,0
1318690,shapez,2020,Puzzle,"₩11,000",0%,13165,516,13681,7524550000,0,0,0,0
261570,Ori and the Blind Forest,2015,Puzzle,Unknown,0%,54150,3262,57412,0,0,0,0,0
2650350,Super Puzzled Cat,2025,Puzzle,"₩18,500",0%,69,0,69,63825000,108,2,110,101750000
1455840,Dorfromantik,2022,Puzzle,"₩14,500",0%,26639,958,27597,20007825000,0,0,0,0
1292940,Cube Escape Collection,2020,Puzzle,"₩3,360",40%,6674,122,6796,1141728000,0,0,0,0
2637990,Duck Detective: The Secret Salami,2024,Puzzle,"₩11,000",0%,4870,220,5090,2799500000,0,0,0,0
238460,BattleBlock Theater®,2014,Puzzle,"₩15,500",0%,69617,1997,71614,55500850000,0,0,0,0
2825530,Beholder: Conductor,2025,Puzzle,"₩15,500",0%,1586,184,1770,1371750000,0,0,0,0
744190,Rusty Lake Paradise,2018,Puzzle,"₩2,700",40%,5582,266,5848,789480000,0,0,0,0
1147860,UFO 50,2024,Puzzle,"₩27,000",0%,5982,267,6249,8436150000,0,0,0,0
698670,Scorn,2022,Puzzle,"₩10,250",75%,11887,3613,15500,7943750000,0,0,0,0
557600,Gorogoa,2017,Puzzle,"₩18,000",0%,17531,435,17966,16169400000,0,0,0,0
501300,What Remains of Edith Finch,2017,Puzzle,"₩24,000",0%,43128,1925,45053,54063600000,0,0,0,0
241260,Sherlock Holmes: Crimes and Punishments,2014,Puzzle,"₩3,300",90%,6469,722,7191,1186515000,0,0,0,0
95400,ibb & obb,2014,Puzzle,"₩12,500",0%,5959,664,6623,4139375000,0,0,0,0
304430,INSIDE,2016,Puzzle,"₩21,500",0%,65954,2092,68046,73149450000,0,0,0,0
1555400,Gomoku Let's Go,2021,Puzzle,"₩3,300",0%,746,101,847,139755000,719,98,817,134805000
2291850,Underground Blossom,2023,Puzzle,"₩3,360",40%,6098,106,6204,1042272000,0,0,0,0
1592190,BONELAB,2022,Puzzle,"₩48,000",0%,12888,3393,16281,39074400000,0,0,0,0
2871440,Squeakross: Home Squeak Home,2025,Puzzle,"₩16,500",0%,0,0,0,0,929,19,948,782100000
2366980,Thank Goodness You're Here!,2024,Puzzle,"₩21,500",0%,5987,209,6196,6660700000,0,0,0,0
1003590,Tetris® Effect: Connected,2021,Puzzle,"₩41,000",0%,7528,404,7932,16260600000,0,0,0,0
2720280,Follow the meaning,2024,Puzzle,"₩5,600",0%,730,50,780,218400000,743,56,799,223720000
532110,Rusty Lake: Roots,2016,Puzzle,"₩2,700",40%,7484,259,7743,1045305000,0,0,0,0
690640,Trine 4: The Nightmare Prince,2019,Puzzle,"₩31,000",0%,11924,1455,13379,20737450000,0,0,0,0
621060,PC Building Simulator,2019,Puzzle,"₩21,500",0%,48356,3299,51655,55529125000,0,0,0,0
3688340,All About Chopsticks,2025,Puzzle,"₩4,500",0%,48,8,56,12600000,111,24,135,30375000
962400,Granny,2018,Puzzle,"₩5,500",0%,5106,375,5481,1507275000,0,0,0,0
1093290,The Wild at Heart,2021,Puzzle,"₩7,800",70%,674,30,704,274560000,522,28,550,214500000
1361320,The Room 4: Old Sins,2021,Puzzle,"₩9,500",0%,16047,230,16277,7731575000,0,0,0,0
2058730,The Darkest Files,2025,Puzzle,"₩20,500",0%,266,14,280,287000000,243,16,259,265475000
823500,BONEWORKS,2019,Puzzle,"₩32,000",0%,32917,2762,35679,57086400000,0,0,0,0
3446190,Hatsune Miku Logic Paint S+,2025,Puzzle,"₩16,500",0%,0,0,0,0,46,3,49,40425000
2287520,Five Nights at Freddy's: Help Wanted 2,2023,Puzzle,"₩42,000",0%,4588,232,4820,10122000000,0,0,0,0
367450,Poly Bridge,2016,Puzzle,"₩10,500",0%,16075,1509,17584,9231600000,0,0,0,0
885810,The Witch's House MV,2018,Puzzle,"₩16,500",0%,3298,153,3451,2847075000,0,0,0,0
1043810,Tactical Breach Wizards,2024,Puzzle,"₩21,500",0%,9301,166,9467,10177025000,0,0,0,0
2843190,Camper Van: Make it Home,2025,Puzzle,"₩16,500",0%,0,0,0,0,572,50,622,513150000
2702170,Strange Jigsaws,2025,Puzzle,"₩5,600",0%,0,0,0,0,1043,11,1054,295120000
504210,SHENZHEN I/O,2016,Puzzle,"₩16,500",0%,3958,205,4163,3434475000,0,0,0,0
953490,CARRION,2020,Puzzle,"₩21,500",0%,25814,1496,27310,29358250000,0,0,0,0
622650,Bendy and the Ink Machine,2017,Puzzle,"₩8,600",60%,26052,3238,29290,12594700000,0,0,0,0
456750,The Room Three,2018,Puzzle,"₩6,500",0%,11581,501,12082,3926650000,0,0,0,0
435120,Rusty Lake Hotel,2016,Puzzle,"₩1,380",40%,8845,374,9219,636111000,0,0,0,0
1145960,The White Door,2020,Puzzle,"₩4,500",0%,5639,374,6013,1352925000,0,0,0,0
1729740,Luto,2025,Puzzle,"₩21,500",0%,0,0,0,0,553,121,674,724550000
3352690,Dead Take,2025,Puzzle,"₩16,800",0%,0,0,0,0,378,51,429,360360000
2368930,ISLANDERS: New Shores,2025,Puzzle,"₩11,000",0%,0,0,0,0,430,13,443,243650000
1138850,Heavenly Bodies,2021,Puzzle,"₩20,500",0%,3753,175,3928,4026200000,0,0,0,0
375820,Human Resource Machine,2015,Puzzle,"₩16,500",0%,4137,271,4408,3636600000,0,0,0,0
288160,The Room,2014,Puzzle,"₩5,500",0%,28356,641,28997,7974175000,0,0,0,0
3743220,A Solitaire Mystery,2025,Puzzle,"₩11,000",0%,0,0,0,0,158,17,175,96250000
537110,Angels of Death,2016,Puzzle,"₩10,500",0%,4717,254,4971,2609775000,0,0,0,0
2232600,Anomaly Exit,2024,Puzzle,"₩3,500",0%,803,76,879,153825000,736,82,818,143150000
909080,Cube Escape: Paradox,2018,Puzzle,Free,0%,10264,290,10554,0,0,0,0,0
425580,The Room Two,2016,Puzzle,"₩5,500",0%,19460,468,19928,5480200000,0,0,0,0
1260520,Patrick's Parabox,2022,Puzzle,"₩21,500",0%,4437,35,4472,4807400000,0,0,0,0
1328840,Lost in Play,2022,Puzzle,"₩21,500",0%,6924,125,7049,7577675000,0,0,0,0
2972990,hololive Treasure Mountain,2024,Puzzle,"₩9,900",0%,751,16,767,379665000,789,16,805,398475000
1478220,Puzzle Together Multiplayer Jigsaw Puzzles,2020,Puzzle,Free,0%,3801,637,4438,0,0,0,0,0
2449160,While Waiting,2025,Puzzle,"₩21,500",0%,209,41,250,268750000,129,38,167,179525000
2915460,OneShot: World Machine Edition,2024,Puzzle,"₩8,800",19%,2773,34,2807,1235080000,0,0,0,0
1778840,Spirit of the North 2,2025,Puzzle,"₩24,000",25%,272,53,325,390000000,339,70,409,490800000
1179080,FAITH: The Unholy Trinity,2022,Puzzle,"₩16,500",0%,6933,329,7262,5991150000,0,0,0,0
572890,Pikuniku,2019,Puzzle,"₩14,500",0%,9576,425,10001,7250725000,0,0,0,0
996770,Moving Out,2020,Puzzle,"₩26,000",0%,1789,480,2269,2949700000,1222,268,1490,1937000000
522470,The House of Da Vinci,2017,Puzzle,"₩4,600",80%,5619,821,6440,1481200000,0,0,0,0
702670,Donut County,2018,Puzzle,"₩16,000",0%,9683,862,10545,8436000000,0,0,0,0
3699970,Blasfemia,2025,Puzzle,"₩16,500",0%,0,0,0,0,172,17,189,155925000
431940,Wildfire,2020,Puzzle,"₩4,650",70%,732,148,880,204600000,352,62,414,96255000
3672540,BACKROOM LOOP,2025,Puzzle,"₩5,600",0%,50,4,54,15120000,63,4,67,18760000
2121980,Void Stranger,2023,Puzzle,"₩13,500",0%,2086,213,2299,1551825000,0,0,0,0
221910,The Stanley Parable,2013,Puzzle,"₩16,500",0%,41582,3400,44982,37110150000,0,0,0,0
343780,Cat Goes Fishing,2015,Puzzle,"₩7,500",0%,13316,840,14156,5308500000,0,0,0,0
368340,CrossCode,2018,Puzzle,"₩21,000",0%,15699,1167,16866,17709300000,0,0,0,0
1670870,MADiSON,2022,Puzzle,"₩36,000",0%,2592,370,2962,5331600000,0,0,0,0
956030,Creaks,2020,Puzzle,"₩22,000",0%,4607,248,4855,5340500000,0,0,0,0
1996010,Crow Country,2024,Puzzle,"₩21,500",0%,5295,89,5384,5787800000,0,0,0,0
1242980,KeyWe,2021,Puzzle,"₩26,000",0%,1686,174,1860,2418000000,1256,124,1380,1794000000
48000,LIMBO,2011,Puzzle,"₩11,000",0%,53043,4241,57284,31506200000,0,0,0,0
2303350,Sticky Business,2023,Puzzle,"₩11,000",0%,5833,338,6171,3394050000,0,0,0,0
1820620,Voxelgram 2,2025,Puzzle,"₩9,900",9%,0,0,0,0,27,2,29,14355000
893720,One Hand Clapping,2021,Puzzle,"₩15,000",0%,840,126,966,724500000,671,118,789,591750000
986130,Shadows of Doubt,2024,Puzzle,"₩27,000",0%,12941,2487,15428,20827800000,0,0,0,0
298630,The Escapists,2015,Puzzle,"₩19,000",0%,14481,1569,16050,15247500000,0,0,0,0
1213700,Spirit of the North,2020,Puzzle,"₩5,120",75%,4556,823,5379,1377024000,0,0,0,0
483980,Mad Father,2016,Puzzle,"₩10,500",0%,5561,158,5719,3002475000,0,0,0,0
1257410,Cat in the Box,2020,Puzzle,"₩7,800",0%,1294,79,1373,535470000,1210,77,1287,501930000
1259840,The House of Da Vinci 2,2020,Puzzle,"₩6,900",70%,1813,163,1976,681720000,1680,166,1846,636870000
322500,SUPERHOT,2016,Puzzle,"₩25,000",0%,35390,3386,38776,48470000000,0,0,0,0
732690,FIVE NIGHTS AT FREDDY'S: HELP WANTED,2019,Puzzle,"₩31,000",0%,11969,494,12463,19317650000,0,0,0,0
555220,Detention,2017,Puzzle,"₩13,000",0%,11782,2596,14378,9345700000,0,0,0,0
541570,Sally Face - Episode One,2016,Puzzle,"₩3,400",0%,21939,622,22561,3835370000,0,0,0,0
1202900,Assemble with Care,2020,Puzzle,"₩8,900",0%,7890,800,8690,3867050000,0,0,0,0
2008920,Lorelei and the Laser Eyes,2024,Puzzle,"₩29,500",0%,2151,120,2271,3349725000,0,0,0,0
1335560,UNREAL LIFE,2020,Puzzle,"₩20,500",0%,1603,70,1673,1714825000,1550,82,1632,1672800000
370360,TIS-100,2015,Puzzle,"₩7,800",0%,3750,126,3876,1511640000,0,0,0,0
359510,Tangle Tower,2019,Puzzle,"₩21,500",0%,5001,242,5243,5636225000,0,0,0,0
233720,Surgeon Simulator,2013,Puzzle,"₩2,200",80%,13566,2927,16493,1814230000,0,0,0,0
1875060,Reus 2,2024,Puzzle,"₩27,000",0%,1836,92,1928,2602800000,1777,94,1871,2525850000
990630,The Last Campfire,2021,Puzzle,"₩16,500",0%,14350,348,14698,12125850000,0,0,0,0
1158470,Voxelgram,2019,Puzzle,"₩3,300",70%,581,9,590,97350000,593,12,605,99825000
260230,Valiant Hearts: The Great War™ / Soldats Inconnus : Mémoires de la Grande Guerre™,2014,Puzzle,"₩16,500",0%,24888,1155,26043,21485475000,0,0,0,0
2976400,Fork Road,2024,Puzzle,"₩3,150",30%,561,172,733,115447500,549,173,722,113715000
3591550,Hunter Roulette,2025,Puzzle,"₩1,840",19%,0,0,0,0,323,44,367,33764000
1983260,Dungeons of Hinterberg,2024,Puzzle,"₩28,500",0%,1892,105,1997,2845725000,1700,109,1809,2577825000
1213230,Rain on Your Parade,2021,Puzzle,"₩16,500",0%,822,34,856,706200000,651,27,678,559350000
1288310,Firework,2021,Puzzle,"₩10,500",0%,40672,886,41558,21817950000,0,0,0,0
1889740,Paper Trail,2024,Puzzle,"₩21,500",0%,476,20,496,533200000,383,20,403,433225000
1321120,Matsuro Palette,2020,Puzzle,"₩7,150",35%,192,2,194,69355000,181,4,185,66137500
1567440,inbento,2021,Puzzle,"₩5,600",0%,1771,52,1823,510440000,1757,73,1830,512400000
627690,Idle Champions of the Forgotten Realms,2020,Puzzle,Free,0%,11212,3268,14480,0,0,0,0,0
1927720,Monument Valley,2022,Puzzle,"₩8,500",0%,6189,120,6309,2681325000,0,0,0,0
3439320,Red or Blue,2025,Puzzle,"₩4,500",0%,75,4,79,17775000,88,6,94,21150000
354240,"Please, Don’t Touch Anything",2015,Puzzle,"₩5,600",0%,4684,607,5291,1481480000,0,0,0,0
1123450,Chicory: A Colorful Tale,2021,Puzzle,"₩21,500",0%,3343,77,3420,3676500000,0,0,0,0
850320,PHOGS!,2020,Puzzle,"₩26,000",0%,886,195,1081,1405300000,724,193,917,1192100000
1104380,The Room VR: A Dark Matter,2020,Puzzle,"₩30,000",0%,3631,92,3723,5584500000,0,0,0,0
418240,Shadow Tactics: Blades of the Shogun,2016,Puzzle,"₩45,000",0%,35767,1470,37237,83783250000,0,0,0,0
1906830,While the Iron's Hot,2023,Puzzle,"₩14,040",40%,155,29,184,129168000,134,30,164,115128000
619150,while True: learn(),2019,Puzzle,"₩13,500",0%,6967,651,7618,5142150000,0,0,0,0
1255560,Myst,2021,Puzzle,"₩37,500",0%,1619,203,1822,3416250000,1539,210,1749,3279375000
602320,Train Valley 2,2019,Puzzle,"₩15,500",0%,2592,279,2871,2225025000,0,0,0,0
2396240,SteamWorld Heist II,2024,Puzzle,"₩32,000",0%,1794,91,1885,3016000000,1724,110,1834,2934400000
1603640,The House of Da Vinci 3,2022,Puzzle,"₩23,000",0%,1048,120,1168,1343200000,1032,128,1160,1334000000
3204020,Juufuutei Raden™'s Guide for Pixel Museum,2025,Puzzle,"₩21,500",0%,13,0,13,13975000,191,4,195,209625000
1999520,CATO: Buttered Cat,2024,Puzzle,"₩12,500",0%,0,0,0,0,0,0,0,0
1303950,Toodee and Topdee,2021,Puzzle,"₩21,500",0%,715,43,758,814850000,564,36,600,645000000
716490,EXAPUNKS,2018,Puzzle,"₩21,500",0%,1676,90,1766,1898450000,1242,52,1294,1391050000
1116580,Shady Part of Me,2020,Puzzle,"₩17,800",0%,2549,147,2696,2399440000,0,0,0,0
2377970,Cats Hidden Around the World,2024,Puzzle,"₩5,500",0%,504,13,517,142175000,577,18,595,163625000
1497440,COCOON,2023,Puzzle,"₩29,500",0%,7155,390,7545,11128875000,0,0,0,0
1369340,Cats Organized Neatly,2020,Puzzle,"₩3,300",0%,4307,105,4412,727980000,0,0,0,0
1521360,MainFrames,2025,Puzzle,"₩7,250",50%,89,11,100,36250000,99,12,111,40237500
1067850,Kindergarten 2,2019,Puzzle,"₩16,500",0%,4793,99,4892,4035900000,0,0,0,0
1333200,Song of Nunu: A League of Legends Story,2023,Puzzle,"₩32,000",0%,2593,137,2730,4368000000,0,0,0,0
35720,Trine 2: Complete Story,2013,Puzzle,"₩21,000",0%,20682,997,21679,22762950000,0,0,0,0
617670,Zup! S,2018,Puzzle,"₩2,300",0%,10555,265,10820,1244300000,0,0,0,0
2153770,Coin Flipper,2022,Puzzle,"₩3,400",0%,295,37,332,56440000,297,44,341,57970000
57300,Amnesia: The Dark Descent,2010,Puzzle,"₩21,500",0%,32258,1850,34108,36666100000,0,0,0,0
609320,FAR: Lone Sails,2018,Puzzle,"₩15,500",0%,21211,1104,22315,17294125000,0,0,0,0
362680,Fran Bow,2015,Puzzle,"₩16,000",0%,18502,514,19016,15212800000,0,0,0,0
942970,Unheard - Voices of Crime,2019,Puzzle,"₩10,500",0%,30125,1184,31309,16437225000,0,0,0,0
2951880,Cats Hidden Around the World 2,2025,Puzzle,"₩5,600",0%,0,0,0,0,84,3,87,24360000
814540,Changed,2018,Puzzle,"₩5,600",0%,14935,2269,17204,4817120000,0,0,0,0
1097200,Twelve Minutes,2021,Puzzle,"₩29,500",0%,5394,2011,7405,10922375000,0,0,0,0
603390,Stone Story RPG,2023,Puzzle,"₩32,000",0%,850,80,930,1488000000,758,84,842,1347200000
3209480,Last Report,2025,Puzzle,"₩5,600",0%,0,0,0,0,918,102,1020,285600000
2744010,Urban Jungle,2025,Puzzle,"₩13,500",0%,369,22,391,263925000,368,32,400,270000000
435400,Hidden Folks,2017,Puzzle,"₩16,500",0%,8952,309,9261,7640325000,0,0,0,0
893850,THE LONGING,2020,Puzzle,"₩11,010",23%,6266,522,6788,3736794000,0,0,0,0
3005620,Drop Pockets,2025,Puzzle,"₩16,500",0%,0,0,0,0,90,21,111,91575000
1746030,Murders on the Yangtze River,2024,Puzzle,"₩16,500",0%,17698,494,18192,15008400000,0,0,0,0
1579380,Shadow Tactics: Aiko's Choice,2021,Puzzle,"₩24,000",0%,4144,292,4436,5323200000,0,0,0,0
618950,Agatha Knife,2017,Puzzle,"₩13,500",0%,547,36,583,393525000,487,37,524,353700000
1178490,港詭實錄ParanormalHK,2020,Puzzle,"₩13,500",0%,17056,1889,18945,12787875000,0,0,0,0
316790,Grim Fandango Remastered,2015,Puzzle,"₩16,000",0%,7433,769,8202,6561600000,0,0,0,0
3686920,Cursed Shorts,2025,Puzzle,₩990,9%,0,0,0,0,19,5,24,1188000
3517980,Secrets of Blackrock Manor - Escape Room,2025,Puzzle,"₩11,000",0%,0,0,0,0,62,9,71,39050000
1411740,Urbek City Builder,2022,Puzzle,"₩19,500",0%,1427,146,1573,1533675000,1362,151,1513,1475175000
2019810,Boxes: Lost Fragments,2024,Puzzle,"₩16,500",0%,3621,280,3901,3218325000,0,0,0,0
473950,Manifold Garden,2020,Puzzle,"₩21,500",0%,6901,328,7229,7771175000,0,0,0,0
3359320,SchoolBoy Runaway,2024,Puzzle,"₩6,700",0%,1853,172,2025,678375000,0,0,0,0
1577620,The Signal State,2021,Puzzle,"₩20,500",0%,497,75,572,586300000,482,79,561,575025000
1063660,Bendy and the Dark Revival,2022,Puzzle,"₩10,560",67%,12068,907,12975,6850800000,0,0,0,0
1042490,Call of the Sea,2020,Puzzle,"₩21,500",0%,4559,609,5168,5555600000,0,0,0,0
3385670,World of Goo 2,2025,Puzzle,"₩32,000",0%,376,43,419,670400000,412,61,473,756800000
3084280,Threefold Recital,2025,Puzzle,"₩16,500",0%,3436,39,3475,2866875000,3676,75,3751,3094575000
1490410,The fairy tale you don't know,2021,Puzzle,"₩19,500",0%,158,47,205,199875000,145,46,191,186225000
496890,Replica,2016,Puzzle,"₩3,400",0%,2950,487,3437,584290000,0,0,0,0
2004180,DAGURI: Gambling Apocalypse,2022,Puzzle,"₩3,300",0%,180,10,190,31350000,174,11,185,30525000
2060590,Wilmot Works It Out,2024,Puzzle,"₩16,500",0%,463,3,466,384450000,500,10,510,420750000
257510,The Talos Principle,2014,Puzzle,"₩32,000",0%,30399,1462,31861,50977600000,0,0,0,0
3255870,Whisper of Y'Ryando,2025,Puzzle,"₩5,340",40%,0,0,0,0,33,5,38,10146000
2464120,YUME 3,2023,Puzzle,"₩3,900",25%,283,75,358,69810000,262,74,336,65520000
792100,7 Billion Humans,2018,Puzzle,"₩16,500",0%,1829,123,1952,1610400000,1615,122,1737,1433025000
262410,World of Guns: Gun Disassembly,2014,Puzzle,Free,0%,16184,3058,19242,0,0,0,0,0
736190,Chinese Parents,2018,Puzzle,"₩10,500",0%,23459,2192,25651,13466775000,0,0,0,0
300570,Infinifactory,2015,Puzzle,"₩27,000",0%,2291,123,2414,3258900000,1664,88,1752,2365200000
405640,Pony Island,2016,Puzzle,"₩5,500",0%,16339,843,17182,4725050000,0,0,0,0
1349230,5D Chess With Multiverse Time Travel,2020,Puzzle,"₩12,500",0%,7934,265,8199,5124375000,0,0,0,0
92800,SpaceChem,2011,Puzzle,"₩11,000",0%,4605,387,4992,2745600000,0,0,0,0
3603580,Whisker Wanderlust: The Wondrous Journey,2025,Puzzle,"₩7,020",9%,0,0,0,0,50,2,52,18252000
1162070,Nyakori's Rabbit Doll,2020,Puzzle,"₩2,040",40%,1268,65,1333,135966000,1220,64,1284,130968000
2224640,Artisan TD,2024,Puzzle,"₩17,900",0%,1848,231,2079,1860705000,0,0,0,0
1564790,Submachine: Legacy,2023,Puzzle,"₩26,000",0%,1256,19,1275,1657500000,1152,24,1176,1528800000
1002260,Ruffy and the Riverside,2025,Puzzle,"₩21,120",19%,0,0,0,0,101,15,116,122496000
1225560,Unravel,2020,Puzzle,"₩22,000",0%,4556,481,5037,5540700000,0,0,0,0
224760,FEZ,2013,Puzzle,"₩10,500",0%,14425,1137,15562,8170050000,0,0,0,0
353540,Stephen's Sausage Roll,2016,Puzzle,"₩32,000",0%,1672,81,1753,2804800000,1321,55,1376,2201600000
452570,Battle Chef Brigade Deluxe,2017,Puzzle,"₩4,100",80%,2506,119,2625,538125000,1418,75,1493,306065000
846470,Moss,2018,Puzzle,"₩21,500",0%,3072,157,3229,3471175000,0,0,0,0
1887400,ANTONBLAST,2024,Puzzle,"₩21,500",0%,3452,136,3588,3857100000,0,0,0,0
3019370,Malware,2024,Puzzle,"₩3,400",0%,941,119,1060,180200000,896,122,1018,173060000
1570010,FAR: Changing Tides,2022,Puzzle,"₩20,500",0%,4324,349,4673,4789825000,0,0,0,0
529590,"Please, Don't Touch Anything 3D",2016,Puzzle,"₩11,000",0%,1074,227,1301,715550000,1018,224,1242,683100000
597220,West of Loathing,2017,Puzzle,"₩11,500",0%,9536,222,9758,5610850000,0,0,0,0
2246110,Q REMASTERED,2023,Puzzle,"₩9,900",0%,336,61,397,196515000,308,63,371,183645000
2654860,Mizi NO!,2024,Puzzle,Free,0%,0,0,0,0,0,0,0,0
966320,Later Alligator,2019,Puzzle,"₩18,500",0%,2664,101,2765,2557625000,0,0,0,0
860950,Mark of the Ninja: Remastered,2018,Puzzle,"₩20,500",0%,5913,241,6154,6307850000,0,0,0,0
219890,Antichamber,2013,Puzzle,"₩21,000",0%,16269,846,17115,17970750000,0,0,0,0
3426920,Twisted Gallery 异馆,2025,Puzzle,"₩5,600",0%,0,0,0,0,79,20,99,27720000
589590,Kindergarten,2017,Puzzle,"₩5,600",0%,8518,299,8817,2468760000,0,0,0,0
2938850,Sakura Hime 5,2025,Puzzle,"₩4,500",0%,95,9,104,23400000,107,12,119,26775000
2608040,Cats Hidden in China,2024,Puzzle,"₩1,100",0%,601,11,612,33660000,701,14,715,39325000
2872750,Dungeon Dev,2024,Puzzle,"₩3,150",30%,39,6,45,7087500,40,6,46,7245000
1182310,The Excavation of Hob's Barrow,2022,Puzzle,"₩7,750",50%,2264,180,2444,947050000,1779,134,1913,741287500
3684610,s.p.l.i.t,2025,Puzzle,"₩3,400",0%,0,0,0,0,1387,121,1508,256360000
1141020,Adventure Escape Mysteries,2020,Puzzle,Free,0%,809,126,935,0,843,137,980,0
3446980,#holoReversi,2025,Puzzle,"₩11,000",0%,0,0,0,0,14,5,19,10450000
1813860,NAIAD,2024,Puzzle,"₩20,900",0%,273,8,281,293645000,292,12,304,317680000
2986450,Metro Gravity,2025,Puzzle,"₩14,500",0%,0,0,0,0,333,18,351,254475000
859570,Secret Neighbor: Hello Neighbor Multiplayer,2019,Puzzle,"₩21,500",0%,15991,2508,18499,19886425000,0,0,0,0
416600,Full Metal Furies,2018,Puzzle,"₩21,500",0%,2558,261,2819,3030425000,0,0,0,0
1116480,Slender Threads,2025,Puzzle,"₩21,500",0%,346,26,372,399900000,334,29,363,390225000
2770160,Maxwell's puzzling demon,2024,Puzzle,"₩16,500",0%,223,2,225,185625000,250,5,255,210375000
3472550,The Mr. Rabbit Magic Show,2025,Puzzle,Free,0%,0,0,0,0,0,0,0,0
1158890,White Shadows,2021,Puzzle,"₩20,500",0%,841,188,1029,1054725000,925,217,1142,1170550000
1077970,Dry Drowning,2019,Puzzle,"₩20,500",0%,400,93,493,505325000,308,67,375,384375000
1533050,Press Ctrl,2021,Puzzle,"₩2,200",0%,503,54,557,61270000,398,44,442,48620000
2918410,Tower of Mask,2024,Puzzle,"₩8,750",30%,199,6,205,89687500,212,11,223,97562500
2926550,Poltergeist Watcher,2024,Puzzle,"₩7,800",0%,78,4,82,31980000,51,3,54,21060000
1046820,I'm on Observation Duty,2019,Puzzle,"₩3,400",0%,1910,82,1992,338640000,1798,95,1893,321810000
1195290,Moncage,2021,Puzzle,"₩15,500",0%,4906,393,5299,4106725000,0,0,0,0
428660,Deliver Us The Moon,2019,Puzzle,"₩26,000",0%,7421,956,8377,10890100000,0,0,0,0
1619230,The Star Named EOS,2024,Puzzle,"₩16,500",0%,439,17,456,376200000,359,19,378,311850000
714120,Little Misfortune,2019,Puzzle,"₩20,500",0%,11125,962,12087,12389175000,0,0,0,0
2346840,One-Eyed Likho,2025,Puzzle,"₩21,500",0%,0,0,0,0,447,39,486,522450000
3194140,Cozy Sudoku,2024,Puzzle,"₩3,400",0%,59,5,64,10880000,58,6,64,10880000
266010,LYNE,2014,Puzzle,"₩2,590",0%,7825,355,8180,1059310000,0,0,0,0
1049280,Pilgrims,2019,Puzzle,"₩7,800",0%,4909,201,5110,1992900000,0,0,0,0
617160,Home Sweet Home,2017,Puzzle,"₩17,500",0%,3168,491,3659,3201625000,0,0,0,0
355630,Leo’s Fortune - HD Edition,2015,Puzzle,"₩6,120",0%,379,32,411,125766000,356,35,391,119646000
1709880,Loco Motive,2024,Puzzle,"₩17,550",0%,681,39,720,631800000,720,46,766,672165000
897330,Coloring Pixels,2018,Puzzle,Free,0%,7622,297,7919,0,0,0,0,0
1338580,McPixel 3,2022,Puzzle,"₩11,000",0%,1412,92,1504,827200000,1007,42,1049,576950000
1597730,Dogs Organized Neatly,2021,Puzzle,"₩3,300",0%,1262,23,1285,212025000,1197,37,1234,203610000
1885690,Virtual Circuit Board,2023,Puzzle,"₩15,500",0%,257,16,273,211575000,246,16,262,203050000
1889040,Birth,2023,Puzzle,"₩11,500",0%,3037,115,3152,1812400000,0,0,0,0
552440,The Talos Principle VR,2017,Puzzle,"₩32,000",0%,692,137,829,1326400000,652,133,785,1256000000
3228180,Click Mage,2025,Puzzle,"₩5,600",0%,1661,118,1779,498120000,1770,133,1903,532840000
2707110,Birds Organized Neatly,2024,Puzzle,"₩3,400",0%,134,2,136,23120000,163,5,168,28560000
1577320,Somewhere in the Shadow,2021,Puzzle,"₩3,400",0%,561,147,708,120360000,452,113,565,96050000
2934890,The Last Visit: 98th,2025,Puzzle,"₩6,700",0%,61,6,67,22445000,88,16,104,34840000
851670,LUMINES REMASTERED,2018,Puzzle,"₩15,500",0%,602,36,638,494450000,560,29,589,456475000
1865060,14 Minesweeper Variants,2022,Puzzle,"₩7,800",0%,1229,37,1266,493740000,1245,39,1284,500760000
850000,Noel the Mortal Fate Complete Edition,2018,Puzzle,"₩15,500",0%,2525,101,2626,2035150000,0,0,0,0
1628610,Paquerette Down the Bunburrows,2023,Puzzle,"₩13,500",0%,1017,26,1043,704025000,929,29,958,646650000
1184760,Shovel Knight Pocket Dungeon,2021,Puzzle,"₩20,500",0%,460,45,505,517625000,435,43,478,489950000
760890,Hello Charlotte EP3: Childhood's End,2018,Puzzle,"₩4,500",0%,2558,47,2605,586125000,0,0,0,0
244910,Homesick,2015,Puzzle,"₩3,200",80%,1092,301,1393,222880000,947,283,1230,196800000
2951770,Leap Year,2024,Puzzle,"₩5,600",0%,2201,57,2258,632240000,0,0,0,0
1216710,Cyber Manhunt,2021,Puzzle,"₩10,500",0%,13720,1000,14720,7728000000,0,0,0,0
3512250,Paranormal Torment,2025,Puzzle,"₩5,600",0%,0,0,0,0,46,10,56,15680000
3191030,Nubby's Number Factory,2025,Puzzle,"₩5,600",0%,9206,227,9433,2641240000,0,0,0,0
1297210,Tandis,2022,Puzzle,"₩16,500",0%,175,8,183,150975000,178,9,187,154275000
1046030,ISLANDERS,2019,Puzzle,"₩6,500",0%,15434,882,16316,5302700000,0,0,0,0
351030,Pixel Puzzles Ultimate Jigsaw Puzzles,2022,Puzzle,Free,0%,2018,659,2677,0,0,0,0,0
2070850,Sakura Hime 4,2024,Puzzle,"₩4,500",0%,220,14,234,52650000,220,14,234,52650000
2207440,LOK Digital,2024,Puzzle,"₩16,500",0%,310,3,313,258225000,308,3,311,256575000
3687600,Seeking The Guardian,2025,Puzzle,"₩9,900",0%,11,1,12,5940000,20,2,22,10890000
1307870,Sensorium,2020,Puzzle,"₩11,000",0%,206,18,224,123200000,213,18,231,127050000
359310,Evoland 2,2015,Puzzle,"₩5,250",75%,3345,491,3836,1006950000,1589,217,1806,474075000
2919660,JudgeSim,2024,Puzzle,"₩7,800",0%,783,136,919,358410000,865,165,1030,401700000
1720850,A=B,2022,Puzzle,"₩5,600",0%,773,36,809,226520000,765,40,805,225400000
2827680,Block Factory,2025,Puzzle,"₩11,000",0%,0,0,0,0,145,43,188,103400000
1309950,Children of the Sun,2024,Puzzle,"₩16,500",0%,1613,110,1723,1421475000,1488,112,1600,1320000000
1254370,No one lives under the lighthouse Director's cut,2020,Puzzle,"₩3,750",50%,1910,277,2187,410062500,0,0,0,0
742490,Nonogram - The Greatest Painter,2018,Puzzle,"₩4,500",0%,302,35,337,75825000,286,35,321,72225000
1337920,Serial Cleaners,2022,Puzzle,"₩27,000",0%,328,96,424,572400000,252,88,340,459000000
1228520,[Chilla's Art] The Convenience Store | 夜勤事件,2020,Puzzle,"₩3,400",0%,2441,480,2921,496570000,0,0,0,0
2984860,Letters of Bernard Thorne,2025,Puzzle,"₩11,000",0%,90,1,91,50050000,94,3,97,53350000
2984860,Letters of Bernard Thorne,2025,Puzzle,"₩11,000",0%,90,1,91,50050000,94,3,97,53350000
2120310,Sagres,2023,Puzzle,"₩23,000",0%,166,37,203,233450000,142,35,177,203550000
1796580,Sorry We're Closed,2024,Puzzle,"₩27,000",0%,1336,24,1360,1836000000,1221,25,1246,1682100000
3422450,Whisker Wanderlust: The Mosaic of Souls,2025,Puzzle,"₩3,920",30%,114,9,123,24108000,112,11,123,24108000
739190,AntVentor,2018,Puzzle,"₩1,680",70%,396,82,478,40152000,350,82,432,36288000
1244630,House Builder,2024,Puzzle,"₩20,340",0%,1893,456,2349,2388933000,0,0,0,0
1812560,SUPER CRAZY RHYTHM CASTLE,2023,Puzzle,"₩28,700",0%,211,38,249,357315000,230,72,302,433370000
3451440,Train Valley Origins,2025,Puzzle,"₩12,000",0%,0,0,0,0,126,30,156,93600000
1707550,Granny 3,2021,Puzzle,"₩5,500",0%,899,78,977,268675000,893,78,971,267025000
938560,INMOST,2020,Puzzle,"₩15,500",0%,6083,597,6680,5177000000,0,0,0,0
221260,Little Inferno,2012,Puzzle,"₩16,500",0%,12216,668,12884,10629300000,0,0,0,0
1148650,The Legend of Bum-Bo,2019,Puzzle,"₩16,500",0%,4695,1106,5801,4785825000,0,0,0,0
1622770,Doors: Paradox,2022,Puzzle,"₩16,500",0%,1414,132,1546,1275450000,1143,99,1242,1024650000
1234550,Quest Rooms,2020,Puzzle,"₩20,500",0%,85,44,129,132225000,78,40,118,120950000
2313240,Cats Hidden in Italy,2023,Puzzle,"₩1,100",0%,1687,41,1728,95040000,1597,49,1646,90530000
248610,Door Kickers,2014,Puzzle,"₩21,500",0%,9277,561,9838,10575850000,0,0,0,0
344850,Big Pharma,2015,Puzzle,"₩27,000",0%,1458,425,1883,2542050000,1098,310,1408,1900800000
1205450,Turnip Boy Commits Tax Evasion,2021,Puzzle,"₩15,500",0%,12156,673,12829,9942475000,0,0,0,0
304410,Hexcells Infinite,2014,Puzzle,"₩5,600",0%,4311,129,4440,1243200000,0,0,0,0
1390350,Webbed,2021,Puzzle,"₩10,500",0%,13512,326,13838,7264950000,0,0,0,0
1094680,Hidden Through Time 2: Discovery,2024,Puzzle,"₩12,500",0%,111,18,129,80625000,102,20,122,76250000
511470,Glass Masquerade,2016,Puzzle,"₩5,600",0%,6405,202,6607,1849960000,0,0,0,0
939400,LoveChoice,2021,Puzzle,"₩2,300",0%,31465,2425,33890,3897350000,0,0,0,0
2292650,Escape From Mystwood Mansion,2023,Puzzle,"₩18,500",0%,860,53,913,844525000,588,44,632,584600000
939400,LoveChoice,2021,Puzzle,"₩2,300",0%,31465,2425,33890,3897350000,0,0,0,0
968350,Hotel Sowls,2019,Puzzle,"₩5,500",0%,544,24,568,156200000,460,24,484,133100000
3044100,Bat to the Heavens,2024,Puzzle,"₩16,500",0%,231,6,237,195525000,252,10,262,216150000
1067540,Röki,2020,Puzzle,"₩26,000",0%,2595,295,2890,3757000000,0,0,0,0
1996210,Sakura Hime 3,2022,Puzzle,"₩4,500",0%,493,28,521,117225000,473,30,503,113175000
835430,La-Mulana 2,2018,Puzzle,"₩26,000",0%,845,141,986,1281800000,628,120,748,972400000
1119980,In Sound Mind,2021,Puzzle,"₩36,000",0%,5535,277,5812,10461600000,0,0,0,0
552620,ATOM RPG: Post-apocalyptic indie game,2018,Puzzle,"₩16,000",0%,8888,1887,10775,8620000000,0,0,0,0
1161170,The Rewinder,2021,Puzzle,"₩14,940",0%,6702,255,6957,5196879000,0,0,0,0
1913490,Adorable Witch 3,2022,Puzzle,"₩3,400",0%,473,80,553,94010000,450,79,529,89930000
2551170,Cats Hidden in Maple Hollow 🍂,2023,Puzzle,"₩1,100",0%,0,0,0,0,1085,22,1107,60885000
206190,Gunpoint,2013,Puzzle,"₩10,500",0%,12770,323,13093,6873825000,0,0,0,0
809060,REVEIL,2024,Puzzle,"₩24,000",0%,630,79,709,850800000,514,77,591,709200000
1333910,Sizeable,2021,Puzzle,"₩10,500",0%,2269,44,2313,1214325000,0,0,0,0
209630,Magrunner: Dark Pulse,2013,Puzzle,"₩2,200",90%,803,288,1091,120010000,284,71,355,39050000
2081470,Red Matter 2,2022,Puzzle,"₩36,600",0%,547,40,587,1074210000,536,40,576,1054080000
3194300,StrangePool,2024,Puzzle,"₩4,500",0%,44,11,55,12375000,43,13,56,12600000
844590,Hypnospace Outlaw,2019,Puzzle,"₩20,500",0%,4633,148,4781,4900525000,0,0,0,0
3084150,Packit List,2024,Puzzle,"₩4,400",0%,80,6,86,18920000,87,7,94,20680000
1354910,Tiny Lands,2021,Puzzle,"₩7,500",0%,919,75,994,372750000,750,65,815,305625000
1421790,Labyrinth City: Pierre the Maze Detective,2021,Puzzle,"₩12,500",0%,2047,90,2137,1335625000,1723,72,1795,1121875000
260750,Neighbours from Hell Compilation,2013,Puzzle,Unknown,0%,2872,68,2940,0,0,0,0,0
3073900,SLACKJAW,2025,Puzzle,"₩7,920",19%,0,0,0,0,52,9,61,24156000
1295320,Can of Wormholes,2023,Puzzle,"₩21,500",0%,447,5,452,485900000,450,5,455,489125000
218680,Scribblenauts Unlimited,2013,Puzzle,"₩3,150",85%,11038,717,11755,1851412500,0,0,0,0
384680,MechaNika,2015,Puzzle,"₩4,500",0%,796,81,877,197325000,610,68,678,152550000
1491670,Venba,2023,Puzzle,"₩16,500",0%,2379,198,2577,2126025000,1663,125,1788,1475100000
1206430,The Unfinished Swan,2020,Puzzle,"₩18,000",0%,1450,271,1721,1548900000,1394,266,1660,1494000000
3623590,The 5th Door,2025,Puzzle,"₩6,210",0%,31,0,31,9625500,18,1,19,5899500
3547010,Occlude,2025,Puzzle,"₩8,900",0%,0,0,0,0,175,24,199,88555000
587430,I Expect You To Die,2017,Puzzle,"₩27,000",0%,2496,144,2640,3564000000,0,0,0,0
251110,INFRA,2016,Puzzle,"₩32,000",0%,2900,370,3270,5232000000,0,0,0,0
975620,Project DeepWeb,2020,Puzzle,"₩3,560",60%,91,15,106,18868000,85,16,101,17978000
1456880,ElecHead,2021,Puzzle,"₩10,500",0%,0,0,0,0,962,40,1002,526050000
976010,I hate this game,2019,Puzzle,"₩2,310",0%,2099,163,2262,261261000,0,0,0,0
259810,Home Sheep Home: Farmageddon Party Edition,2014,Puzzle,"₩10,500",0%,725,32,757,397425000,534,28,562,295050000
2356500,Cats Hidden in Bali,2023,Puzzle,"₩1,100",0%,1186,16,1202,66110000,1146,23,1169,64295000
1848520,Fruit Salad,2023,Puzzle,"₩1,720",25%,279,12,291,25026000,256,13,269,23134000
774201,Heaven's Vault,2019,Puzzle,"₩26,000",0%,1889,320,2209,2871700000,1523,248,1771,2302300000
2776570,Cats Hidden in Germany,2024,Puzzle,"₩1,100",0%,296,9,305,16775000,347,14,361,19855000
319910,Trine 3: The Artifacts of Power,2015,Puzzle,"₩23,000",0%,5598,3261,8859,10187850000,0,0,0,0
569860,Thimbleweed Park™,2017,Puzzle,"₩21,000",0%,3673,263,3936,4132800000,0,0,0,0
2472770,Automate It: Factory Puzzle,2025,Puzzle,"₩14,500",0%,31,2,33,23925000,45,10,55,39875000
3636440,Click To Continue,2025,Puzzle,"₩5,600",0%,26,1,27,7560000,118,10,128,35840000
1150950,Timelie,2020,Puzzle,"₩18,500",0%,2277,141,2418,2236650000,1637,86,1723,1593775000
589780,The Red Strings Club,2018,Puzzle,"₩16,500",0%,12057,782,12839,10592175000,0,0,0,0
574560,"Dude, Stop",2018,Puzzle,"₩15,500",0%,2171,335,2506,1942150000,0,0,0,0
1166290,Death and Taxes,2020,Puzzle,"₩14,500",0%,6106,922,7028,5095300000,0,0,0,0
1814170,Lingo,2021,Puzzle,"₩11,000",0%,596,37,633,348150000,601,45,646,355300000
1536980,Glass Masquerade 3: Honeylines,2023,Puzzle,"₩5,600",0%,881,77,958,268240000,880,87,967,270760000
3121470,Chroma Zero,2024,Puzzle,"₩12,010",0%,196,3,199,119499500,186,8,194,116497000
322450,FRAMED Collection,2018,Puzzle,"₩11,000",0%,2718,202,2920,1606000000,0,0,0,0
2826800,Amanda the Adventurer 2,2024,Puzzle,"₩11,000",0%,921,200,1121,616550000,929,204,1133,623150000
2216830,The Jackbox Party Pack 10,2023,Puzzle,"₩32,000",0%,368,204,572,915200000,297,174,471,753600000
1544360,LEGO® Builder's Journey,2021,Puzzle,"₩21,500",0%,3303,666,3969,4266675000,0,0,0,0
355980,Dungeon Warfare,2015,Puzzle,"₩9,900",0%,1834,82,1916,948420000,1756,92,1848,914760000
2447100,Scarred,2025,Puzzle,"₩8,900",0%,55,45,100,44500000,45,41,86,38270000
1825110,Castle of Secrets,2025,Puzzle,"₩8,800",19%,27,7,34,14960000,21,9,30,13200000
1168880,MOLEK-SYNTEZ,2019,Puzzle,"₩11,000",0%,570,72,642,353100000,449,44,493,271150000
2485180,Cats Hidden in Georgia,2024,Puzzle,"₩1,100",0%,698,54,752,41360000,706,53,759,41745000
2313250,Cats Hidden in Paris,2023,Puzzle,Free,0%,0,0,0,0,0,0,0,0
1889890,Shinehill,2024,Puzzle,"₩10,500",0%,98,3,101,53025000,105,4,109,57225000
1448000,迷离诡夜 blurred weird night,2023,Puzzle,"₩6,530",40%,243,50,293,95664500,224,52,276,90114000
2221390,Damned 2,2025,Puzzle,"₩13,170",15%,0,0,0,0,35,10,45,29632500
969760,Omno,2021,Puzzle,"₩20,500",0%,2288,185,2473,2534825000,1514,150,1664,1705600000
2753620,Fruit Mountain,2024,Puzzle,"₩9,900",0%,424,5,429,212355000,407,8,415,205425000
1679210,The Spirit and the Mouse,2022,Puzzle,"₩8,600",60%,744,20,764,328520000,563,17,580,249400000
3816700,Logic Bombs,2025,Puzzle,"₩5,600",0%,0,0,0,0,303,19,322,90160000
1293160,The Medium,2021,Puzzle,"₩54,800",0%,7765,974,8739,23944860000,0,0,0,0
3229100,Teenage Mutant Ninja Turtles: Tactical Takedown,2025,Puzzle,"₩17,200",19%,84,6,90,77400000,104,10,114,98040000
1038280,Nobodies: Murder Cleaner,2019,Puzzle,"₩7,800",0%,373,32,405,157950000,311,27,338,131820000
296490,GemCraft - Chasing Shadows,2015,Puzzle,"₩2,200",80%,3939,197,4136,454960000,0,0,0,0
839870,Wilmot's Warehouse,2019,Puzzle,"₩16,500",0%,476,15,491,405075000,450,19,469,386925000
3168310,True Fear: Forsaken Souls Part 3,2025,Puzzle,"₩12,000",0%,301,21,322,193200000,393,30,423,253800000
966680,Red Matter,2018,Puzzle,"₩26,000",0%,1001,107,1108,1440400000,848,94,942,1224600000
935880,Glass Masquerade 2: Illusions,2019,Puzzle,"₩5,600",0%,2737,240,2977,833560000,0,0,0,0
3504170,Emberfly,2025,Puzzle,"₩4,500",0%,27,3,30,6750000,29,3,32,7200000
1311540,"The Wake: Mourning Father, Mourning Mother",2020,Puzzle,"₩5,600",0%,205,45,250,70000000,184,46,230,64400000
611760,Don't Escape: 4 Days to Survive,2019,Puzzle,"₩16,500",0%,2227,45,2272,1874400000,1771,18,1789,1475925000
1137350,Filament,2020,Puzzle,"₩18,500",0%,615,99,714,660450000,516,84,600,555000000
937170,Otaku's Adventure,2019,Puzzle,"₩7,500",0%,7981,440,8421,3157875000,0,0,0,0
1289310,Helltaker,2020,Puzzle,Free,0%,122115,2803,124918,0,0,0,0,0
1816950,Nobodies: After Death,2023,Puzzle,"₩7,800",0%,91,2,93,36270000,85,3,88,34320000
750290,Slice of Sea,2021,Puzzle,"₩26,000",0%,478,41,519,674700000,395,39,434,564200000
544390,NITE Team 4 - Military Hacking Division,2019,Puzzle,"₩21,500",0%,1117,98,1215,1306125000,888,99,987,1061025000
2072840,Word Factori,2023,Puzzle,"₩6,700",0%,326,60,386,129310000,341,60,401,134335000
295790,Never Alone (Kisima Ingitchuna),2014,Puzzle,"₩16,000",0%,6833,1626,8459,6767200000,0,0,0,0
233470,Evoland,2013,Puzzle,"₩2,620",75%,4847,1020,5867,768577000,0,0,0,0
497780,Recursed,2016,Puzzle,"₩8,900",0%,568,12,580,258100000,539,17,556,247420000
1080020,Electrician Simulator,2022,Puzzle,"₩19,500",0%,2322,587,2909,2836275000,0,0,0,0
581270,Old Man's Journey,2017,Puzzle,"₩11,000",0%,3453,517,3970,2183500000,0,0,0,0
1051310,Paper Dolls: Original / 纸人,2019,Puzzle,"₩6,120",0%,3881,638,4519,1382814000,3566,581,4147,1268982000
1850550,I'm on Observation Duty 5,2022,Puzzle,"₩11,000",0%,704,26,730,401500000,672,28,700,385000000
1599880,Cats in Time,2021,Puzzle,"₩4,320",19%,1223,49,1272,274752000,916,28,944,203904000
224480,Octodad: Dadliest Catch,2014,Puzzle,"₩15,400",0%,9539,616,10155,7819350000,0,0,0,0
2020090,The Space-Eating Croc,2023,Puzzle,"₩7,500",0%,117,4,121,45375000,84,4,88,33000000
404680,Hob,2017,Puzzle,"₩21,000",0%,4632,611,5243,5505150000,0,0,0,0
979400,Last Labyrinth,2019,Puzzle,"₩41,200",0%,93,27,120,247200000,81,29,110,226600000
2492390,Logiart Grimoire,2024,Puzzle,"₩21,500",0%,298,11,309,332175000,274,14,288,309600000
3522230,Death Stream,2025,Puzzle,"₩3,400",0%,20,1,21,3570000,21,1,22,3740000
2492390,Logiart Grimoire,2024,Puzzle,"₩21,500",0%,298,11,309,332175000,274,14,288,309600000
1671410,Somerville,2022,Puzzle,"₩21,500",0%,1034,443,1477,1587775000,1038,445,1483,1594225000
609490,Minit,2018,Puzzle,"₩11,000",0%,2339,278,2617,1439350000,1501,148,1649,906950000
508900,Zup! X,2018,Puzzle,"₩2,300",0%,5809,182,5991,688965000,0,0,0,0
345540,Inbetween Land,2015,Puzzle,"₩1,990",70%,217,49,266,26467000,149,31,180,17910000
416680,Zombie Night Terror,2016,Puzzle,"₩14,500",0%,3426,254,3680,2668000000,0,0,0,0
220860,McPixel,2012,Puzzle,"₩5,000",0%,3295,621,3916,979000000,0,0,0,0
559210,Rakuen,2017,Puzzle,"₩16,500",0%,5629,219,5848,4824600000,0,0,0,0
684410,Bridge Constructor Portal,2017,Puzzle,"₩11,000",0%,6123,555,6678,3672900000,0,0,0,0
251430,The Inner World,2013,Puzzle,"₩1,650",90%,1246,148,1394,115005000,741,101,842,69465000
2014470,The Abandoned Planet,2024,Puzzle,"₩16,500",0%,88,4,92,75900000,102,10,112,92400000
1600370,Not Tonight 2,2022,Puzzle,"₩20,500",0%,305,69,374,383350000,309,72,381,390525000
1558510,MECHANICA: A Ballad of the Rabbit and Mercury,2021,Puzzle,"₩20,500",0%,799,38,837,857925000,728,38,766,785150000
231160,The Swapper,2013,Puzzle,"₩16,000",0%,6929,440,7369,5895200000,0,0,0,0
2523310,Lingo 2,2025,Puzzle,"₩11,000",0%,286,12,298,163900000,308,16,324,178200000
1108000,Children of Silentown,2023,Puzzle,"₩26,000",0%,1140,169,1309,1701700000,762,114,876,1138800000
3471060,Sweet Delights: The Girl’s Cafe Quest,2025,Puzzle,"₩2,300",0%,0,0,0,0,19,2,21,2415000
552590,The Sexy Brutale,2017,Puzzle,"₩21,000",0%,3546,294,3840,4032000000,0,0,0,0
2322180,A Tiny Sticker Tale,2023,Puzzle,"₩11,000",0%,397,8,405,222750000,325,10,335,184250000
1070790,Freshly Frosted,2022,Puzzle,"₩10,500",0%,332,5,337,176925000,301,6,307,161175000
1085220,Figment 2: Creed Valley,2023,Puzzle,"₩27,000",0%,1100,73,1173,1583550000,742,47,789,1065150000
780210,Freeways,2018,Puzzle,"₩5,600",0%,1658,216,1874,524720000,1689,209,1898,531440000
471810,Death Squared,2017,Puzzle,"₩16,500",0%,587,71,658,542850000,398,44,442,364650000
680980,HEADLINER,2017,Puzzle,"₩5,600",0%,683,197,880,246400000,635,201,836,234080000
2320500,Chloé’s Requiem -encore-,2023,Puzzle,"₩10,000",0%,119,12,131,65500000,109,13,122,61000000
1040550,Spring Falls,2019,Puzzle,"₩7,500",0%,915,28,943,353625000,891,37,928,348000000
2848800,Pup Champs,2025,Puzzle,"₩14,500",0%,43,0,43,31175000,70,2,72,52200000
1724140,Craftomation 101: Programming & Craft,2024,Puzzle,"₩11,000",0%,442,73,515,283250000,436,83,519,285450000
3181470,Cat & Farm Pals,2025,Puzzle,"₩1,100",0%,0,0,0,0,177,13,190,10450000
3249900,Bloxpath,2025,Puzzle,"₩6,700",0%,0,0,0,0,15,1,16,5360000
3645700,What Happened to Lily?,2025,Puzzle,"₩4,500",0%,0,0,0,0,50,21,71,15975000
1218900,Zup! Z,2020,Puzzle,"₩2,300",0%,3557,99,3656,420440000,0,0,0,0
890720,In Other Waters,2020,Puzzle,"₩16,500",0%,1973,294,2267,1870275000,1659,226,1885,1555125000
1093910,Tales of the Black Forest,2019,Puzzle,"₩4,500",0%,13633,314,13947,3138075000,0,0,0,0
2085360,Insomnia: Theater in the Head,2022,Puzzle,"₩2,830",0%,2483,64,2547,360400500,0,0,0,0
265890,Hexcells,2014,Puzzle,"₩3,400",0%,5546,175,5721,972570000,0,0,0,0
1837220,Psalm 5:9-13,2024,Puzzle,"₩4,500",0%,1282,228,1510,339750000,1207,230,1437,323325000
568320,Pictopix,2017,Puzzle,"₩7,500",0%,1325,43,1368,513000000,1243,52,1295,485625000
2431070,98xx,2023,Puzzle,"₩3,400",0%,251,63,314,53380000,252,71,323,54910000
930280,Murder Mystery Machine,2021,Puzzle,"₩2,050",90%,87,72,159,16297500,61,56,117,11992500
357300,Snakebird,2015,Puzzle,"₩7,500",0%,1099,73,1172,439500000,811,43,854,320250000
733070,Sudoku Universe / 数独宇宙,2017,Puzzle,"₩3,400",0%,2777,142,2919,496230000,0,0,0,0
746710,Cypher,2018,Puzzle,"₩5,600",0%,777,77,854,239120000,743,83,826,231280000
1924360,Lil' Guardsman,2024,Puzzle,"₩21,500",0%,922,49,971,1043825000,870,55,925,994375000
2147950,4D Golf,2024,Puzzle,"₩21,500",0%,669,12,681,732075000,668,14,682,733150000
284390,The Last Door - Collector's Edition,2014,Puzzle,"₩10,500",0%,2205,128,2333,1224825000,1675,88,1763,925575000
1147890,Bonfire Peaks,2021,Puzzle,"₩21,500",0%,272,12,284,305300000,228,9,237,254775000
2700540,Cats Hidden in Japan,2025,Puzzle,"₩1,100",0%,183,1,184,10120000,319,7,326,17930000
2700540,Cats Hidden in Japan,2025,Puzzle,"₩1,100",0%,183,1,184,10120000,319,7,326,17930000
429720,IMSCARED,2016,Puzzle,"₩4,400",0%,3015,191,3206,705320000,0,0,0,0
1158720,Causality,2021,Puzzle,"₩7,500",0%,219,17,236,88500000,208,18,226,84750000
960420,Hello Neighbor: Hide and Seek,2019,Puzzle,"₩32,000",0%,841,156,997,1595200000,737,101,838,1340800000
1212620,Pretty Neko,2020,Puzzle,"₩1,100",0%,2842,215,3057,168135000,0,0,0,0
1407420,Milo and the Magpies,2021,Puzzle,"₩3,400",0%,3086,46,3132,532440000,0,0,0,0
214340,Deponia,2012,Puzzle,"₩10,500",0%,10509,1566,12075,6339375000,0,0,0,0
221810,The Cave,2013,Puzzle,"₩16,000",0%,2456,353,2809,2247200000,0,0,0,0
1730260,Retro Gadgets,2022,Puzzle,"₩21,500",0%,425,32,457,491275000,374,37,411,441825000
393190,TSIOQUE,2018,Puzzle,"₩14,500",0%,1718,92,1810,1312250000,759,40,799,579275000
1101360,Rock of Ages 3: Make & Break,2020,Puzzle,"₩31,000",0%,1075,361,1436,2225800000,813,243,1056,1636800000
709920,Tametsi,2017,Puzzle,"₩3,400",0%,1230,38,1268,215560000,1216,51,1267,215390000
367580,Hook,2015,Puzzle,"₩2,300",0%,8617,270,8887,1022005000,0,0,0,0
251730,Legend of Grimrock 2,2014,Puzzle,"₩25,920",0%,3458,348,3806,4932576000,0,0,0,0
2090580,Matcha,2022,Puzzle,"₩3,300",0%,32,2,34,5610000,32,2,34,5610000
383270,Hue,2016,Puzzle,"₩16,000",0%,9736,788,10524,8419200000,1401,105,1506,1204800000
2685900,Mind Over Magnet,2024,Puzzle,"₩11,000",0%,1012,123,1135,624250000,1037,128,1165,640750000
1930640,Lost2,2022,Puzzle,"₩30,000",0%,1151,251,1402,2103000000,1103,242,1345,2017500000
735290,Genesis Noir,2021,Puzzle,"₩16,500",0%,1562,426,1988,1640100000,1201,319,1520,1254000000
984800,Automachef,2019,Puzzle,"₩15,500",0%,622,241,863,668825000,381,120,501,388275000
1725440,House of Rules,2021,Puzzle,"₩8,500",0%,136,13,149,63325000,137,15,152,64600000
1701330,Sokobond Express,2024,Puzzle,"₩16,500",0%,68,6,74,61050000,61,7,68,56100000
3637730,FIND ALL 8: The road to the Maya,2025,Puzzle,"₩2,300",0%,0,0,0,0,59,1,60,6900000
542050,Forgotton Anne,2018,Puzzle,"₩19,500",0%,1687,189,1876,1829100000,1352,150,1502,1464450000
510420,The Hex,2018,Puzzle,"₩10,500",0%,4671,286,4957,2602425000,0,0,0,0
1890520,Tide Up,2022,Puzzle,"₩8,900",0%,224,21,245,109025000,213,19,232,103240000
2913040,Back,2024,Puzzle,"₩7,800",0%,272,71,343,133770000,231,69,300,117000000
1098340,Zup! 9,2019,Puzzle,"₩2,300",0%,1704,76,1780,204700000,1646,87,1733,199295000
1304610,Lab Rat,2025,Puzzle,"₩21,500",0%,220,7,227,244025000,248,8,256,275200000
434730,Half Dead,2016,Puzzle,"₩2,200",0%,2582,718,3300,363000000,0,0,0,0
1148510,Pretty Angel,2019,Puzzle,"₩1,100",0%,3256,296,3552,195360000,0,0,0,0
1923790,Linelith,2022,Puzzle,"₩3,400",0%,834,12,846,143820000,854,17,871,148070000
2812450,Tiny Garden,2025,Puzzle,"₩14,500",0%,110,10,120,87000000,74,10,84,60900000
799070,Zup! 8,2018,Puzzle,"₩2,300",0%,3605,138,3743,430445000,0,0,0,0
3876680,101 Dogs Hidden,2025,Puzzle,"₩1,100",0%,0,0,0,0,13,2,15,825000
720250,Welcome to the Game II,2018,Puzzle,"₩11,000",0%,2698,481,3179,1748450000,0,0,0,0
2741360,Valiant Hearts: Coming Home,2024,Puzzle,"₩16,900",0%,192,137,329,278005000,217,145,362,305890000
470780,She Remembered Caterpillars,2017,Puzzle,"₩12,500",0%,497,27,524,327500000,158,7,165,103125000
1357870,Metel - Horror Escape,2020,Puzzle,"₩3,400",0%,2023,130,2153,366010000,1935,124,2059,350030000
2510890,Pricolage -IDOLIZED-,2024,Puzzle,"₩8,500",0%,190,66,256,108800000,183,68,251,106675000
2206560,Zup! Q,2023,Puzzle,"₩2,300",0%,0,0,0,0,648,20,668,76820000
562220,Zup! 2,2016,Puzzle,"₩2,300",0%,5994,278,6272,721280000,0,0,0,0
2635930,Snowman Story,2023,Puzzle,"₩6,000",0%,99,2,101,30300000,85,4,89,26700000
3395930,Mashina,2025,Puzzle,"₩19,500",0%,0,0,0,0,67,2,69,67275000
281080,Reversion - The Return (Last Chapter),2020,Puzzle,"₩1,100",90%,77,13,90,4950000,66,12,78,4290000
250050,Life Goes On: Done to Death,2014,Puzzle,"₩14,500",0%,2312,97,2409,1746525000,0,0,0,0
1812060,Yokai Art: Night Parade of One Hundred Demons,2022,Puzzle,"₩7,800",0%,963,101,1064,414960000,935,104,1039,405210000
1833490,GOODBYE WORLD,2022,Puzzle,"₩12,500",0%,676,119,795,496875000,615,117,732,457500000
891360,Hellcoming,2021,Puzzle,"₩5,500",0%,644,171,815,224125000,498,132,630,173250000
748970,Zen Chess: Mate in One,2018,Puzzle,₩770,30%,358,51,409,15746500,315,39,354,13629000
271900,Hexcells Plus,2014,Puzzle,"₩3,400",0%,2540,143,2683,456110000,0,0,0,0
1833490,GOODBYE WORLD,2022,Puzzle,"₩12,500",0%,676,119,795,496875000,615,117,732,457500000
385250,Paint it Back,2015,Puzzle,"₩8,500",0%,531,11,542,230350000,488,15,503,213775000
855640,My Brother Rabbit,2018,Puzzle,"₩3,100",80%,1848,69,1917,297135000,1505,63,1568,243040000
2430900,Among Ashes,2024,Puzzle,"₩16,500",0%,289,16,305,251625000,268,14,282,232650000
891360,Hellcoming,2021,Puzzle,"₩5,500",0%,644,171,815,224125000,498,132,630,173250000
493540,Figment,2017,Puzzle,"₩20,000",0%,4610,674,5284,5284000000,1098,150,1248,1248000000
3540460,Watermelon (with a Broken Head) Game,2025,Puzzle,"₩2,550",25%,9,0,9,1147500,14,1,15,1912500
403180,Draw a Stickman: EPIC 2,2015,Puzzle,"₩7,500",0%,858,123,981,367875000,796,119,915,343125000
3356790,Cozy Solitaire,2024,Puzzle,"₩4,500",0%,46,3,49,11025000,50,8,58,13050000
1693260,Yugo Puzzle,2021,Puzzle,"₩5,360",19%,273,3,276,73968000,268,5,273,73164000
1065070,Été,2024,Puzzle,"₩27,000",0%,157,9,166,224100000,144,13,157,211950000
1689080,Mercury Abbey,2024,Puzzle,"₩19,500",0%,717,61,778,758550000,601,45,646,629850000
944080,Pode,2020,Puzzle,"₩20,500",0%,400,36,436,446900000,359,35,394,403850000
2546310,Sandtrix+,2023,Puzzle,"₩8,900",0%,126,9,135,60075000,115,9,124,55180000
530890,Haydee,2016,Puzzle,"₩15,500",0%,5506,987,6493,5032075000,0,0,0,0
1463920,hexceed,2021,Puzzle,Free,0%,2305,257,2562,0,0,0,0,0
395860,The Last Dream: Developer's Edition,2015,Puzzle,"₩2,850",70%,306,75,381,54292500,200,56,256,36480000
2964540,Nurikabe World,2025,Puzzle,"₩11,000",0%,76,0,76,41800000,91,0,91,50050000
230700,La-Mulana,2013,Puzzle,"₩16,000",0%,1971,504,2475,1980000000,1536,408,1944,1555200000
2458430,Leila,2025,Puzzle,"₩8,770",35%,259,27,286,125411000,290,36,326,142951000
2777220,Human Fall Flat VR,2024,Puzzle,"₩15,500",0%,59,58,117,90675000,54,58,112,86800000
3553320,Them,2025,Puzzle,"₩7,800",0%,0,0,0,0,43,5,48,18720000
2559860,Three Goblin Wobblin',2024,Puzzle,"₩8,900",0%,31,2,33,14685000,20,2,22,9790000
2469570,Oberty,2024,Puzzle,"₩1,020",70%,36,1,37,1887000,44,1,45,2295000
220740,Chaos on Deponia,2012,Puzzle,"₩21,000",0%,2527,267,2794,2933700000,0,0,0,0
558780,Sonya: The Great Adventure,2017,Puzzle,"₩1,990",70%,144,55,199,19800500,121,45,166,16517000
1383050,Chess Knights: Shinobi,2020,Puzzle,"₩2,380",30%,57,12,69,8211000,56,11,67,7973000
2808270,Buckshot With Friends,2024,Puzzle,"₩4,500",0%,44,46,90,20250000,40,38,78,17550000
1289990,Alan's Automaton Workshop,2022,Puzzle,"₩15,500",0%,167,36,203,157325000,151,36,187,144925000
1073320,Meteorfall: Krumit's Tale,2020,Puzzle,"₩15,500",0%,763,80,843,653325000,657,73,730,565750000
2356450,A Street Cat's Tale 2: Outside is Dangerous,2023,Puzzle,"₩14,900",0%,72,3,75,55875000,23,3,26,19370000
284850,Grim Legends: The Forsaken Bride,2014,Puzzle,"₩16,500",0%,1558,71,1629,1343925000,955,50,1005,829125000
926340,Roman's Christmas / 罗曼圣诞探案集,2020,Puzzle,"₩11,500",0%,1415,56,1471,845825000,1314,55,1369,787175000
3416270,Cross The Boundaries,2025,Puzzle,"₩5,600",0%,44,0,44,12320000,45,0,45,12600000
601220,Zup! F,2019,Puzzle,"₩2,300",0%,7476,211,7687,884005000,0,0,0,0
1151740,Prison Princess,2020,Puzzle,"₩20,500",0%,282,53,335,343375000,270,55,325,333125000
588970,Oik,2017,Puzzle,"₩1,100",0%,1515,172,1687,92785000,1420,176,1596,87780000
3338380,The Cursed Moon ~The Girl Trapped in the Haunted House~,2025,Puzzle,"₩18,500",0%,61,3,64,59200000,32,5,37,34225000
3539440,Metal Garden,2025,Puzzle,"₩6,700",0%,519,9,528,176880000,862,27,889,297815000
454190,Cubicolor,2016,Puzzle,"₩5,600",0%,189,14,203,56840000,169,13,182,50960000
1141290,Tactical Nexus,2019,Puzzle,Free,0%,186,6,192,0,188,8,196,0
540840,Lara Croft GO,2016,Puzzle,"₩10,990",0%,3480,275,3755,2063372500,0,0,0,0
2421410,Cyber Manhunt 2: New World - The Hacking Simulator,2025,Puzzle,"₩14,500",0%,3903,306,4209,3051525000,0,0,0,0
391720,Layers of Fear (2016),2016,Puzzle,"₩21,000",0%,23576,3040,26616,27946800000,0,0,0,0
1234430,Ad Infinitum,2023,Puzzle,"₩37,500",0%,750,184,934,1751250000,429,114,543,1018125000
306760,Obduction,2016,Puzzle,"₩32,000",0%,3076,781,3857,6171200000,0,0,0,0
1117090,Purple Place - Classic Games,2023,Puzzle,"₩2,300",0%,1726,251,1977,227355000,1609,262,1871,215165000
218640,Lucius,2012,Puzzle,"₩10,500",0%,8528,1987,10515,5520375000,0,0,0,0
485380,Welcome to the Game,2016,Puzzle,"₩5,600",0%,2083,372,2455,687400000,0,0,0,0
1321230,Angels of Death Episode.Eddie,2020,Puzzle,"₩7,500",0%,387,46,433,162375000,366,50,416,156000000
794940,Hexa Turn,2018,Puzzle,₩990,70%,99,11,110,5445000,83,10,93,4603500
1299400,Understand,2020,Puzzle,"₩4,500",0%,671,67,738,166050000,655,73,728,163800000
1153430,Love wish,2020,Puzzle,₩580,47%,1460,356,1816,52664000,1379,345,1724,49996000
1706090,Bean and Nothingness,2021,Puzzle,"₩12,500",0%,176,2,178,111250000,171,3,174,108750000
1298140,Fobia - St. Dinfna Hotel,2022,Puzzle,"₩29,240",0%,1686,296,1982,2897684000,1114,197,1311,1916682000
2725090,HER TREES : THE PUZZLE HOUSE,2024,Puzzle,"₩2,300",0%,0,0,0,0,194,8,202,23230000
2520000,HYNPYTOL,2023,Puzzle,"₩15,000",0%,77,1,78,58500000,56,1,57,42750000
1181840,HIVESWAP: ACT 2,2020,Puzzle,"₩15,500",0%,933,138,1071,830025000,824,123,947,733925000
604330,The Crown of Leaves,2018,Puzzle,"₩5,500",0%,2003,89,2092,575300000,1794,75,1869,513975000
1025410,Metamorphosis,2020,Puzzle,"₩9,750",0%,505,86,591,288112500,359,74,433,211087500
3558720,Out of Sight VR,2025,Puzzle,"₩27,000",0%,32,0,32,43200000,29,1,30,40500000
1254130,Phobies,2022,Puzzle,Free,0%,0,0,0,0,1060,172,1232,0
314660,Oddworld: New 'n' Tasty,2015,Puzzle,"₩20,500",0%,2996,495,3491,3578275000,0,0,0,0
1672310,Decarnation,2023,Puzzle,"₩16,500",0%,754,97,851,702075000,669,100,769,634425000
2994680,Nobodies: Silent Blood,2024,Puzzle,"₩7,800",0%,25,2,27,10530000,27,2,29,11310000
2884480,Dot Piece Puzzle - Dotpicture,2024,Puzzle,"₩2,010",25%,22,0,22,2211000,20,0,20,2010000
368390,The Darkside Detective,2017,Puzzle,"₩16,500",0%,4464,260,4724,3897300000,0,0,0,0
2304240,Moving Through Life,2023,Puzzle,"₩2,800",50%,41,18,59,8260000,41,18,59,8260000
1347970,Patch Quest,2023,Puzzle,"₩17,000",0%,2479,168,2647,2249950000,1870,119,1989,1690650000
1073810,Shapik: The Moon Quest,2020,Puzzle,"₩2,550",70%,230,15,245,31237500,229,17,246,31365000
303610,Suicide Guy,2017,Puzzle,"₩6,700",0%,2391,322,2713,908855000,0,0,0,0
1370170,Diorama Builder,2024,Puzzle,"₩5,600",0%,424,25,449,125720000,328,17,345,96600000
2456350,The Scourge | Tai Ương,2024,Puzzle,"₩11,000",0%,541,38,579,318450000,512,45,557,306350000
1215270,Down the Rabbit Hole,2020,Puzzle,"₩20,500",0%,417,25,442,453050000,290,22,312,319800000
209790,Splice,2012,Puzzle,"₩10,500",0%,514,72,586,307650000,152,25,177,92925000
3316620,Prove You Can Win,2025,Puzzle,"₩5,600",0%,34,5,39,10920000,38,7,45,12600000
3080380,Violent Horror Stories: anthology,2024,Puzzle,"₩3,400",0%,448,70,518,88060000,439,71,510,86700000
3444050,FIND ALL 6: Netherlands,2025,Puzzle,"₩2,300",0%,101,2,103,11845000,134,4,138,15870000
2838400,Squiggle Drop,2024,Puzzle,"₩5,600",0%,29,1,30,8400000,30,1,31,8680000
754120,Ninja Stealth 3,2017,Puzzle,"₩5,500",0%,402,100,502,138050000,376,94,470,129250000
3409430,Shrink Rooms,2025,Puzzle,"₩16,500",0%,35,2,37,30525000,25,2,27,22275000
284770,Enigmatis 2: The Mists of Ravenwood,2014,Puzzle,"₩4,120",75%,1510,41,1551,319506000,1019,32,1051,216506000
2160470,Zup! Y,2024,Puzzle,"₩2,300",0%,0,0,0,0,169,13,182,20930000
297130,Titan Souls,2015,Puzzle,"₩16,500",0%,10347,2766,13113,10818225000,0,0,0,0
250620,Among the Sleep - Enhanced Edition,2014,Puzzle,"₩17,500",0%,6728,877,7605,6654375000,0,0,0,0
533300,Zup!,2016,Puzzle,"₩2,300",0%,7755,464,8219,945185000,0,0,0,0
2833960,Asian Foxes,2024,Puzzle,₩660,40%,26,3,29,957000,21,4,25,825000
2636340,SEEING THINGS,2024,Puzzle,"₩9,900",0%,62,3,65,32175000,55,2,57,28215000
1224020,Creepy Tale,2020,Puzzle,"₩5,600",0%,2310,361,2671,747880000,0,0,0,0
499440,klocki,2016,Puzzle,"₩2,300",0%,4495,150,4645,534175000,0,0,0,0
2995650,Dungeons of Dreadrock 2 - The Dead King's Secret,2024,Puzzle,"₩16,500",0%,62,2,64,52800000,67,2,69,56925000
303210,The Beginner's Guide,2015,Puzzle,"₩11,000",0%,19369,2633,22002,12101100000,0,0,0,0
214790,The Basement Collection,2012,Puzzle,"₩4,500",0%,1295,206,1501,337725000,1049,130,1179,265275000
353560,Plug & Play,2015,Puzzle,"₩4,500",0%,4140,758,4898,1102050000,0,0,0,0
465100,LUNA The Shadow Dust,2020,Puzzle,"₩13,700",27%,1452,148,1600,1096000000,1147,142,1289,882965000
1928670,Hajis هاجس,2022,Puzzle,"₩7,680",0%,84,17,101,38784000,66,17,83,31872000
1015720,Alternate DiMansion Diary,2019,Puzzle,"₩10,500",0%,430,68,498,261450000,394,69,463,243075000
1276070,Manufactoria 2022,2022,Puzzle,"₩21,500",0%,64,3,67,72025000,62,3,65,69875000
1694960,Furry Feet,2021,Puzzle,"₩1,950",15%,1402,328,1730,168675000,605,99,704,68640000
303210,The Beginner's Guide,2015,Puzzle,"₩11,000",0%,19369,2633,22002,12101100000,0,0,0,0
2088670,Puzzline,2022,Puzzle,"₩4,400",0%,124,1,125,27500000,131,0,131,28820000
1725640,Sudocats,2022,Puzzle,"₩2,200",0%,1469,17,1486,163460000,1416,29,1445,158950000
1708770,30 Birds,2024,Puzzle,"₩19,500",0%,92,3,95,92625000,89,4,93,90675000
951750,I Am Dead,2020,Puzzle,"₩24,000",0%,339,70,409,490800000,302,76,378,453600000
495110,Enigmatis 3: The Shadow of Karkhala,2016,Puzzle,"₩4,120",75%,906,65,971,200026000,701,53,754,155324000
2455920,Mimic Logic,2024,Puzzle,"₩4,500",0%,440,7,447,100575000,457,9,466,104850000
2834330,Hidden in my Paradise,2024,Puzzle,"₩11,000",0%,64,4,68,37400000,64,6,70,38500000
1372320,Cloud Gardens,2021,Puzzle,"₩18,500",0%,2104,110,2214,2047950000,0,0,0,0
1115780,The Almost Gone,2020,Puzzle,"₩10,500",0%,913,222,1135,595875000,757,189,946,496650000
1507190,Machinika: Museum,2021,Puzzle,"₩8,500",0%,5209,414,5623,2389775000,920,91,1011,429675000
2952990,RewindGirl,2025,Puzzle,"₩8,900",0%,62,4,66,29370000,71,5,76,33820000
3232040,BodyRecords,2025,Puzzle,"₩3,900",50%,187,135,322,62790000,222,115,337,65715000
2882870,Doll Impostor,2024,Puzzle,"₩8,900",0%,854,46,900,400500000,792,51,843,375135000
2661210,WhaleGameOnline,2023,Puzzle,"₩3,400",0%,96,6,102,17340000,89,8,97,16490000
1779030,So to Speak,2025,Puzzle,"₩19,500",0%,64,2,66,64350000,78,3,81,78975000
3894150,VeryVeryHouse,2025,Puzzle,₩900,25%,0,0,0,0,9,2,11,495000
1564090,Landlord of the Woods,2021,Puzzle,"₩1,100",0%,993,30,1023,56265000,984,30,1014,55770000
3893840,blocate,2025,Puzzle,"₩1,100",0%,0,0,0,0,10,0,10,550000
469790,Linelight,2017,Puzzle,"₩10,500",0%,1016,35,1051,551775000,867,36,903,474075000
353640,Train Valley,2015,Puzzle,"₩10,500",0%,2964,339,3303,1734075000,0,0,0,0
1817000,Zodiacats,2022,Puzzle,"₩2,200",0%,1088,11,1099,120890000,1055,22,1077,118470000
645090,Zup! 5,2017,Puzzle,"₩2,300",0%,2400,158,2558,294170000,0,0,0,0
272600,Detective Grimoire,2014,Puzzle,"₩7,800",0%,2063,94,2157,841230000,1716,90,1806,704340000
2191190,FIND ALL 4: Magic,2023,Puzzle,"₩2,250",0%,523,6,529,59512500,500,5,505,56812500
1904880,Once Upon A Puppet,2025,Puzzle,"₩27,000",0%,50,1,51,68850000,37,2,39,52650000
1258460,Escape First 3,2020,Puzzle,"₩7,800",0%,132,79,211,82290000,120,71,191,74490000
1471960,Room to Grow,2021,Puzzle,"₩10,500",0%,174,5,179,93975000,167,5,172,90300000
914020,Gibbous -  A Cthulhu Adventure,2019,Puzzle,"₩21,500",0%,1953,224,2177,2340275000,1751,239,1990,2139250000
1479890,Inua - A Story in Ice and Time,2022,Puzzle,"₩3,870",75%,72,5,77,14899500,54,4,58,11223000
2677310,GRIDROAD,2024,Puzzle,"₩11,000",0%,261,45,306,168300000,250,67,317,174350000
705120,Death Coming/死神来了,2017,Puzzle,"₩7,500",0%,2920,324,3244,1216500000,0,0,0,0
566160,Zup! 6,2017,Puzzle,"₩2,300",0%,2024,117,2141,246215000,0,0,0,0
558420,Stories Untold,2017,Puzzle,"₩11,000",0%,4480,662,5142,2828100000,0,0,0,0
1354260,Brave Escape,2025,Puzzle,"₩21,500",0%,68,1,69,74175000,71,1,72,77400000
279800,Grim Legends 2: Song of the Dark Swan,2015,Puzzle,"₩16,500",0%,1244,53,1297,1070025000,763,40,803,662475000
658560,Zup! 7,2017,Puzzle,"₩2,300",0%,1860,86,1946,223790000,0,0,0,0
3066510,Home_0,2024,Puzzle,"₩7,800",0%,47,10,57,22230000,50,10,60,23400000
1146310,Beyond a Steel Sky,2020,Puzzle,"₩36,000",0%,1293,177,1470,2646000000,1034,155,1189,2140200000
1389200,Cramped Room of Death,2023,Puzzle,"₩16,500",0%,59,3,62,51150000,57,3,60,49500000
896520,Stay Out of the House,2022,Puzzle,"₩15,500",0%,1409,79,1488,1153200000,1296,83,1379,1068725000
711660,CHUCHEL,2018,Puzzle,"₩11,500",0%,3375,645,4020,2311500000,0,0,0,0
3891120,101 Dogs Hidden in Dubai,2025,Puzzle,₩660,40%,0,0,0,0,0,0,0,0
2865580,Let's Minesweeper,2024,Puzzle,"₩5,600",0%,507,135,642,179760000,456,129,585,163800000
224460,Contrast,2013,Puzzle,"₩10,500",0%,4984,508,5492,2883300000,0,0,0,0
457680,OPUS: The Day We Found Earth,2016,Puzzle,"₩16,500",0%,1364,200,1564,1290300000,1101,165,1266,1044450000
1147960,[Chilla's Art] Okaeri | おかえり,2019,Puzzle,"₩3,400",0%,468,247,715,121550000,445,240,685,116450000
3806550,101 Cats Hidden in Prague,2025,Puzzle,₩550,50%,0,0,0,0,14,0,14,385000
224460,Contrast,2013,Puzzle,"₩10,500",0%,4984,508,5492,2883300000,0,0,0,0
225080,Brothers - A Tale of Two Sons,2013,Puzzle,"₩16,000",0%,38721,2274,40995,32796000000,0,0,0,0
1124160,VR Giants,2023,Puzzle,"₩21,500",0%,153,25,178,191350000,129,21,150,161250000
1229060,Dungeon and Puzzles,2021,Puzzle,"₩1,700",80%,175,8,183,15555000,180,12,192,16320000
810660,The Office Quest,2018,Puzzle,"₩9,500",0%,748,57,805,382375000,685,52,737,350075000
658550,Zup! Zero 2,2018,Puzzle,"₩2,300",0%,917,50,967,111205000,1088,69,1157,133055000
761460,Lamplight City,2018,Puzzle,"₩8,840",48%,679,82,761,336362000,627,78,705,311610000
2476100,Creepy Tale: Some Other Place,2024,Puzzle,"₩11,000",0%,466,28,494,271700000,418,31,449,246950000
1440440,Sam & Max Save the World,2020,Puzzle,"₩20,500",0%,1595,117,1712,1754800000,1362,103,1465,1501625000
1112830,The Watchers,2020,Puzzle,"₩5,600",0%,365,121,486,136080000,304,96,400,112000000
956010,Hexanome,2018,Puzzle,₩990,70%,25,6,31,1534500,24,6,30,1485000
874400,Dinosaur Hunt Puzzle,2018,Puzzle,"₩1,100",0%,301,104,405,22275000,97,36,133,7315000
449610,Monster Boy and the Cursed Kingdom,2019,Puzzle,"₩32,000",0%,2188,267,2455,3928000000,0,0,0,0
1091250,Total Party Kill,2019,Puzzle,"₩5,600",0%,154,8,162,45360000,142,8,150,42000000
833140,Supaplex,2018,Puzzle,"₩15,500",0%,251,14,265,205375000,242,15,257,199175000
1458090,Hapland Trilogy,2022,Puzzle,"₩6,500",0%,33,3,36,11700000,33,2,35,11375000
261700,Eryi's Action,2013,Puzzle,"₩5,500",0%,1213,168,1381,379775000,779,96,875,240625000
2859200,Alex Hill: Whispers at White Oak Inn,2025,Puzzle,"₩21,500",0%,259,9,268,288100000,280,12,292,313900000
907470,Iris.Fall,2018,Puzzle,"₩15,500",0%,2498,326,2824,2188600000,0,0,0,0
587860,Tales of Escape,2017,Puzzle,Free,0%,1298,836,2134,0,0,0,0,0
610360,Zup! Zero,2017,Puzzle,"₩2,300",0%,2309,158,2467,283705000,0,0,0,0
664180,Draw Puzzle 画之谜,2017,Puzzle,"₩5,500",0%,903,24,927,254925000,760,24,784,215600000
567030,Under Leaves,2017,Puzzle,"₩5,500",0%,717,34,751,206525000,651,34,685,188375000
575640,Zup! 3,2017,Puzzle,"₩2,300",0%,4678,517,5195,597425000,0,0,0,0
773670,Delete,2018,Puzzle,"₩2,300",0%,1517,63,1580,181700000,1422,75,1497,172155000
421050,Deponia Doomsday,2016,Puzzle,"₩21,000",0%,3291,551,3842,4034100000,0,0,0,0
588040,WILL: A Wonderful World / WILL：美好世界,2017,Puzzle,"₩16,000",0%,4996,389,5385,4308000000,0,0,0,0
1182470,reky,2020,Puzzle,"₩6,500",0%,57,11,68,22100000,44,11,55,17875000
1264280,Slipways,2021,Puzzle,"₩17,500",0%,2000,154,2154,1884750000,0,0,0,0
1281270,Fatum Betula,2020,Puzzle,"₩5,600",0%,831,32,863,241640000,806,42,848,237440000
1229580,Disc Room,2020,Puzzle,"₩16,500",0%,915,60,975,804375000,755,57,812,669900000
1172650,INDUSTRIA,2021,Puzzle,"₩21,500",0%,2314,940,3254,3498050000,0,0,0,0
1325890,SILT,2022,Puzzle,"₩15,500",0%,522,157,679,526225000,438,138,576,446400000
2870420,Mech Builder,2024,Puzzle,"₩10,250",0%,337,93,430,220375000,329,104,433,221912500
742250,OPUS: Rocket of Whispers,2018,Puzzle,"₩16,500",0%,1453,121,1574,1298550000,1203,105,1308,1079100000
922550,keyg: the last prison,2018,Puzzle,"₩5,600",0%,114,19,133,37240000,92,15,107,29960000
1726400,The Death | Thần Trùng,2022,Puzzle,"₩6,500",0%,2680,254,2934,953550000,0,0,0,0
1071130,The Procession to Calvary,2020,Puzzle,"₩10,000",0%,1079,27,1106,553000000,994,31,1025,512500000
2333240,Logic Town,2023,Puzzle,"₩11,000",0%,169,14,183,100650000,175,17,192,105600000
336240,Typoman,2016,Puzzle,"₩10,500",0%,711,116,827,434175000,633,112,745,391125000
1374290,Palindrome Syndrome: Escape Room,2020,Puzzle,"₩10,500",0%,424,87,511,268275000,383,84,467,245175000
990900,Neon Noodles,2023,Puzzle,"₩21,500",0%,82,20,102,109650000,62,19,81,87075000
673800,Zup! XS,2019,Puzzle,"₩2,300",0%,960,144,1104,126960000,1116,197,1313,150995000
503400,Four Last Things,2017,Puzzle,"₩10,000",0%,1343,56,1399,699500000,1290,68,1358,679000000
318430,Squishy the Suicidal Pig,2014,Puzzle,"₩6,700",0%,2815,555,3370,1128950000,0,0,0,0
504920,39 Days to Mars,2018,Puzzle,"₩21,500",0%,268,45,313,336475000,186,38,224,240800000
2979220,DEVIL'S WAY,2024,Puzzle,"₩5,600",0%,48,64,112,31360000,69,74,143,40040000
252750,MouseCraft,2014,Puzzle,"₩11,000",0%,278,34,312,171600000,156,28,184,101200000
3199430,EYES ON THE EXAM,2025,Puzzle,"₩5,600",0%,0,0,0,0,38,1,39,10920000
359100,Q.U.B.E. 2,2018,Puzzle,"₩26,000",0%,1396,259,1655,2151500000,797,152,949,1233700000
416770,SquareCells,2015,Puzzle,"₩3,400",0%,1069,111,1180,200600000,1040,115,1155,196350000
2081180,SquishCraft,2022,Puzzle,"₩7,500",0%,117,5,122,45750000,115,6,121,45375000
1036950,Super Jigsaw Puzzle: Generations,2019,Puzzle,Free,0%,976,52,1028,0,985,63,1048,0
209950,Triple Town,2012,Puzzle,"₩11,000",0%,738,63,801,440550000,528,46,574,315700000
757480,Broken Reality,2018,Puzzle,"₩15,500",0%,1871,145,2016,1562400000,1767,154,1921,1488775000
1444350,House,2020,Puzzle,"₩10,500",0%,1871,71,1942,1019550000,1740,72,1812,951300000
284710,Abyss: The Wraiths of Eden,2014,Puzzle,"₩16,500",0%,1336,144,1480,1221000000,701,87,788,650100000
2789770,Epigraph,2024,Puzzle,"₩3,400",0%,132,11,143,24310000,154,13,167,28390000
3155430,FIND ALL 5: Vikings,2024,Puzzle,"₩1,700",26%,252,10,262,22270000,255,13,268,22780000
721390,Pipe Push Paradise,2018,Puzzle,"₩10,500",0%,172,8,180,94500000,132,4,136,71400000
861270,Sudoku Killer / 杀手数独,2018,Puzzle,"₩3,400",0%,192,23,215,36550000,190,24,214,36380000
38700,Toki Tori,2010,Puzzle,"₩5,600",0%,1855,256,2111,591080000,1418,193,1611,451080000
994140,Lightmatter,2020,Puzzle,"₩21,500",0%,2505,235,2740,2945500000,557,42,599,643925000
227580,"10,000,000",2013,Puzzle,"₩5,500",0%,2076,227,2303,633325000,1587,176,1763,484825000
3073040,Seoul Station,2024,Puzzle,"₩4,500",0%,32,15,47,10575000,0,0,0,0
858040,Sudoku Jigsaw / 拼图数独,2018,Puzzle,"₩3,400",0%,210,15,225,38250000,202,13,215,36550000
209190,Stealth Bastard Deluxe,2012,Puzzle,"₩10,500",0%,1042,134,1176,617400000,608,83,691,362775000
1181400,Path of Giants,2020,Puzzle,"₩9,500",0%,916,27,943,447925000,367,11,378,179550000
666610,Endless ATC,2017,Puzzle,"₩8,900",0%,434,14,448,199360000,430,13,443,197135000
2821850,Baisu,2024,Puzzle,"₩11,000",0%,217,35,252,138600000,126,36,162,89100000
635320,Last Day of June,2017,Puzzle,"₩21,000",0%,3861,590,4451,4673550000,0,0,0,0
270630,Haunt the House: Terrortown,2014,Puzzle,"₩5,600",0%,1856,274,2130,596400000,1709,255,1964,549920000
465170,Crime Secrets: Crimson Lily,2016,Puzzle,"₩3,300",80%,359,128,487,80355000,192,68,260,42900000
1969440,Sunday Gold,2022,Puzzle,"₩24,800",0%,567,146,713,884120000,483,144,627,777480000
1642220,FIND ALL,2021,Puzzle,"₩1,300",0%,574,34,608,39520000,557,36,593,38545000
253110,The Cat Lady,2013,Puzzle,"₩9,900",0%,5346,357,5703,2822985000,0,0,0,0
290260,Sokobond,2014,Puzzle,"₩16,500",0%,609,40,649,535425000,475,30,505,416625000
335240,Transformice,2015,Puzzle,Free,0%,24320,3341,27661,0,0,0,0,0
3507100,HIDDEN CATS 3: Steampunk,2025,Puzzle,"₩1,100",0%,43,4,47,2585000,63,6,69,3795000
1718130,SCP: Secret Files,2022,Puzzle,"₩15,500",0%,4268,553,4821,3736275000,0,0,0,0
264060,Full Bore,2014,Puzzle,"₩16,000",0%,202,35,237,189600000,66,9,75,60000000
3034130,Love is...,2024,Puzzle,"₩13,000",0%,205,10,215,139750000,189,10,199,129350000
383630,SEEP Universe,2015,Puzzle,₩680,80%,68,23,91,3094000,42,10,52,1768000
1257810,I'm on Observation Duty 2,2020,Puzzle,"₩3,400",0%,424,39,463,78710000,405,35,440,74800000
629220,Rise of Insanity,2018,Puzzle,"₩10,500",0%,959,253,1212,636300000,734,184,918,481950000
852110,RetroMaze,2018,Puzzle,"₩1,250",0%,1407,53,1460,91250000,1321,55,1376,86000000
747910,Disassembly 3D,2017,Puzzle,"₩31,000",0%,257,59,316,489800000,242,53,295,457250000
1458920,Meridian 157: Chapter 1,2020,Puzzle,"₩4,500",0%,244,15,259,58275000,250,16,266,59850000
393520,Iconoclasts,2018,Puzzle,"₩21,500",0%,4098,632,4730,5084750000,0,0,0,0
1747510,An Architect's Adventure,2023,Puzzle,"₩11,000",0%,54,0,54,29700000,53,0,53,29150000
874440,Border Bots VR,2024,Puzzle,"₩22,500",0%,49,9,58,65250000,49,12,61,68625000
38740,EDGE,2011,Puzzle,"₩7,800",0%,2015,179,2194,855660000,1639,142,1781,694590000
2337140,Can't Live Without Electricity,2023,Puzzle,"₩5,600",0%,214,10,224,62720000,205,13,218,61040000
1528220,Gordian Rooms 2: A curious island,2024,Puzzle,"₩27,000",0%,87,30,117,157950000,92,30,122,164700000
348360,Doodle God,2015,Puzzle,"₩13,000",0%,1034,343,1377,895050000,694,207,901,585650000
1130620,[Chilla's Art] Aka Manto | 赤マント,2019,Puzzle,"₩5,600",0%,940,130,1070,299600000,840,125,965,270200000
792120,FIGHT KNIGHT,2021,Puzzle,"₩21,500",0%,1362,110,1472,1582400000,1240,123,1363,1465225000
339200,Oceanhorn: Monster of Uncharted Seas,2015,Puzzle,"₩16,000",0%,1649,421,2070,1656000000,1037,243,1280,1024000000
241240,Contraption Maker,2014,Puzzle,"₩14,500",0%,1158,108,1266,917850000,811,70,881,638725000
3612480,3D Escape Room: Mystic Manor,2025,Puzzle,"₩11,000",0%,0,0,0,0,27,7,34,18700000
792120,FIGHT KNIGHT,2021,Puzzle,"₩21,500",0%,1362,110,1472,1582400000,1240,123,1363,1465225000
1424600,Verne: The Shape of Fantasy,2023,Puzzle,"₩16,500",0%,201,39,240,198000000,143,33,176,145200000
2249120,Blockappend,2023,Puzzle,"₩4,500",0%,7,0,7,1575000,12,0,12,2700000
393520,Iconoclasts,2018,Puzzle,"₩21,500",0%,4098,632,4730,5084750000,0,0,0,0
1130620,[Chilla's Art] Aka Manto | 赤マント,2019,Puzzle,"₩5,600",0%,940,130,1070,299600000,840,125,965,270200000
1955330,Save Room - Organization Puzzle,2022,Puzzle,"₩3,400",0%,2188,62,2250,382500000,1799,56,1855,315350000
858760,Scalak,2018,Puzzle,"₩3,400",0%,980,26,1006,171020000,892,37,929,157930000
1927150,Townframe,2024,Puzzle,"₩7,800",0%,76,1,77,30030000,78,2,80,31200000
3256030,Hideko,2024,Puzzle,"₩5,600",0%,0,0,0,0,51,1,52,14560000
1900340,Ten Trials of Babel: The Doppelganger Maze,2022,Puzzle,"₩3,300",0%,3807,280,4087,674355000,3781,285,4066,670890000
1550510,Creepy Tale 2,2021,Puzzle,"₩10,500",0%,1170,187,1357,712425000,1015,165,1180,619500000
551110,Wayout,2016,Puzzle,"₩2,300",0%,1018,136,1154,132710000,854,117,971,111665000
548330,Wheely,2016,Puzzle,"₩2,300",0%,194,7,201,23115000,180,9,189,21735000
2451640,Furry Myth 🦁,2024,Puzzle,"₩5,530",0%,0,0,0,0,113,17,130,35945000
591420,Zup! 4,2017,Puzzle,"₩2,300",0%,2470,264,2734,314410000,0,0,0,0
1896880,Dungeons of Dreadrock,2022,Puzzle,"₩6,700",0%,421,23,444,148740000,402,30,432,144720000
2317300,Access Denied: Escape,2023,Puzzle,"₩5,600",0%,206,14,220,61600000,160,12,172,48160000
243220,FRACT OSC,2014,Puzzle,"₩16,500",0%,519,82,601,495825000,358,58,416,343200000
3543720,FIND ALL: Bunker,2025,Puzzle,₩810,26%,61,5,66,2673000,82,5,87,3523500
2907010,HIDDEN CATS: The last of cats,2024,Puzzle,Free,0%,0,0,0,0,980,30,1010,0
461840,Zenge,2016,Puzzle,"₩2,300",0%,2902,148,3050,350750000,0,0,0,0
1126290,Lost,2019,Puzzle,"₩2,200",0%,6228,1467,7695,846450000,0,0,0,0
243220,FRACT OSC,2014,Puzzle,"₩16,500",0%,519,82,601,495825000,358,58,416,343200000
932850,Simmiland,2018,Puzzle,"₩5,500",0%,780,89,869,238975000,1470,239,1709,469975000
461840,Zenge,2016,Puzzle,"₩2,300",0%,2902,148,3050,350750000,0,0,0,0
1571940,Ctrl Alt Ego,2022,Puzzle,"₩21,500",0%,658,47,705,757875000,634,48,682,733150000
1910680,Orb of Creation,2022,Puzzle,"₩5,500",0%,1210,117,1327,364925000,1193,133,1326,364650000
2705480,Nonogram 3D : Mega Puzzle,2024,Puzzle,"₩8,900",0%,59,2,61,27145000,52,2,54,24030000
765870,Leisure Suit Larry - Wet Dreams Don't Dry,2018,Puzzle,"₩31,000",0%,1468,238,1706,2644300000,1077,190,1267,1963850000
2421950,The Guardian of Nature,2025,Puzzle,"₩6,700",0%,0,0,0,0,43,4,47,15745000
747340,Unforgiving - A Northern Hymn,2017,Puzzle,"₩16,500",0%,1252,244,1496,1234200000,1127,247,1374,1133550000
524850,Alicemare,2016,Puzzle,"₩3,300",0%,993,129,1122,185130000,933,127,1060,174900000
1203420,Miss Neko 2,2021,Puzzle,"₩1,100",50%,2494,228,2722,149710000,0,0,0,0
207570,English Country Tune,2012,Puzzle,"₩5,600",0%,343,85,428,119840000,155,15,170,47600000
757330,qop 2,2017,Puzzle,"₩2,300",0%,382,19,401,46115000,489,31,520,59800000
262940,Broken Sword 5 - the Serpent's Curse,2013,Puzzle,"₩26,130",19%,2361,296,2657,3471370500,1623,201,1824,2383056000
499520,The Turing Test,2016,Puzzle,"₩21,000",0%,6915,979,7894,8288700000,0,0,0,0
242840,In Verbis Virtus,2015,Puzzle,"₩21,500",0%,1327,351,1678,1803850000,1141,322,1463,1572725000
654900,qop,2017,Puzzle,"₩2,300",0%,852,78,930,106950000,960,95,1055,121325000
115110,Stacking,2012,Puzzle,"₩10,500",0%,1587,193,1780,934500000,842,83,925,485625000
2101890,Zoonomaly,2024,Puzzle,"₩6,700",0%,595,183,778,260630000,584,185,769,257615000
331870,AER Memories of Old,2017,Puzzle,"₩16,000",0%,6323,1054,7377,5901600000,0,0,0,0
2731590,Block Shop,2025,Puzzle,"₩11,000",0%,63,0,63,34650000,61,0,61,33550000
427760,A Chair in a Room : Greenwater,2016,Puzzle,"₩27,000",0%,509,103,612,826200000,494,101,595,803250000
2428840,Miniatures,2024,Puzzle,"₩6,700",0%,224,9,233,78055000,206,11,217,72695000
1212830,Seek Girl Ⅳ,2020,Puzzle,"₩1,100",0%,1492,483,1975,108625000,1385,462,1847,101585000
1162280,Eternal Hope,2020,Puzzle,"₩12,500",0%,313,62,375,234375000,260,50,310,193750000
327220,Anna's Quest,2015,Puzzle,"₩21,000",0%,2054,277,2331,2447550000,1470,200,1670,1753500000
576030,MHRD,2017,Puzzle,"₩10,500",0%,369,44,413,216825000,360,45,405,212625000
742500,Nonogram - Master's Legacy,2018,Puzzle,Free,0%,441,73,514,0,450,79,529,0
1878910,WooLoop,2023,Puzzle,Free,0%,0,0,0,0,0,0,0,0
632000,CrossCells,2017,Puzzle,"₩3,400",0%,700,136,836,142120000,701,144,845,143650000
785890,Hexologic,2018,Puzzle,"₩5,600",0%,1208,52,1260,352800000,625,26,651,182280000
284750,Enigmatis: The Ghosts of Maple Creek,2014,Puzzle,"₩3,300",80%,1431,262,1693,279345000,1061,202,1263,208395000
2328730,Polimines 2,2023,Puzzle,"₩11,000",0%,123,16,139,76450000,119,19,138,75900000
381890,Induction,2017,Puzzle,"₩7,800",0%,156,18,174,67860000,129,16,145,56550000
2150490,Gnomdom,2024,Puzzle,"₩3,400",0%,71,2,73,12410000,83,3,86,14620000
846870,Yooka-Laylee and the Impossible Lair,2019,Puzzle,"₩31,000",0%,1042,227,1269,1966950000,659,116,775,1201250000
2085970,Cracking the Cryptic,2022,Puzzle,Free,0%,0,0,0,0,188,19,207,0
2239130,Reviver,2025,Puzzle,"₩9,800",0%,144,12,156,76440000,128,14,142,69580000
966330,Flower,2019,Puzzle,"₩8,800",0%,3666,917,4583,2016520000,0,0,0,0
3340750,100 New Year Cats,2024,Puzzle,Free,0%,0,0,0,0,611,32,643,0
702680,Wattam,2020,Puzzle,"₩24,000",0%,456,81,537,644400000,417,80,497,596400000
1544540,ALONE,2021,Puzzle,"₩1,100",0%,171,24,195,10725000,168,23,191,10505000
1256230,Hyperbolica,2022,Puzzle,"₩14,500",0%,1044,215,1259,912775000,979,201,1180,855500000
2655740,CatBox,2024,Puzzle,"₩3,400",0%,61,1,62,10540000,60,1,61,10370000
1029890,Layers of Fear 2 (2019),2019,Puzzle,"₩20,500",0%,1667,658,2325,2383125000,1371,560,1931,1979275000
2618380,Death of Marionette,2024,Puzzle,"₩7,800",0%,46,3,49,19110000,47,3,50,19500000
864300,qop 3,2018,Puzzle,"₩2,300",0%,313,20,333,38295000,456,29,485,55775000
201420,Toki Tori 2+,2013,Puzzle,"₩16,500",0%,889,157,1046,862950000,619,92,711,586575000
1961520,FIND ALL 3: Travel,2022,Puzzle,"₩2,250",0%,439,29,468,52650000,433,33,466,52425000
2862990,Zerko,2024,Puzzle,"₩2,300",0%,0,0,0,0,124,8,132,15180000
1029890,Layers of Fear 2 (2019),2019,Puzzle,"₩20,500",0%,1667,658,2325,2383125000,1371,560,1931,1979275000
864300,qop 3,2018,Puzzle,"₩2,300",0%,313,20,333,38295000,456,29,485,55775000
2954460,100 Crime Cats,2025,Puzzle,"₩1,100",0%,0,0,0,0,47,5,52,2860000
1635980,Kubinashi Recollection,2021,Puzzle,"₩12,500",0%,163,8,171,106875000,138,7,145,90625000
1644490,Occult,2022,Puzzle,"₩5,500",0%,1369,527,1896,521400000,1041,425,1466,403150000
2362680,"Grandma, No!",2025,Puzzle,"₩16,500",0%,31,6,37,30525000,29,6,35,28875000
2168150,Teslagrad Remastered,2023,Puzzle,"₩10,900",0%,136,37,173,94285000,115,29,144,78480000
954650,Druidstone: The Secret of the Menhir Forest,2019,Puzzle,"₩26,000",0%,1124,232,1356,1762800000,1033,227,1260,1638000000
1840490,Christmas Massacre,2021,Puzzle,"₩8,500",0%,857,80,937,398225000,799,79,878,373150000
1232010,Radical Rabbit Stew,2020,Puzzle,"₩16,500",0%,178,7,185,152625000,114,1,115,94875000
2950000,Ninja Stealth 5,2024,Puzzle,"₩5,500",0%,35,12,47,12925000,39,12,51,14025000
1249080,"Lynn , The Girl Drawn On Puzzles",2020,Puzzle,"₩8,500",0%,81,12,93,39525000,58,10,68,28900000
3066440,Archipel Logic Infinite,2024,Puzzle,"₩7,880",0%,64,3,67,26398000,54,2,56,22064000
1226670,Rosewater,2025,Puzzle,"₩17,200",19%,256,9,265,227900000,248,22,270,232200000
241910,Goodbye Deponia,2013,Puzzle,"₩21,500",0%,2093,264,2357,2533775000,1675,207,1882,2023150000
965590,Sagrada,2020,Puzzle,"₩10,500",0%,352,16,368,193200000,269,11,280,147000000
378690,Potions: A Curious Tale,2024,Puzzle,"₩20,000",0%,339,35,374,374000000,288,36,324,324000000
1737760,Platonic,2022,Puzzle,"₩20,500",0%,65,9,74,75850000,69,12,81,83025000
1606300,Puzzle Light,2021,Puzzle,₩550,50%,42,4,46,1265000,43,3,46,1265000
538070,Bad Dream: Coma,2017,Puzzle,"₩9,900",0%,1957,178,2135,1056825000,1724,170,1894,937530000
2543350,KoroNeko,2024,Puzzle,"₩9,900",0%,93,4,97,48015000,87,4,91,45045000
469610,Rick and Morty: Virtual Rick-ality,2017,Puzzle,"₩32,000",0%,1727,594,2321,3713600000,0,0,0,0
3128740,Beff Jezos Simulator,2025,Puzzle,"₩11,000",0%,207,69,276,151800000,229,89,318,174900000
762830,Telling Lies,2019,Puzzle,"₩24,000",0%,786,445,1231,1477200000,743,436,1179,1414800000
415170,Engare,2017,Puzzle,"₩11,000",0%,429,24,453,249150000,392,25,417,229350000
72000,Closure,2012,Puzzle,"₩11,000",0%,836,142,978,537900000,376,66,442,243100000
690120,Inked: A Tale of Love,2021,Puzzle,"₩10,500",0%,197,36,233,122325000,146,37,183,96075000
70300,VVVVVV,2010,Puzzle,"₩5,600",0%,9720,377,10097,2827160000,0,0,0,0
1257850,SOLAS 128,2021,Puzzle,"₩4,120",75%,181,13,194,39964000,163,9,172,35432000
3551600,Jumpscare Simulator: System Breach,2025,Puzzle,"₩2,300",0%,52,3,55,6325000,58,5,63,7245000
2803000,100 Dino Cats,2024,Puzzle,Free,0%,0,0,0,0,1819,96,1915,0
2085040,ToriDori,2023,Puzzle,"₩5,500",0%,180,6,186,51150000,0,0,0,0
1069740,Seen,2019,Puzzle,"₩1,100",0%,8916,837,9753,536415000,0,0,0,0
545690,VOI,2016,Puzzle,"₩1,100",0%,770,46,816,44880000,0,0,0,0
219910,Edna & Harvey: Harvey's New Eyes,2012,Puzzle,"₩21,000",0%,2809,353,3162,3320100000,0,0,0,0
369420,9 Clues 2: The Ward,2015,Puzzle,"₩4,950",70%,876,82,958,237105000,0,0,0,0
1458930,Meridian 157: Chapter 2,2020,Puzzle,"₩5,600",0%,166,8,174,48720000,0,0,0,0
3031590,13F,2024,Puzzle,"₩4,500",0%,88,4,92,20700000,84,4,88,19800000
753930,God's Basement,2018,Puzzle,"₩3,100",80%,948,334,1282,198710000,831,308,1139,176545000
38720,RUSH,2010,Puzzle,"₩5,600",0%,1130,127,1257,351960000,962,119,1081,302680000
3384180,A Simple Garbage Sorting Game,2025,Puzzle,"₩1,100",0%,113,2,115,6325000,120,5,125,6875000
1983220,Ugly,2023,Puzzle,"₩21,500",0%,473,22,495,532125000,330,17,347,373025000
550310,Root Of Evil: The Tailor,2016,Puzzle,"₩1,500",80%,432,79,511,38325000,360,68,428,32100000
2702490,TETRACHROMA,2024,Puzzle,"₩5,600",0%,151,0,151,42280000,150,0,150,42000000
2300300,Growth,2023,Puzzle,"₩11,000",0%,250,20,270,148500000,163,12,175,96250000
3466440,100 Greece Cats,2025,Puzzle,"₩2,070",9%,0,0,0,0,8,2,10,1035000
284730,Dark Arcana: The Carnival,2014,Puzzle,"₩3,300",80%,657,79,736,121440000,334,50,384,63360000
959000,Edna & Harvey: The Breakout - Anniversary Edition,2019,Puzzle,"₩21,900",0%,672,60,732,801540000,610,60,670,733650000
430070,Never Again,2019,Puzzle,"₩15,500",0%,671,161,832,644800000,630,157,787,609925000
687920,Tropical Liquor,2018,Puzzle,"₩11,000",0%,586,144,730,401500000,558,140,698,383900000
430070,Never Again,2019,Puzzle,"₩15,500",0%,671,161,832,644800000,630,157,787,609925000
3908190,Hidden Cats: Old Amusement Park,2025,Puzzle,₩920,16%,0,0,0,0,10,0,10,460000
258520,The Vanishing of Ethan Carter,2014,Puzzle,"₩21,500",0%,7805,1026,8831,9493325000,0,0,0,0
232790,Broken Age,2014,Puzzle,"₩14,940",0%,6679,1309,7988,5967036000,0,0,0,0
1583850,Asleep - Ato 1,2024,Puzzle,"₩11,000",0%,434,20,454,249700000,223,17,240,132000000
299680,Tengami,2015,Puzzle,"₩7,800",0%,1432,336,1768,689520000,729,149,878,342420000
230820,The Night of the Rabbit,2013,Puzzle,"₩21,000",0%,2839,337,3176,3334800000,0,0,0,0
269790,DreadOut,2014,Puzzle,"₩16,500",0%,4187,1266,5453,4498725000,0,0,0,0
314020,Morphopolis,2014,Puzzle,"₩4,500",0%,4018,811,4829,1086525000,0,0,0,0
1311070,Greak: Memories of Azur,2021,Puzzle,"₩20,500",0%,1071,298,1369,1403225000,707,177,884,906100000
342260,Nevermind,2015,Puzzle,"₩20,500",0%,336,94,430,440750000,252,84,336,344400000
559330,A Fisherman's Tale,2019,Puzzle,"₩18,500",0%,1373,92,1465,1355125000,971,73,1044,965700000
1711840,Ninja Stealth 4,2021,Puzzle,"₩5,500",0%,101,30,131,36025000,94,28,122,33550000
1156380,One Dreamer,2022,Puzzle,"₩16,500",0%,368,33,401,330825000,332,37,369,304425000
252670,Nihilumbra,2013,Puzzle,"₩8,500",0%,2607,342,2949,1253325000,0,0,0,0
373390,Contradiction: Spot The Liar,2015,Puzzle,"₩14,500",0%,2984,147,3131,2269975000,0,0,0,0
457210,SEUM: Speedrunners from Hell,2016,Puzzle,"₩16,000",0%,2808,153,2961,2368800000,0,0,0,0
1096140,Timemelters,2024,Puzzle,"₩21,500",0%,160,11,171,183825000,129,11,140,150500000
2627270,The Method of Hiding a Body,2024,Puzzle,"₩4,500",0%,54,4,58,13050000,55,3,58,13050000
269050,Year Walk,2014,Puzzle,"₩6,700",0%,1808,188,1996,668660000,1137,99,1236,414060000
906100,Observation,2020,Puzzle,"₩27,000",0%,3743,1030,4773,6443550000,0,0,0,0
3775050,DOGWALK,2025,Puzzle,Free,0%,0,0,0,0,1464,45,1509,0
485450,Ninja Stealth,2016,Puzzle,"₩5,500",0%,1147,522,1669,458975000,642,203,845,232375000
520720,Dear Esther: Landmark Edition,2017,Puzzle,"₩10,500",0%,5103,1746,6849,3595725000,0,0,0,0
1502800,Escape Machine City: Airborne,2021,Puzzle,"₩5,600",0%,80,9,89,24920000,83,14,97,27160000
1285080,Gordian Rooms 1: A curious heritage,2020,Puzzle,"₩7,000",0%,427,67,494,172900000,416,68,484,169400000
3162020,ToriDori 2,2024,Puzzle,"₩5,500",0%,56,3,59,16225000,52,4,56,15400000
2667970,100 Asian Cats,2023,Puzzle,Free,0%,0,0,0,0,0,0,0,0
469920,hackmud,2016,Puzzle,"₩19,100",0%,647,179,826,788830000,573,161,734,700970000
244430,realMyst: Masterpiece Edition,2014,Puzzle,"₩19,500",0%,1362,169,1531,1492725000,1188,162,1350,1316250000
2253730,Madorica Real Estate 2 - The mystery of the new property -,2023,Puzzle,"₩26,000",0%,44,3,47,61100000,34,3,37,48100000
2551300,BROKEN LIFE,2025,Puzzle,"₩3,920",30%,30,0,30,5880000,34,0,34,6664000
867380,Up Left Out,2018,Puzzle,"₩2,300",0%,406,29,435,50025000,392,29,421,48415000
2093220,ForbiddenWord,2023,Puzzle,"₩5,500",0%,15,9,24,6600000,13,9,22,6050000
661680,Growbot,2021,Puzzle,"₩11,390",41%,171,20,191,108774500,101,16,117,66631500
508550,Sneak Thief,2022,Puzzle,"₩16,500",0%,1333,465,1798,1483350000,1220,428,1648,1359600000
1747050,Sam & Max: Beyond Time and Space,2021,Puzzle,"₩20,500",0%,399,5,404,414100000,381,8,389,398725000
2234960,Pygmalion,2023,Puzzle,"₩5,000",0%,105,3,108,27000000,88,8,96,24000000
1254670,Night Reverie,2021,Puzzle,"₩11,000",0%,292,9,301,165550000,252,8,260,143000000
1732750,Havsala: Into the Soul Palace,2022,Puzzle,"₩12,500",0%,571,44,615,384375000,538,41,579,361875000
1037120,Mutropolis,2021,Puzzle,"₩11,160",45%,176,21,197,109926000,123,20,143,79794000
3141120,100 China Cats,2025,Puzzle,"₩2,300",0%,0,0,0,0,16,1,17,1955000
966630,qop 4,2018,Puzzle,"₩2,300",0%,189,7,196,22540000,315,20,335,38525000
204240,The Bridge,2013,Puzzle,"₩10,500",0%,3747,557,4304,2259600000,0,0,0,0
585830,Ninja Stealth 2,2017,Puzzle,₩550,90%,441,198,639,17572500,416,187,603,16582500
623940,HIVESWAP: ACT 1,2017,Puzzle,"₩8,500",0%,3660,288,3948,1677900000,0,0,0,0
1334000,Wordle,2021,Puzzle,"₩32,000",0%,521,93,614,982400000,605,124,729,1166400000
2402200,Hidden Kitten,2023,Puzzle,"₩4,500",0%,94,8,102,22950000,89,9,98,22050000
2880750,Leaf's Odyssey,2024,Puzzle,"₩16,500",0%,104,1,105,86625000,94,3,97,80025000
2402200,Hidden Kitten,2023,Puzzle,"₩4,500",0%,94,8,102,22950000,89,9,98,22050000
2717750,Tobla - Divine Path,2024,Puzzle,"₩8,900",0%,144,10,154,68530000,148,11,159,70755000
96000,The Tiny Bang Story,2011,Puzzle,"₩5,500",0%,5630,821,6451,1774025000,0,0,0,0
1191210,Seek Girl Ⅲ,2019,Puzzle,"₩1,100",0%,2410,477,2887,158785000,0,0,0,0
3344160,HIDDEN CATS 2: Crafts,2024,Puzzle,"₩1,100",0%,77,1,78,4290000,85,2,87,4785000
719750,PUSS!,2018,Puzzle,"₩10,500",0%,1308,181,1489,781725000,937,82,1019,534975000
460060,Varenje,2018,Puzzle,Free,0%,1263,188,1451,0,1259,205,1464,0
655100,Oik 3,2017,Puzzle,"₩1,100",0%,838,126,964,53020000,798,130,928,51040000
1425130,Forgotten Hill First Steps,2021,Puzzle,"₩3,400",0%,139,9,148,25160000,139,10,149,25330000
1602980,Insight,2021,Puzzle,"₩4,500",0%,49,9,58,13050000,65,15,80,18000000
2252960,Flashback,2023,Puzzle,"₩1,100",0%,356,53,409,22495000,345,56,401,22055000
896750,Koral,2019,Puzzle,"₩15,500",0%,310,62,372,288300000,281,66,347,268925000
348440,Quell Memento,2015,Puzzle,"₩4,400",0%,210,9,219,48180000,154,8,162,35640000
214550,Eets Munchies,2014,Puzzle,"₩7,500",0%,610,155,765,286875000,152,33,185,69375000
243160,Mushroom 11,2015,Puzzle,"₩16,000",0%,570,106,676,540800000,123,15,138,110400000
435100,2Dark,2017,Puzzle,"₩27,000",0%,617,180,797,1075950000,413,91,504,680400000
1211110,Petal Crash,2020,Puzzle,"₩10,500",0%,269,6,275,144375000,176,7,183,96075000
2348090,Crop Rotation,2023,Puzzle,"₩11,000",0%,448,29,477,262350000,457,29,486,267300000
1590230,Tyrion Cuthbert: Attorney of the Arcane,2023,Puzzle,"₩32,000",0%,1288,32,1320,2112000000,1266,39,1305,2088000000
1546790,"Peace, Death! 2",2021,Puzzle,"₩4,900",0%,799,41,840,205800000,772,41,813,199185000
269670,BADLAND: Game of the Year Edition,2015,Puzzle,"₩10,500",0%,2637,440,3077,1615425000,0,0,0,0
252890,Dracula: Love Kills,2013,Puzzle,"₩1,100",90%,265,63,328,18040000,207,49,256,14080000
205020,Lumino City,2014,Puzzle,"₩13,500",0%,1174,178,1352,912600000,502,88,590,398250000
573130,Aporia: Beyond The Valley,2017,Puzzle,"₩17,500",0%,609,120,729,637875000,330,63,393,343875000
1578990,Midnight Girl,2023,Puzzle,"₩16,500",0%,120,11,131,108075000,110,12,122,100650000
2863090,No.9,2024,Puzzle,"₩1,100",0%,0,0,0,0,84,9,93,5115000
1578990,Midnight Girl,2023,Puzzle,"₩16,500",0%,120,11,131,108075000,110,12,122,100650000
3466430,100 Berlin Cats,2025,Puzzle,"₩2,300",0%,0,0,0,0,16,4,20,2300000
3017380,100 Egypt Cats,2025,Puzzle,"₩1,100",0%,0,0,0,0,66,4,70,3850000
1590230,Tyrion Cuthbert: Attorney of the Arcane,2023,Puzzle,"₩32,000",0%,1288,32,1320,2112000000,1266,39,1305,2088000000
3473610,Bridge Constructor Studio,2025,Puzzle,"₩13,500",0%,0,0,0,0,9,1,10,6750000
724740,Lines X,2017,Puzzle,"₩2,300",0%,758,163,921,105915000,663,146,809,93035000
3419780,Tick Hop,2025,Puzzle,"₩3,400",0%,115,26,141,23970000,120,30,150,25500000
2675630,Cats Huddled Together 挤在一起的猫猫们,2023,Puzzle,"₩2,300",0%,0,0,0,0,285,50,335,38525000
297590,Monsters Ate My Birthday Cake,2014,Puzzle,"₩11,000",0%,112,2,114,62700000,81,2,83,45650000
529660,Mages of Mystralia,2017,Puzzle,"₩21,000",0%,1243,195,1438,1509900000,728,128,856,898800000
3708560,Brainfuck Challenge,2025,Puzzle,"₩3,400",0%,0,0,0,0,22,1,23,3910000
1668290,Dungeons of Aether,2023,Puzzle,"₩16,500",0%,494,110,604,498300000,463,109,572,471900000
2600140,"Please, Touch The Artwork 2",2024,Puzzle,Free,0%,0,0,0,0,0,0,0,0
1961300,Is Simon There?,2022,Puzzle,"₩5,600",0%,289,51,340,95200000,225,40,265,74200000
33950,Fish Fillets 2,2010,Puzzle,"₩5,900",0%,224,64,288,84960000,101,3,104,30680000
3720950,Left By Angels,2025,Puzzle,"₩1,020",70%,0,0,0,0,53,9,62,3162000
1234520,The Escaper,2020,Puzzle,"₩4,400",0%,714,47,761,167420000,671,51,722,158840000
1600910,Demon's Mirror,2024,Puzzle,"₩21,500",0%,83,12,95,102125000,69,11,80,86000000
364230,Lucius Demake,2016,Puzzle,"₩5,600",0%,519,38,557,155960000,377,24,401,112280000
523210,A Normal Lost Phone,2017,Puzzle,"₩3,300",0%,2389,297,2686,443190000,0,0,0,0
414660,Vampire Legends: The True Story of Kisilova,2015,Puzzle,"₩16,500",0%,562,91,653,538725000,358,53,411,339075000
1085160,Palmyra Orphanage,2019,Puzzle,"₩6,500",0%,617,77,694,225550000,535,73,608,197600000
1574910,The Bart Bonte collection,2021,Puzzle,"₩10,500",0%,118,3,121,63525000,116,4,120,63000000
2447120,Veiled Edge,2024,Puzzle,"₩13,200",19%,30,0,30,19800000,20,0,20,13200000
1574910,The Bart Bonte collection,2021,Puzzle,"₩10,500",0%,118,3,121,63525000,116,4,120,63000000
539270,Mahjong,2017,Puzzle,"₩10,500",0%,416,84,500,262500000,388,74,462,242550000
1162680,[Chilla's Art] Stigmatized Property | 事故物件,2019,Puzzle,"₩3,400",0%,1020,232,1252,212840000,959,225,1184,201280000
785840,Moe Jigsaw,2018,Puzzle,"₩4,400",0%,296,55,351,77220000,284,58,342,75240000
1014140,Snakebird Primer,2019,Puzzle,"₩8,500",0%,211,15,226,96050000,203,15,218,92650000
447850,The Next Door,2016,Puzzle,"₩5,600",0%,483,422,905,253400000,133,96,229,64120000
240440,Quadrilateral Cowboy,2016,Puzzle,"₩20,500",0%,867,73,940,963500000,773,67,840,861000000
1620720,The Forest Quartet,2022,Puzzle,"₩11,000",0%,361,20,381,209550000,315,20,335,184250000
944340,Vignettes,2019,Puzzle,"₩8,500",0%,90,5,95,40375000,73,5,78,33150000
399600,I and Me,2016,Puzzle,"₩10,500",0%,344,14,358,187950000,276,11,287,150675000
3343590,FIND ALL: Christmas,2024,Puzzle,Free,0%,0,0,0,0,353,23,376,0
2736480,Hidden Cats in Berlin,2024,Puzzle,"₩3,600",19%,198,1,199,35820000,161,2,163,29340000
1257660,Time Rift,2022,Puzzle,"₩11,000",0%,120,2,122,67100000,60,3,63,34650000
1919600,Paper Perjury,2024,Puzzle,"₩21,500",0%,132,14,146,156950000,135,15,150,161250000
1309200,3D Math - Ultra,2020,Puzzle,"₩5,600",0%,196,12,208,58240000,190,14,204,57120000
2780690,Hidden Cats in Rio de Janeiro,2025,Puzzle,"₩4,500",0%,0,0,0,0,48,0,48,10800000
783940,Forgotten Hill Mementoes,2018,Puzzle,"₩2,300",0%,215,21,236,27140000,211,23,234,26910000
2759760,Prickle,2024,Puzzle,"₩7,800",0%,81,0,81,31590000,81,0,81,31590000
1019310,VirtuaVerse,2020,Puzzle,"₩16,000",0%,884,180,1064,851200000,769,169,938,750400000
950140,Hiding Spot,2018,Puzzle,"₩5,500",0%,156,5,161,44275000,152,6,158,43450000
251370,Escape Goat,2013,Puzzle,"₩5,500",0%,664,28,692,190300000,404,21,425,116875000
249590,Teslagrad,2013,Puzzle,"₩10,500",0%,2050,380,2430,1275750000,1394,285,1679,881475000
1733500,Looking for Aliens,2021,Puzzle,"₩8,900",0%,278,13,291,129495000,177,9,186,82770000
3495050,100 Zombie Cats,2025,Puzzle,"₩2,300",0%,0,0,0,0,10,1,11,1265000
985950,Operencia: The Stolen Sun,2020,Puzzle,"₩31,000",0%,415,118,533,826150000,379,120,499,773450000
2295070,Poems & Codes,2023,Puzzle,"₩11,000",0%,68,3,71,39050000,68,4,72,39600000
2780690,Hidden Cats in Rio de Janeiro,2025,Puzzle,"₩4,500",0%,0,0,0,0,48,0,48,10800000
418040,hocus,2015,Puzzle,"₩1,100",0%,715,69,784,43120000,662,65,727,39985000
1733500,Looking for Aliens,2021,Puzzle,"₩8,900",0%,278,13,291,129495000,177,9,186,82770000
1232570,Paper Beast,2020,Puzzle,"₩20,500",0%,596,35,631,646775000,436,28,464,475600000
487370,Akin,2016,Puzzle,"₩1,100",0%,642,93,735,40425000,406,66,472,25960000
1822240,Stars In The Trash,2024,Puzzle,"₩13,500",0%,240,2,242,163350000,184,4,188,126900000
3629400,Loophole,2025,Puzzle,"₩11,000",0%,0,0,0,0,41,1,42,23100000
491010,IN-VERT: Definitive Edition,2018,Puzzle,"₩1,900",66%,82,19,101,9595000,60,13,73,6935000
1316720,THE 8IGHT,2025,Puzzle,"₩8,900",0%,20,5,25,11125000,20,6,26,11570000
3328700,3D Escape: Chinese Room,2024,Puzzle,"₩2,300",0%,84,12,96,11040000,91,21,112,12880000
205870,Auditorium,2012,Puzzle,"₩7,500",0%,248,48,296,111000000,111,21,132,49500000
2113450,"Forests, Fields and Fortresses",2023,Puzzle,"₩5,600",0%,64,2,66,18480000,38,1,39,10920000
949790,Rogue Bit,2018,Puzzle,"₩13,500",0%,105,11,116,78300000,103,13,116,78300000
2092660,Magnet Block,2022,Puzzle,"₩15,500",0%,30,2,32,24800000,21,1,22,17050000
3015350,Echoes of Dread,2024,Puzzle,"₩6,700",0%,44,7,51,17085000,44,6,50,16750000
465520,PRICE,2016,Puzzle,Free,0%,4793,301,5094,0,0,0,0,0
2462810,Ligo,2025,Puzzle,"₩16,500",0%,36,0,36,29700000,34,0,34,28050000
3037060,100 Waiting Cats,2024,Puzzle,Free,0%,0,0,0,0,585,24,609,0
1054340,Logic World,2021,Puzzle,"₩15,500",0%,289,19,308,238700000,268,17,285,220875000
3333330,You Are The Code,2025,Puzzle,"₩11,000",0%,0,0,0,0,13,0,13,7150000
922100,Nauticrawl,2019,Puzzle,"₩2,470",85%,322,26,348,42978000,286,25,311,38408500
1056610,Heal,2020,Puzzle,"₩7,800",0%,599,115,714,278460000,496,102,598,233220000
2343880,The Diary,2025,Puzzle,"₩17,500",0%,0,0,0,0,72,43,115,100625000
3333330,You Are The Code,2025,Puzzle,"₩11,000",0%,0,0,0,0,13,0,13,7150000
465520,PRICE,2016,Puzzle,Free,0%,4793,301,5094,0,0,0,0,0
638000,When Ski Lifts Go Wrong,2019,Puzzle,"₩15,500",0%,736,111,847,656425000,442,66,508,393700000
1056610,Heal,2020,Puzzle,"₩7,800",0%,599,115,714,278460000,496,102,598,233220000
2729000,Cats and Seek: Dino Park,2024,Puzzle,"₩2,300",0%,0,0,0,0,195,2,197,22655000
2688900,Super Algebrawl,2024,Puzzle,"₩6,700",0%,155,14,169,56615000,145,14,159,53265000
1032170,Robo Instructus,2019,Puzzle,"₩13,500",0%,61,9,70,47250000,51,9,60,40500000
237850,Dreamfall Chapters,2017,Puzzle,"₩27,000",0%,3664,776,4440,5994000000,0,0,0,0
1281490,The Night is Grey,2024,Puzzle,"₩14,500",0%,186,38,224,162400000,160,37,197,142825000
3070570,The Paradixion: Christmas,2024,Puzzle,"₩2,300",0%,23,0,23,2645000,20,0,20,2300000
1720090,Aspire: Ina's Tale,2021,Puzzle,"₩6,750",0%,309,56,365,123187500,221,39,260,87750000
684270,Silicon Zeroes,2017,Puzzle,"₩16,500",0%,239,33,272,224400000,215,29,244,201300000
2143050,Red Line,2023,Puzzle,"₩11,000",0%,157,2,159,87450000,134,3,137,75350000
3201210,Chaos Entropy,2024,Puzzle,"₩13,500",0%,53,4,57,38475000,34,4,38,25650000
1061920,Our Secret Below,2020,Puzzle,"₩10,500",0%,102,12,114,59850000,64,10,74,38850000
1026400,TAMASHII,2019,Puzzle,"₩5,500",0%,314,15,329,90475000,286,15,301,82775000
1177130,NABOKI,2019,Puzzle,"₩2,300",0%,335,24,359,41285000,328,29,357,41055000
1182090,Mr. Pumpkin 2: Kowloon walled city,2019,Puzzle,"₩6,700",0%,429,37,466,156110000,420,41,461,154435000
2944750,The Strange City,2024,Puzzle,"₩16,500",0%,29,27,56,46200000,27,27,54,44550000
331460,ROOMS: The Toymaker's Mansion,2015,Puzzle,"₩7,900",0%,108,14,122,48190000,83,12,95,37525000
2765340,EarWorm,2025,Puzzle,"₩3,400",0%,70,2,72,12240000,102,3,105,17850000
3213430,Utter a Name,2025,Puzzle,"₩7,800",0%,80,1,81,31590000,99,3,102,39780000
290890,You Must Build A Boat,2015,Puzzle,"₩5,500",0%,862,187,1049,288475000,661,155,816,224400000
1223500,Umurangi Generation,2020,Puzzle,"₩15,500",0%,1034,98,1132,877300000,970,96,1066,826150000
642560,Art Of Gravity,2017,Puzzle,"₩2,300",0%,613,58,671,77165000,531,59,590,67850000
672150,LOGistICAL 3: Earth,2020,Puzzle,"₩41,000",0%,137,20,157,321850000,128,19,147,301350000
1168690,HELLSEED: All Chapters,2024,Puzzle,"₩21,500",0%,168,68,236,253700000,155,58,213,228975000
230210,ASYLUM,2025,Puzzle,"₩27,000",0%,303,45,348,469800000,264,46,310,418500000
3201210,Chaos Entropy,2024,Puzzle,"₩13,500",0%,53,4,57,38475000,34,4,38,25650000
998930,Seek Girl,2019,Puzzle,Free,0%,3970,1139,5109,0,0,0,0,0
556240,Disoriented,2016,Puzzle,"₩3,400",0%,323,75,398,67660000,312,73,385,65450000
214830,Half Minute Hero: Super Mega Neo Climax Ultimate Boy,2012,Puzzle,"₩10,500",0%,1261,208,1469,771225000,872,119,991,520275000
314790,Silence,2016,Puzzle,"₩20,500",0%,2194,409,2603,2668075000,1437,294,1731,1774275000
207170,Legend of Grimrock,2012,Puzzle,"₩16,500",0%,5995,406,6401,5280825000,0,0,0,0
1892790,Polimines,2022,Puzzle,"₩5,600",0%,125,27,152,42560000,125,31,156,43680000
2989830,Park It!,2025,Puzzle,"₩4,500",0%,0,0,0,0,29,0,29,6525000
2524360,With My Past,2024,Puzzle,"₩9,900",0%,305,13,318,157410000,234,15,249,123255000
1212410,Hourglass,2021,Puzzle,"₩20,500",0%,328,37,365,374125000,267,36,303,310575000
522210,Serial Cleaner,2017,Puzzle,"₩16,000",0%,3244,526,3770,3016000000,1105,180,1285,1028000000
699600,PEG,2017,Puzzle,"₩1,100",0%,207,18,225,12375000,201,17,218,11990000
454320,[the Sequence],2016,Puzzle,"₩5,600",0%,157,17,174,48720000,133,16,149,41720000
1215280,Mask of Mists,2020,Puzzle,"₩16,500",0%,153,29,182,150150000,129,26,155,127875000
922710,Knightin'+,2019,Puzzle,"₩3,250",50%,232,38,270,43875000,185,30,215,34937500
252550,Qbeh-1: The Atlas Cube,2014,Puzzle,"₩10,500",0%,621,86,707,371175000,519,77,596,312900000
738860,Jetstream,2019,Puzzle,"₩10,500",0%,93,7,100,52500000,76,8,84,44100000
1133930,Forgotten Hill Disillusion,2019,Puzzle,"₩5,600",0%,174,22,196,54880000,169,23,192,53760000
2844290,Hard Chip,2024,Puzzle,"₩16,500",0%,30,1,31,25575000,36,2,38,31350000
3063040,Click Painter,2025,Puzzle,"₩8,500",0%,24,0,24,10200000,21,2,23,9775000
1054660,Factory Balls,2019,Puzzle,"₩4,400",0%,131,2,133,29260000,133,3,136,29920000
453290,Awareness Rooms,2016,Puzzle,"₩5,500",0%,428,95,523,143825000,411,97,508,139700000
696480,The Norwood Suite,2017,Puzzle,"₩10,500",0%,1058,147,1205,632625000,537,22,559,293475000
2511450,There's No Dinosaurs,2024,Puzzle,"₩4,500",0%,0,0,0,0,28,1,29,6525000
711130,God of Light: Remastered,2017,Puzzle,"₩10,500",0%,69,6,75,39375000,60,4,64,33600000
460960,The Deed: Dynasty,2016,Puzzle,"₩3,400",0%,496,75,571,97070000,444,66,510,86700000
1004150,Madorica Real Estate,2019,Puzzle,"₩18,000",0%,102,6,108,97200000,87,8,95,85500000
1311510,Embracelet,2020,Puzzle,"₩13,500",0%,93,6,99,66825000,75,7,82,55350000
1955110,Star Stuff,2024,Puzzle,"₩16,500",0%,166,1,167,137775000,133,1,134,110550000
544970,Milkmaid of the Milky Way,2017,Puzzle,"₩6,500",0%,499,26,525,170625000,476,25,501,162825000
2963230,Joyville 2,2024,Puzzle,"₩14,500",0%,112,41,153,110925000,114,45,159,115275000
585950,Wayout 2: Hex,2017,Puzzle,"₩2,300",0%,363,57,420,48300000,302,49,351,40365000
676420,SiNKR,2017,Puzzle,"₩4,500",0%,387,18,405,91125000,484,36,520,117000000
778390,Corpse Party: Book of Shadows,2018,Puzzle,"₩15,500",0%,406,58,464,359600000,373,61,434,336350000
1255040,Let's Learn Korean! Hangul,2020,Puzzle,"₩5,600",0%,78,3,81,22680000,73,3,76,21280000
3109800,Illusion Box,2025,Puzzle,"₩7,800",0%,210,8,218,85020000,182,8,190,74100000
511090,The Shape Of Heart,2016,Puzzle,"₩3,300",0%,180,45,225,37125000,163,38,201,33165000
454250,The Eyes of Ara,2016,Puzzle,"₩15,500",0%,660,135,795,616125000,586,129,715,554125000
1648100,Kinduo,2021,Puzzle,"₩2,300",0%,88,4,92,10580000,83,4,87,10005000
1204440,The God Unit,2021,Puzzle,"₩1,100",90%,81,4,85,4675000,66,4,70,3850000
2077720,Moth Lake: A Horror Story,2022,Puzzle,"₩8,900",0%,79,16,95,42275000,74,16,90,40050000
3411050,3D Escape Room: Detective Story,2025,Puzzle,"₩8,900",0%,42,17,59,26255000,50,21,71,31595000
2845320,Cats and Seek: Kyoto,2024,Puzzle,Free,0%,0,0,0,0,1040,32,1072,0
1271300,Methods: The Detective Competition,2020,Puzzle,"₩21,500",0%,554,50,604,649300000,532,46,578,621350000
221640,Super Hexagon,2012,Puzzle,"₩3,400",0%,23905,771,24676,4194920000,0,0,0,0
1684270,It's a Wrap!,2023,Puzzle,"₩7,800",60%,58,10,68,26520000,41,9,50,19500000
2447260,Cats on Duty,2024,Puzzle,"₩11,000",0%,0,0,0,0,114,9,123,67650000
1801650,Lost: Find,2021,Puzzle,"₩4,400",0%,1778,249,2027,445940000,1714,256,1970,433400000
1150460,Summer Paws,2020,Puzzle,"₩5,600",0%,403,14,417,116760000,369,15,384,107520000
308040,Back to Bed,2014,Puzzle,"₩6,500",0%,2296,537,2833,920725000,548,155,703,228475000
462680,BalanCity,2016,Puzzle,"₩8,500",0%,707,167,874,371450000,553,105,658,279650000
2700230,ISOLAND4: The Anchor of Memory,2024,Puzzle,"₩3,400",0%,128,19,147,24990000,106,20,126,21420000
1398740,The Chrono Jotter,2021,Puzzle,"₩12,500",0%,1837,102,1939,1211875000,1628,104,1732,1082500000
221640,Super Hexagon,2012,Puzzle,"₩3,400",0%,23905,771,24676,4194920000,0,0,0,0
3193730,Seek,2025,Puzzle,"₩6,700",0%,50,7,57,19095000,60,11,71,23785000
333250,Forward to the Sky,2015,Puzzle,"₩3,200",60%,1791,396,2187,349920000,1541,294,1835,293600000
259600,Finding Teddy,2013,Puzzle,"₩7,500",0%,811,180,991,371625000,291,64,355,133125000
1187510,Rock Simulator,2019,Puzzle,"₩2,300",0%,1567,87,1654,190210000,1308,84,1392,160080000
1418360,Lonesome Village,2022,Puzzle,"₩20,500",0%,156,49,205,210125000,104,41,145,148625000
2800300,100 Cats Singapore,2024,Puzzle,"₩1,100",0%,0,0,0,0,65,3,68,3740000
742480,The Big Journey,2018,Puzzle,"₩1,680",70%,282,49,331,27804000,221,45,266,22344000
1450100,LUNA,2020,Puzzle,"₩1,100",0%,251,47,298,16390000,234,45,279,15345000
1259640,Tiny Room Stories: Town Mystery,2021,Puzzle,"₩10,500",0%,662,88,750,393750000,621,93,714,374850000
614910,#monstercakes,2017,Puzzle,"₩1,100",0%,752,103,855,47025000,607,91,698,38390000
2576580,Robospital,2023,Puzzle,"₩16,500",0%,18,4,22,18150000,19,6,25,20625000
1718910,Prose & Codes,2022,Puzzle,"₩11,000",0%,264,1,265,145750000,256,3,259,142450000
618920,Dungeon Escape VR,2017,Puzzle,"₩5,600",0%,156,36,192,53760000,151,38,189,52920000
3575260,Only Sliding,2025,Puzzle,"₩5,600",0%,0,0,0,0,32,2,34,9520000
2845260,100 March Cats,2024,Puzzle,Free,0%,0,0,0,0,1493,46,1539,0
3491570,FIND ALL 7: Japan,2025,Puzzle,Free,0%,0,0,0,0,209,4,213,0
1676910,Onde,2022,Puzzle,"₩14,500",0%,234,18,252,182700000,167,13,180,130500000
977810,THE ENIGMA MACHINE,2018,Puzzle,"₩5,500",0%,269,26,295,81125000,270,30,300,82500000
1676910,Onde,2022,Puzzle,"₩14,500",0%,234,18,252,182700000,167,13,180,130500000
1876000,IFO,2022,Puzzle,"₩4,500",0%,68,10,78,17550000,78,13,91,20475000
3491570,FIND ALL 7: Japan,2025,Puzzle,Free,0%,0,0,0,0,209,4,213,0
2511440,Infinite Seek and Find,2024,Puzzle,"₩3,150",30%,19,1,20,3150000,14,1,15,2362500
1451720,Minesweeper Classy,2020,Puzzle,"₩3,400",0%,167,12,179,30430000,164,12,176,29920000
591630,Candleman: The Complete Journey,2018,Puzzle,"₩15,500",0%,1126,94,1220,945500000,950,94,1044,809100000
2791650,100 Cats Berlin,2024,Puzzle,"₩1,100",0%,0,0,0,0,62,6,68,3740000
335000,Tormentum - Dark Sorrow,2015,Puzzle,"₩12,500",0%,2455,155,2610,1631250000,0,0,0,0
1714050,SOKOBOT,2022,Puzzle,"₩14,500",0%,42,3,45,32625000,39,4,43,31175000
591380,Bomb Squad Academy,2017,Puzzle,"₩5,500",0%,390,60,450,123750000,347,57,404,111100000
223730,Fly'N,2012,Puzzle,"₩12,000",0%,429,65,494,296400000,258,25,283,169800000
1601280,Potato Flowers in Full Bloom,2022,Puzzle,"₩18,500",0%,0,0,0,0,486,26,512,473600000
3634590,Coloring Voxels,2025,Puzzle,Free,0%,0,0,0,0,82,28,110,0
50000,Nimbus,2010,Puzzle,"₩10,500",0%,237,15,252,132300000,171,11,182,95550000
1950490,Nova: Cloudwalker's Tale,2023,Puzzle,"₩11,000",0%,52,2,54,29700000,50,2,52,28600000
1949000,Catgirls From My Sweet Dream,2022,Puzzle,"₩5,600",0%,261,29,290,81200000,270,33,303,84840000
203830,The Dark Eye: Chains of Satinav,2012,Puzzle,"₩21,000",0%,2042,311,2353,2470650000,1643,267,1910,2005500000
759000,.projekt,2018,Puzzle,"₩5,500",0%,136,12,148,40700000,115,10,125,34375000
1055850,Inspector Waffles,2021,Puzzle,"₩14,500",0%,250,14,264,191400000,183,10,193,139925000
2746760,100 Hidden Kooky - Sand & Sun,2024,Puzzle,"₩1,730",0%,57,1,58,5017000,52,1,53,4584500
2881230,100 Funny Cats,2024,Puzzle,Free,0%,0,0,0,0,1474,46,1520,0
2356330,Candlelight: Lament,2024,Puzzle,"₩10,890",0%,94,6,100,54450000,66,7,73,39748500
3111680,Can't revert,2024,Puzzle,"₩5,600",0%,121,36,157,43960000,109,33,142,39760000
255300,Journey of a Roach,2013,Puzzle,"₩7,800",0%,1755,211,1966,766740000,1285,159,1444,563160000
2672090,Cats and Seek: Osaka,2023,Puzzle,Free,0%,0,0,0,0,1665,34,1699,0
2666840,Robot Detour,2024,Puzzle,"₩6,700",0%,170,1,171,57285000,159,0,159,53265000
2810330,Cats in Boxes,2024,Puzzle,"₩2,990",0%,31,0,31,4634500,28,0,28,4186000
308060,Black The Fall,2017,Puzzle,"₩16,000",0%,1356,385,1741,1392800000,567,160,727,581600000
2356330,Candlelight: Lament,2024,Puzzle,"₩10,890",0%,94,6,100,54450000,66,7,73,39748500
547480,Carly and the Reaperman - Escape from the Underworld,2018,Puzzle,"₩20,500",0%,193,25,218,223450000,173,24,197,201925000
818500,Colorzzle,2018,Puzzle,"₩2,200",0%,134,6,140,15400000,133,7,140,15400000
544330,Snake Pass,2017,Puzzle,"₩21,000",0%,2560,641,3201,3361050000,978,146,1124,1180200000
676430,PUSH,2017,Puzzle,"₩2,300",0%,592,87,679,78085000,553,90,643,73945000
262590,Chuck's Challenge 3D 2020,2014,Puzzle,"₩10,500",0%,175,33,208,109200000,114,28,142,74550000
1477020,Wordle 4,2020,Puzzle,"₩11,000",0%,57,41,98,53900000,143,33,176,96800000
1138970,Dandy Dungeon - Legend of Brave Yamada -,2019,Puzzle,"₩19,500",0%,71,12,83,80925000,68,12,80,78000000
1587560,100 hidden cats,2021,Puzzle,"₩2,300",0%,2116,122,2238,257370000,0,0,0,0
284890,Left in the Dark: No One on Board,2014,Puzzle,"₩3,300",80%,631,124,755,124575000,376,82,458,75570000
2946030,Choo-Choose,2024,Puzzle,"₩1,100",0%,239,48,287,15785000,264,54,318,17490000
3198680,Puttler,2025,Puzzle,"₩8,900",0%,179,5,184,81880000,174,9,183,81435000
2782380,100 Cats New York,2024,Puzzle,Free,0%,0,0,0,0,596,25,621,0
775530,Puzzlement,2018,Puzzle,"₩2,200",0%,216,19,235,25850000,190,19,209,22990000
2103480,Summer Trip Cruise,2023,Puzzle,"₩14,500",0%,86,7,93,67425000,82,9,91,65975000
1220100,Tentacular,2022,Puzzle,"₩27,000",0%,88,8,96,129600000,62,5,67,90450000
61730,Critter Crunch,2012,Puzzle,"₩7,500",0%,332,19,351,131625000,252,13,265,99375000
2714600,Hidden Capybaras with Orange,2023,Puzzle,"₩2,300",0%,0,0,0,0,129,1,130,14950000
2757220,SCP: Descent,2024,Puzzle,"₩7,800",0%,54,44,98,38220000,53,41,94,36660000
797620,Dissembler,2018,Puzzle,"₩5,600",0%,88,7,95,26600000,83,10,93,26040000
467210,Evo Explores,2016,Puzzle,"₩4,400",0%,325,20,345,75900000,173,17,190,41800000
689910,Another Lost Phone: Laura's Story,2017,Puzzle,"₩3,300",0%,861,85,946,156090000,743,73,816,134640000
395170,DISTRAINT: Deluxe Edition,2015,Puzzle,"₩5,600",0%,11408,834,12242,3427760000,0,0,0,0
497950,GOD'S GIFT,2024,Puzzle,"₩13,500",0%,19,1,20,13500000,12,0,12,8100000
1510620,Pocket Watch,2021,Puzzle,"₩3,300",0%,32,1,33,5445000,88,6,94,15510000
620940,Invisibox,2017,Puzzle,"₩2,300",0%,68,10,78,8970000,64,9,73,8395000
319870,Jenny LeClue - Detectivu,2019,Puzzle,"₩21,500",0%,1144,165,1309,1407175000,1021,166,1187,1276025000
596590,Linked,2017,Puzzle,"₩4,500",0%,519,47,566,127350000,401,35,436,98100000
1518810,Koi Farm,2021,Puzzle,"₩3,300",0%,883,47,930,153450000,815,52,867,143055000
824570,Kine,2020,Puzzle,"₩15,900",0%,107,6,113,89835000,94,6,100,79500000
1186640,Pumpkin Jack,2020,Puzzle,"₩32,000",0%,7138,690,7828,12524800000,0,0,0,0
1665280,Skábma™ - Snowfall,2022,Puzzle,"₩20,500",0%,147,37,184,188600000,126,30,156,159900000
1452540,Frincess&Cnight,2021,Puzzle,"₩4,400",0%,127,5,132,29040000,123,5,128,28160000
1086410,Golf Around!,2020,Puzzle,"₩11,000",0%,995,59,1054,579700000,766,49,815,448250000
1180540,Puddle Knights,2020,Puzzle,"₩11,000",0%,200,5,205,112750000,188,6,194,106700000
463930,The Dweller,2016,Puzzle,"₩5,500",0%,692,42,734,201850000,357,23,380,104500000
462620,Pocket Kingdom,2016,Puzzle,"₩7,500",0%,193,21,214,80250000,112,11,123,46125000
1033080,Letters - a written adventure,2022,Puzzle,"₩15,500",0%,228,22,250,193750000,178,22,200,155000000
322680,BLACKHOLE,2015,Puzzle,"₩9,900",0%,901,150,1051,520245000,499,81,580,287100000
227000,Primordia,2012,Puzzle,"₩10,500",0%,3194,108,3302,1733550000,0,0,0,0
235820,Element4l,2013,Puzzle,"₩10,500",0%,541,110,651,341775000,391,80,471,247275000
3141140,100 Sea Cats,2025,Puzzle,"₩2,070",9%,0,0,0,0,9,1,10,1035000
269330,Chronology,2014,Puzzle,"₩5,500",0%,831,120,951,261525000,451,50,501,137775000
1008920,Photographs,2019,Puzzle,"₩12,500",0%,135,25,160,100000000,121,27,148,92500000
2026870,Night At the Gates of Hell,2022,Puzzle,"₩12,500",0%,706,83,789,493125000,648,80,728,455000000
661430,LineWay,2017,Puzzle,"₩1,100",0%,496,39,535,29425000,441,44,485,26675000
1397290,Comet 64,2021,Puzzle,"₩16,500",0%,133,43,176,145200000,127,45,172,141900000
733050,Lines Infinite,2017,Puzzle,"₩2,300",0%,511,46,557,64055000,429,37,466,53590000
1099500,The Curious Tale of the Stolen Pets,2019,Puzzle,"₩7,800",0%,317,32,349,136110000,249,25,274,106860000
967120,Cursed Mansion,2023,Puzzle,"₩7,430",0%,55,5,60,22290000,49,5,54,20061000
1347600,Dad's Monster House,2021,Puzzle,"₩3,300",0%,206,10,216,35640000,203,13,216,35640000
2494440,Toy Trains,2024,Puzzle,"₩16,000",0%,82,4,86,68800000,69,4,73,58400000
2415540,The Paradixion: Son's Room,2023,Puzzle,"₩2,550",25%,40,6,46,5865000,40,6,46,5865000
765940,SOK,2017,Puzzle,"₩1,860",0%,154,21,175,16275000,156,23,179,16647000
1653970,Jigsaw Puzzle Dreams,2021,Puzzle,Free,0%,0,0,0,0,978,62,1040,0
1208030,Let's Learn Japanese! Vocabulary,2019,Puzzle,"₩5,600",0%,43,7,50,14000000,43,7,50,14000000
2782400,Papercut Art Gallery-Nature,2024,Puzzle,"₩2,300",0%,0,0,0,0,188,6,194,22310000
2840590,no signal,2025,Puzzle,"₩16,500",0%,0,0,0,0,42,1,43,35475000
1127970,Retro Machina,2021,Puzzle,"₩18,500",0%,203,31,234,216450000,159,24,183,169275000
3047220,Tidy Backpack,2024,Puzzle,"₩4,500",0%,63,0,63,14175000,62,0,62,13950000
606480,Flood of Light,2017,Puzzle,"₩4,400",0%,273,23,296,65120000,221,22,243,53460000
493200,RiME,2017,Puzzle,"₩32,000",0%,4585,494,5079,8126400000,0,0,0,0
2932930,100 Korea Cats,2024,Puzzle,Free,0%,0,0,0,0,684,51,735,0
919410,Felix The Reaper,2019,Puzzle,"₩11,000",0%,321,121,442,243100000,163,41,204,112200000
1978330,Life Gallery,2023,Puzzle,"₩3,700",0%,303,65,368,68080000,265,71,336,62160000
2723460,Dogs Huddled Together 挤在一起的狗狗们,2024,Puzzle,"₩2,300",0%,0,0,0,0,99,16,115,13225000
498660,Mind Spheres,2016,Puzzle,"₩5,600",0%,618,181,799,223720000,239,46,285,79800000
350970,Planet of the Eyes,2015,Puzzle,"₩11,000",0%,479,93,572,314600000,151,15,166,91300000
1569810,24 Solar Terms,2023,Puzzle,"₩7,500",0%,149,17,166,62250000,131,18,149,55875000
1820690,One Line,2021,Puzzle,₩550,50%,54,1,55,1512500,50,1,51,1402500
284830,Clockwork Tales: Of Glass and Ink,2014,Puzzle,"₩3,300",80%,1026,88,1114,183810000,550,61,611,100815000
3249580,Yakiniku Party Survival,2024,Puzzle,"₩3,400",0%,20,1,21,3570000,21,2,23,3910000
349220,The Black Watchmen,2015,Puzzle,"₩10,500",0%,661,82,743,390075000,552,68,620,325500000
2244630,Lovux,2023,Puzzle,"₩3,400",0%,0,0,0,0,70,9,79,13430000
2017200,Leximan,2024,Puzzle,"₩16,500",0%,51,8,59,48675000,45,9,54,44550000
699780,Endless Fables 2: Frozen Path,2017,Puzzle,"₩15,500",0%,218,24,242,187550000,155,14,169,130975000
937850,Hidden Paws Mystery,2018,Puzzle,"₩5,500",0%,276,17,293,80575000,250,19,269,73975000
384360,Fingered,2015,Puzzle,"₩2,160",0%,743,252,995,107460000,690,242,932,100656000
1755890,Repit,2021,Puzzle,"₩4,800",0%,59,11,70,16800000,39,5,44,10560000
2584650,Girlfriend from Hell,2024,Puzzle,"₩4,600",0%,150,32,182,41860000,136,24,160,36800000
3051050,100 Aztec Cats,2025,Puzzle,"₩1,100",0%,33,1,34,1870000,46,3,49,2695000
2560680,The Paradixion: Laboratory,2024,Puzzle,"₩4,500",0%,32,2,34,7650000,32,2,34,7650000
215510,Rocketbirds: Hardboiled Chicken,2012,Puzzle,"₩5,500",0%,2487,643,3130,860750000,1538,361,1899,522225000
992050,Oik 5,2019,Puzzle,"₩1,100",0%,135,15,150,8250000,124,15,139,7645000
491620,Beeftacular,2016,Puzzle,"₩5,600",0%,91,21,112,31360000,89,19,108,30240000
2617090,Fowl Damage,2024,Puzzle,"₩16,500",0%,107,3,110,90750000,101,3,104,85800000
1303670,WORLD OF ART JIGSAW PUZZLES,2020,Puzzle,"₩11,500",0%,85,4,89,51175000,71,5,76,43700000
1560450,the Sequence [2],2021,Puzzle,"₩5,600",0%,25,2,27,7560000,21,2,23,6440000
1107230,The 13th Doll: A Fan Game of The 7th Guest,2019,Puzzle,"₩20,500",0%,181,12,193,197825000,114,9,123,126075000
1110050,Evan's Remains,2020,Puzzle,"₩7,500",0%,1637,230,1867,700125000,848,94,942,353250000
3382220,OVERDOSE,2025,Puzzle,"₩4,500",0%,81,14,95,21375000,55,7,62,13950000
387290,Ori and the Blind Forest: Definitive Edition,2016,Puzzle,"₩19,900",0%,63788,3191,66979,66644105000,0,0,0,0
258890,Type:Rider,2013,Puzzle,₩930,83%,1321,340,1661,77236500,456,94,550,25575000
284240,Maize,2016,Puzzle,"₩11,000",0%,1657,386,2043,1123650000,637,95,732,402600000
2110510,DREAM LOGIC,2022,Puzzle,"₩5,600",0%,303,33,336,94080000,301,33,334,93520000
699710,Rose and Lotus: Petals of Memories,2023,Puzzle,"₩16,500",0%,41,26,67,55275000,10,7,17,14025000
1722520,FIND ALL 2: Middle Ages,2022,Puzzle,"₩1,660",26%,405,15,420,34860000,397,21,418,34694000
2869960,Animal Shake,2024,Puzzle,"₩4,500",0%,26,0,26,5850000,20,0,20,4500000
3382220,OVERDOSE,2025,Puzzle,"₩4,500",0%,81,14,95,21375000,55,7,62,13950000
1110050,Evan's Remains,2020,Puzzle,"₩7,500",0%,1637,230,1867,700125000,848,94,942,353250000
348300,Chip's Challenge 2,2015,Puzzle,"₩5,500",0%,118,19,137,37675000,114,17,131,36025000
3640750,This is Interesting,2025,Puzzle,"₩7,800",0%,60,1,61,23790000,65,1,66,25740000
1722520,FIND ALL 2: Middle Ages,2022,Puzzle,"₩1,660",26%,405,15,420,34860000,397,21,418,34694000
2704510,Simple CEO,2024,Puzzle,"₩3,150",30%,14,6,20,3150000,11,6,17,2677500
1506440,Batora: Lost Haven,2022,Puzzle,"₩27,800",0%,270,134,404,561560000,143,48,191,265490000
437420,The Secret Order 3: Ancient Times,2016,Puzzle,"₩16,500",0%,333,50,383,315975000,232,38,270,222750000
263980,Out There Somewhere,2016,Puzzle,"₩4,860",0%,6433,483,6916,1680588000,0,0,0,0
783180,Fairune Collection,2018,Puzzle,"₩10,500",0%,93,14,107,56175000,88,14,102,53550000
392030,Murasaki,2016,Puzzle,"₩5,500",0%,109,11,120,33000000,104,9,113,31075000
839340,SOK MIN,2018,Puzzle,"₩1,860",0%,93,9,102,9486000,88,10,98,9114000
1613680,Arrow Sudoku,2021,Puzzle,"₩5,500",0%,67,1,68,18700000,66,1,67,18425000
1095120,Helheim Hassle,2020,Puzzle,"₩21,500",0%,326,34,360,387000000,259,29,288,309600000
387290,Ori and the Blind Forest: Definitive Edition,2016,Puzzle,"₩19,900",0%,63788,3191,66979,66644105000,0,0,0,0
255870,PixelJunk™ Shooter,2013,Puzzle,"₩9,500",0%,541,60,601,285475000,221,14,235,111625000
1383250,Please Fix The Road,2022,Puzzle,"₩10,500",0%,105,11,116,60900000,188,56,244,128100000
1585910,Roll,2021,Puzzle,"₩5,600",0%,376,32,408,114240000,358,35,393,110040000
451570,Demetrios - The BIG Cynical Adventure,2016,Puzzle,"₩1,050",90%,345,68,413,21682500,225,53,278,14595000
1508530,Epiphany City,2022,Puzzle,"₩10,500",0%,232,25,257,134925000,226,25,251,131775000
1086450,Oik Memory: Endgame,2019,Puzzle,"₩1,100",0%,76,5,81,4455000,73,5,78,4290000
1193990,Trapped,2019,Puzzle,"₩4,400",0%,128,24,152,33440000,109,22,131,28820000
1205170,Super Magbot,2021,Puzzle,"₩11,250",0%,312,52,364,204750000,159,20,179,100687500
233230,Kairo,2013,Puzzle,"₩5,600",0%,1265,452,1717,480760000,1092,384,1476,413280000
1086450,Oik Memory: Endgame,2019,Puzzle,"₩1,100",0%,76,5,81,4455000,73,5,78,4290000
1613680,Arrow Sudoku,2021,Puzzle,"₩5,500",0%,67,1,68,18700000,66,1,67,18425000
365160,Kona,2017,Puzzle,"₩15,500",0%,2807,577,3384,2622600000,0,0,0,0
679660,aMAZE ZER0,2017,Puzzle,₩640,72%,199,41,240,7680000,163,29,192,6144000
781810,Oik 4,2018,Puzzle,"₩1,100",0%,261,52,313,17215000,253,52,305,16775000
406870,Eventide: Slavic Fable,2016,Puzzle,"₩16,500",0%,759,57,816,673200000,525,39,564,465300000
1024160,Lord Winklebottom Investigates,2022,Puzzle,"₩19,500",0%,179,12,191,186225000,150,13,163,158925000
909820,Songbird Symphony,2019,Puzzle,"₩18,500",0%,581,65,646,597550000,480,53,533,493025000
1428820,Wordle 3,2020,Puzzle,"₩32,000",0%,156,38,194,310400000,250,51,301,481600000
233230,Kairo,2013,Puzzle,"₩5,600",0%,1265,452,1717,480760000,1092,384,1476,413280000
3141080,100 Fantasy Cats,2025,Puzzle,"₩1,100",0%,0,0,0,0,44,1,45,2475000
2359170,Witch's Rhythm Puzzle,2023,Puzzle,"₩5,600",0%,157,39,196,54880000,150,40,190,53200000
904570,TOK,2018,Puzzle,"₩1,100",0%,257,23,280,15400000,247,24,271,14905000
1281800,Samsara Room,2020,Puzzle,Free,0%,8956,246,9202,0,0,0,0,0
2981150,Alone in the School,2024,Puzzle,"₩1,100",0%,41,6,47,2585000,42,7,49,2695000
862740,OneShift,2018,Puzzle,"₩5,600",0%,57,12,69,19320000,44,10,54,15120000
2229350,Someday You'll Return: Director's Cut,2023,Puzzle,"₩21,500",0%,179,29,208,223600000,165,32,197,211775000
2338490,Twilight Oracle,2024,Puzzle,"₩11,000",0%,102,3,105,57750000,65,4,69,37950000
1263370,Seek Girl:Fog Ⅰ,2020,Puzzle,"₩4,400",0%,3961,725,4686,1030920000,3775,719,4494,988680000
2742750,Quod: Episode 1,2024,Puzzle,"₩7,800",0%,126,21,147,57330000,110,21,131,51090000
2066950,Quadrata,2022,Puzzle,"₩3,400",0%,42,0,42,7140000,86,3,89,15130000
1799160,Math+Sticks - Coffee Break Club,2021,Puzzle,"₩2,300",0%,48,6,54,6210000,45,6,51,5865000
1471910,Killer Sudoku,2020,Puzzle,"₩5,500",0%,104,14,118,32450000,104,14,118,32450000
2845270,100 Aliens Cats,2024,Puzzle,Free,0%,0,0,0,0,1692,89,1781,0
1771130,OPEN DOOR,2023,Puzzle,"₩7,800",0%,80,20,100,39000000,68,17,85,33150000
319270,Great Permutator,2014,Puzzle,"₩7,800",0%,123,20,143,55770000,60,8,68,26520000
654910,YANKAI'S PEAK.,2017,Puzzle,"₩6,500",0%,78,8,86,27950000,78,10,88,28600000
1459910,Isolomus,2020,Puzzle,"₩1,100",0%,329,16,345,18975000,320,17,337,18535000
1377260,Miracle Sudoku,2020,Puzzle,"₩5,500",0%,156,11,167,45925000,154,12,166,45650000
494810,VR: Vacate the Room (Virtual Reality Escape),2016,Puzzle,"₩4,400",0%,212,40,252,55440000,202,38,240,52800000
1072590,Game Of Puzzles: Dragons,2019,Puzzle,"₩1,100",0%,82,8,90,4950000,72,7,79,4345000
831570,Isoland,2018,Puzzle,"₩1,100",0%,264,25,289,15895000,248,25,273,15015000
263460,Girls Like Robots,2014,Puzzle,"₩7,500",0%,197,83,280,105000000,66,16,82,30750000
1383630,Antarctica 88,2020,Puzzle,"₩6,500",0%,209,29,238,77350000,203,30,233,75725000
3681940,Hidden Cats: Rome,2025,Puzzle,"₩1,100",0%,23,2,25,1375000,33,3,36,1980000
862110,Super Jigsaw Puzzle: Cities,2018,Puzzle,"₩5,600",0%,76,5,81,22680000,72,5,77,21560000
3421860,NO.8 High School,2025,Puzzle,"₩5,600",0%,22,6,28,7840000,25,7,32,8960000
1386730,Wordle 2,2020,Puzzle,"₩32,000",0%,114,25,139,222400000,208,31,239,382400000
823580,Isoland 2 - Ashes of Time,2018,Puzzle,"₩3,400",0%,279,15,294,49980000,229,15,244,41480000
1588760,Switchball HD,2021,Puzzle,"₩14,500",0%,144,23,167,121075000,112,18,130,94250000
1020590,Space Pilgrim Academy: Reunion,2019,Puzzle,"₩2,300",0%,63,3,66,7590000,65,1,66,7590000
1096180,Ato,2020,Puzzle,"₩15,500",0%,414,12,426,330150000,304,6,310,240250000
593960,Lorelai,2019,Puzzle,"₩9,900",0%,1319,140,1459,722205000,1161,129,1290,638550000
359040,The Music Machine,2015,Puzzle,"₩5,500",0%,480,59,539,148225000,382,47,429,117975000
3668990,Legacy - Reawakening,2025,Puzzle,"₩6,700",0%,11,2,13,4355000,14,3,17,5695000
1204410,Kosmokrats,2020,Puzzle,"₩10,500",0%,102,14,116,60900000,64,10,74,38850000
2071200,The Bad Kids,2023,Puzzle,"₩3,090",70%,414,135,549,84820500,383,134,517,79876500
1217830,Khimera: Puzzle Island,2020,Puzzle,"₩5,600",0%,271,7,278,77840000,258,5,263,73640000
832320,Mighty Switch Force! Collection,2019,Puzzle,"₩20,500",0%,123,16,139,142475000,93,11,104,106600000
1102100,TINY METAL: FULL METAL RUMBLE,2019,Puzzle,"₩15,500",0%,138,28,166,128650000,130,31,161,124775000
832320,Mighty Switch Force! Collection,2019,Puzzle,"₩20,500",0%,123,16,139,142475000,93,11,104,106600000
3288510,Spacecaps,2025,Puzzle,"₩5,600",0%,8,0,8,2240000,10,0,10,2800000
402040,The Guest,2016,Puzzle,"₩10,500",0%,671,227,898,471450000,586,217,803,421575000
408520,FORM,2017,Puzzle,"₩15,500",0%,887,86,973,754075000,864,86,950,736250000
1861500,Pure Logic,2023,Puzzle,"₩4,900",0%,64,3,67,16415000,63,4,67,16415000
2966550,SpreadCheat,2025,Puzzle,"₩7,800",0%,23,1,24,9360000,25,1,26,10140000
336130,Shardlight,2016,Puzzle,"₩16,000",0%,673,73,746,596800000,588,73,661,528800000
2784250,100 Cats Mexico,2024,Puzzle,"₩1,100",0%,0,0,0,0,44,7,51,2805000
2743080,100 Capitalist Cats,2024,Puzzle,Free,0%,0,0,0,0,0,0,0,0
1036700,My Beautiful Paper Smile,2021,Puzzle,"₩15,500",0%,340,58,398,308450000,280,57,337,261175000
2352130,SuperPosition,2025,Puzzle,"₩8,900",0%,18,0,18,8010000,13,0,13,5785000
1307880,Hanoi Puzzles: Solid Match,2020,Puzzle,"₩3,400",0%,54,2,56,9520000,51,2,53,9010000
1269520,Let Me Out,2024,Puzzle,"₩12,000",0%,75,12,87,52200000,54,10,64,38400000
1168490,Rauniot,2024,Puzzle,"₩8,770",55%,116,11,127,55689500,79,10,89,39026500
2830480,Gentoo Rescue,2025,Puzzle,"₩17,200",19%,34,0,34,29240000,59,0,59,50740000
1149660,Seek Girl Ⅱ,2019,Puzzle,"₩1,100",0%,2087,481,2568,141240000,0,0,0,0
444770,Mimpi Dreams,2016,Puzzle,Free,0%,1035,68,1103,0,1067,68,1135,0
238530,Super Puzzle Platformer Deluxe,2013,Puzzle,"₩8,500",0%,449,51,500,212500000,337,33,370,157250000
1047960,TOK 2,2019,Puzzle,"₩1,100",0%,141,10,151,8305000,140,10,150,8250000
753660,AtmaSphere,2018,Puzzle,"₩4,500",0%,914,267,1181,265725000,148,32,180,40500000
337490,Four Sided Fantasy,2016,Puzzle,"₩14,210",0%,356,76,432,306936000,200,50,250,177625000
1425380,10mg :),2020,Puzzle,"₩3,300",0%,84,2,86,14190000,68,2,70,11550000
434820,Brushwood Buddies,2016,Puzzle,"₩3,300",0%,149,29,178,29370000,121,25,146,24090000
2838460,ReThink 3.5,2024,Puzzle,"₩7,800",0%,10,0,10,3900000,10,0,10,3900000
1705580,SiNKR 3,2022,Puzzle,"₩4,500",0%,24,0,24,5400000,60,5,65,14625000
434820,Brushwood Buddies,2016,Puzzle,"₩3,300",0%,149,29,178,29370000,121,25,146,24090000
337490,Four Sided Fantasy,2016,Puzzle,"₩14,210",0%,356,76,432,306936000,200,50,250,177625000
932330,Alchemia,2018,Puzzle,"₩2,300",0%,53,15,68,7820000,54,14,68,7820000
753660,AtmaSphere,2018,Puzzle,"₩4,500",0%,914,267,1181,265725000,148,32,180,40500000
2093900,Island Cities - Jigsaw Puzzle,2022,Puzzle,"₩2,300",0%,203,12,215,24725000,184,10,194,22310000
3797690,WordScoop With Gelato the Otter,2025,Puzzle,"₩6,700",0%,0,0,0,0,13,0,13,4355000
2235150,Brain Show: Party Game,2023,Puzzle,"₩15,920",0%,142,52,194,154424000,118,42,160,127360000
867150,InFlux Redux,2024,Puzzle,"₩21,500",0%,79,0,79,84925000,76,0,76,81700000
3141130,100 Italy Cats,2025,Puzzle,"₩2,300",0%,0,0,0,0,18,8,26,2990000
1608660,Overhaul,2022,Puzzle,"₩12,500",0%,78,7,85,53125000,71,7,78,48750000
2550630,808s&Genetics,2023,Puzzle,"₩2,300",0%,67,1,68,7820000,64,1,65,7475000
255390,Max: The Curse of Brotherhood,2014,Puzzle,"₩16,000",0%,1483,86,1569,1255200000,1362,87,1449,1159200000
1044220,Oik Reloaded,2020,Puzzle,"₩1,100",0%,88,9,97,5335000,77,10,87,4785000
3558310,Bring the Book back,2025,Puzzle,"₩3,370",25%,13,1,14,2359000,11,1,12,2022000
700160,Semblance,2018,Puzzle,"₩11,000",0%,326,54,380,209000000,256,49,305,167750000
723270,Rumu,2017,Puzzle,"₩10,500",0%,509,53,562,295050000,464,57,521,273525000
1460610,hocus 2,2021,Puzzle,"₩3,300",0%,59,10,69,11385000,57,8,65,10725000
494720,Morphblade,2017,Puzzle,"₩5,500",0%,513,47,560,154000000,238,15,253,69575000
1249010,ISOLAND3: Dust of the Universe,2020,Puzzle,"₩3,300",0%,206,19,225,37125000,194,19,213,35145000
277680,"About Love, Hate and the other ones",2014,Puzzle,"₩8,900",0%,751,86,837,372465000,561,62,623,277235000
1067310,Gravitas,2019,Puzzle,Free,0%,6738,137,6875,0,0,0,0,0
1258310,Mushroom Cats 2,2020,Puzzle,"₩1,100",0%,548,13,561,30855000,495,15,510,28050000
1334040,Paper Dolls 2 纸人贰,2020,Puzzle,"₩10,590",0%,2262,431,2693,1425943500,2062,393,2455,1299922500
1295740,Mine Dungeon2 ~Rurumu's trip~,2020,Puzzle,"₩10,500",0%,19,3,22,11550000,12,3,15,7875000
1258310,Mushroom Cats 2,2020,Puzzle,"₩1,100",0%,548,13,561,30855000,495,15,510,28050000
3081060,ISOLAND PUMPKIN TOWN,2025,Puzzle,"₩2,300",0%,0,0,0,0,29,5,34,3910000
2954560,100 Forest Cats,2025,Puzzle,"₩1,100",0%,0,0,0,0,44,15,59,3245000
1250560,Chess Sudoku,2020,Puzzle,"₩5,500",0%,173,6,179,49225000,166,7,173,47575000
1053250,TOK HARDCORE,2019,Puzzle,"₩1,100",0%,131,8,139,7645000,127,8,135,7425000
903630,The Last Cube,2022,Puzzle,"₩20,500",0%,132,3,135,138375000,111,3,114,116850000
1787160,Cupid Nonogram,2021,Puzzle,"₩3,300",0%,120,7,127,20955000,97,7,104,17160000
1300310,Move Code Lines,2020,Puzzle,"₩6,500",0%,69,13,82,26650000,69,14,83,26975000
1671280,Prognostic,2022,Puzzle,"₩7,500",0%,434,26,460,172500000,381,24,405,151875000
2707300,Cosmic Collapse,2024,Puzzle,"₩5,600",0%,102,1,103,28840000,97,2,99,27720000
1316700,Escape from Kyoto House,2020,Puzzle,"₩5,600",0%,148,12,160,44800000,112,11,123,34440000
2056880,Mystery of Mortlake Mansion,2022,Puzzle,"₩9,900",0%,73,10,83,41085000,64,11,75,37125000
2775180,101 Cats Hidden,2024,Puzzle,"₩1,100",0%,0,0,0,0,168,30,198,10890000
108500,Vessel,2012,Puzzle,"₩5,600",0%,699,97,796,222880000,358,49,407,113960000
527710,Crown Champion: Legends of the Arena,2016,Puzzle,"₩5,600",0%,211,51,262,73360000,158,32,190,53200000
2731230,Jewel Match Origins 3 - Camelot Castle Collector's Edition,2024,Puzzle,"₩15,500",0%,15,2,17,13175000,14,2,16,12400000
1334040,Paper Dolls 2 纸人贰,2020,Puzzle,"₩10,590",0%,2262,431,2693,1425943500,2062,393,2455,1299922500
1188900,Fire Tonight,2021,Puzzle,"₩6,500",0%,82,14,96,31200000,71,13,84,27300000
944920,Nanotale - Typing Chronicles,2021,Puzzle,"₩20,500",0%,602,172,774,793350000,505,151,656,672400000
894620,ATONE: Heart of the Elder Tree,2023,Puzzle,"₩7,300",0%,111,19,130,47450000,73,9,82,29930000
386900,The Cat Machine,2015,Puzzle,"₩15,500",0%,136,9,145,112375000,110,10,120,93000000
402260,Dead Secret,2016,Puzzle,"₩15,500",0%,475,108,583,451825000,383,90,473,366575000
2740260,Stickin' the Landing,2024,Puzzle,"₩4,450",50%,25,0,25,5562500,24,0,24,5340000
1575510,Seedlings,2023,Puzzle,"₩11,000",0%,58,0,58,31900000,51,0,51,28050000
2023050,Lighthouse Keeper,2022,Puzzle,"₩12,310",0%,347,100,447,275128500,264,58,322,198191000
1575510,Seedlings,2023,Puzzle,"₩11,000",0%,58,0,58,31900000,51,0,51,28050000
1171370,The Supper,2020,Puzzle,Free,0%,4064,57,4121,0,0,0,0,0
2740260,Stickin' the Landing,2024,Puzzle,"₩4,450",50%,25,0,25,5562500,24,0,24,5340000
981260,Love In Drawing,2019,Puzzle,"₩2,300",0%,202,34,236,27140000,192,34,226,25990000
255320,Edna & Harvey: The Breakout,2013,Puzzle,"₩16,000",0%,1396,229,1625,1300000000,1148,203,1351,1080800000
851730,Sandmade,2018,Puzzle,"₩1,100",0%,196,18,214,11770000,193,21,214,11770000
2412700,It Is Ticking,2023,Puzzle,"₩9,830",0%,58,3,61,29981500,54,3,57,28015500
1184900,Unitied,2019,Puzzle,"₩1,100",0%,51,1,52,2860000,49,1,50,2750000
1766540,Wonderputt Forever,2022,Puzzle,"₩11,000",0%,104,17,121,66550000,83,15,98,53900000
293740,Road Not Taken,2014,Puzzle,"₩16,500",0%,280,67,347,286275000,195,49,244,201300000
703500,ReThink | Evolved,2017,Puzzle,"₩11,000",0%,67,9,76,41800000,66,9,75,41250000
447780,LostWinds,2016,Puzzle,"₩10,500",0%,578,130,708,371700000,448,92,540,283500000
2569280,Below Nowhere,2025,Puzzle,"₩16,500",0%,11,2,13,10725000,9,3,12,9900000
677020,Eventide 3: Legacy of Legends,2017,Puzzle,"₩16,500",0%,237,44,281,231825000,168,37,205,169125000
2402170,Veggie Quest: The Puzzle Game,2024,Puzzle,"₩21,500",0%,52,3,55,59125000,51,3,54,58050000
2672770,Hexle,2023,Puzzle,"₩6,700",0%,34,0,34,11390000,20,1,21,7035000
1352200,Detective From The Crypt,2021,Puzzle,"₩11,000",0%,129,8,137,75350000,118,6,124,68200000
211360,Offspring Fling!,2012,Puzzle,"₩8,500",0%,489,106,595,252875000,122,15,137,58225000
2097180,OxU,2022,Puzzle,"₩2,300",0%,21,0,21,2415000,208,2,210,24150000
292910,Deponia: The Complete Journey,2014,Puzzle,"₩37,000",0%,5613,931,6544,12106400000,0,0,0,0
976700,Size Matters,2021,Puzzle,"₩11,000",0%,412,61,473,260150000,130,14,144,79200000
2174720,The Will of Arthur Flabbington,2023,Puzzle,"₩13,500",0%,153,4,157,105975000,104,7,111,74925000
1548820,Happy Puzzle,2021,Puzzle,"₩2,300",0%,302,45,347,39905000,289,43,332,38180000
575680,Square n Fair,2017,Puzzle,"₩4,500",0%,161,31,192,43200000,127,22,149,33525000
3146640,Abnormal1999:The Compass and the Sand,2024,Puzzle,"₩3,400",0%,89,1,90,15300000,80,2,82,13940000
1548820,Happy Puzzle,2021,Puzzle,"₩2,300",0%,302,45,347,39905000,289,43,332,38180000
471920,Pan-Pan,2016,Puzzle,"₩21,500",0%,207,33,240,258000000,170,32,202,217150000
3110490,Pixel Restorer,2024,Puzzle,Free,0%,0,0,0,0,129,14,143,0
255340,Escape Goat 2,2014,Puzzle,"₩10,500",0%,422,19,441,231525000,198,8,206,108150000
2562350,Escape Escape,2023,Puzzle,"₩1,100",0%,61,10,71,3905000,57,12,69,3795000
546490,Heart and Seoul,2016,Puzzle,₩850,75%,45,53,98,4165000,23,21,44,1870000
292910,Deponia: The Complete Journey,2014,Puzzle,"₩37,000",0%,5613,931,6544,12106400000,0,0,0,0
323380,The Magic Circle,2015,Puzzle,"₩21,500",0%,1364,112,1476,1586700000,963,95,1058,1137350000
2100720,Rat Cage,2023,Puzzle,"₩11,000",0%,25,5,30,16500000,23,5,28,15400000
1220370,Ever Forward,2020,Puzzle,"₩15,500",0%,223,47,270,209250000,107,36,143,110825000
1012840,Moons of Madness,2019,Puzzle,"₩27,500",0%,2130,618,2748,3778500000,0,0,0,0
1417890,Catie in MeowmeowLand,2022,Puzzle,"₩15,500",0%,149,12,161,124775000,109,7,116,89900000
464900,Pitfall Planet,2016,Puzzle,"₩11,000",0%,92,1,93,51150000,88,2,90,49500000
741520,Professor Lupo and his Horrible Pets,2019,Puzzle,"₩15,500",0%,50,3,53,41075000,33,1,34,26350000
695110,Twickles,2017,Puzzle,"₩7,500",0%,121,11,132,49500000,71,2,73,27375000
693700,Prime Mover,2018,Puzzle,"₩15,500",0%,182,22,204,158100000,149,20,169,130975000
3464820,Jewel Match Solitaire Fantasy - Collector's Edition,2025,Puzzle,"₩15,500",0%,0,0,0,0,20,3,23,17825000
1320950,The Swine,2020,Puzzle,"₩2,300",0%,246,54,300,34500000,233,55,288,33120000
1852830,SPACE ACCIDENT,2022,Puzzle,"₩8,350",0%,154,47,201,83917500,117,27,144,60120000
1343260,I dream of you and ice cream,2020,Puzzle,"₩5,600",0%,53,3,56,15680000,49,3,52,14560000
270010,Time Rifters,2014,Puzzle,"₩10,500",0%,387,51,438,229950000,333,50,383,201075000
1601860,Warp Factory,2021,Puzzle,"₩10,500",0%,43,3,46,24150000,43,3,46,24150000
284460,DeadCore,2014,Puzzle,"₩10,500",0%,1726,305,2031,1066275000,1360,221,1581,830025000
307230,"I, Zombie",2014,Puzzle,"₩2,300",0%,2147,410,2557,294055000,0,0,0,0
1109410,Perspective,2019,Puzzle,Free,0%,1226,23,1249,0,1274,26,1300,0
2299660,Fossilfuel 2,2024,Puzzle,"₩21,500",0%,107,30,137,147275000,101,29,130,139750000
1188460,Gravity Escape,2024,Puzzle,"₩7,800",0%,18,0,18,7020000,15,0,15,5850000
2697430,Dexterous: Time to Steal,2024,Puzzle,"₩11,000",0%,9,0,9,4950000,10,0,10,5500000
361550,Cradle,2015,Puzzle,"₩2,800",80%,1382,573,1955,273700000,1275,547,1822,255080000
318840,Tempopo,2025,Puzzle,"₩21,500",0%,43,1,44,47300000,35,1,36,38700000
1404190,Chess Brain,2020,Puzzle,"₩1,100",0%,135,14,149,8195000,128,16,144,7920000
1348160,Turn on the light,2020,Puzzle,₩710,35%,168,8,176,6248000,158,8,166,5893000
2733920,Cat Search in Feudal Japan,2024,Puzzle,"₩1,100",0%,86,3,89,4895000,84,4,88,4840000
718080,Artifact Quest 2 - Match 3 Puzzle,2017,Puzzle,"₩4,500",40%,46,7,53,11925000,42,8,50,11250000
1110770,"About Love, Hate And The Other Ones 2",2020,Puzzle,"₩12,500",0%,43,2,45,28125000,34,2,36,22500000
57200,Puzzle Dimension,2010,Puzzle,"₩11,000",0%,438,50,488,268400000,394,44,438,240900000
350070,Environmental Station Alpha,2015,Puzzle,"₩8,500",0%,1228,242,1470,624750000,1132,232,1364,579700000
2784140,100 Cats London,2025,Puzzle,"₩2,300",0%,0,0,0,0,44,2,46,5290000
853410,YAPP2: Yet Another Pushing Puzzler,2018,Puzzle,"₩2,300",0%,15,1,16,1840000,12,1,13,1495000
1906130,Yum Collector,2022,Puzzle,"₩5,500",0%,21,2,23,6325000,16,2,18,4950000
282760,Circuits,2014,Puzzle,"₩5,500",0%,1862,233,2095,576125000,1493,185,1678,461450000
2999910,Everlasting: Tomorrow,2024,Puzzle,"₩11,000",0%,22,0,22,12100000,23,0,23,12650000
453720,Last Will,2016,Puzzle,"₩9,500",0%,283,87,370,175750000,170,57,227,107825000
2247680,Read Clock Time,2022,Puzzle,"₩1,100",0%,57,6,63,3465000,51,3,54,2970000
211180,Unmechanical,2012,Puzzle,"₩10,500",0%,426,36,462,242550000,278,24,302,158550000
2597210,Welcome teacher,2023,Puzzle,"₩1,100",0%,15,1,16,880000,14,2,16,880000
284950,Pixel Puzzles: Japan,2014,Puzzle,Free,0%,2135,499,2634,0,0,0,0,0
1105110,OXXO,2019,Puzzle,"₩2,300",0%,255,13,268,30820000,250,13,263,30245000
1101270,Anime Artist,2019,Puzzle,"₩2,300",0%,151,33,184,21160000,136,30,166,19090000
2597210,Welcome teacher,2023,Puzzle,"₩1,100",0%,15,1,16,880000,14,2,16,880000
453720,Last Will,2016,Puzzle,"₩9,500",0%,283,87,370,175750000,170,57,227,107825000
376520,Kelvin and the Infamous Machine,2016,Puzzle,"₩11,000",0%,866,91,957,526350000,707,79,786,432300000
613470,The Inner World - The Last Wind Monk,2017,Puzzle,"₩2,150",90%,434,53,487,52352500,365,50,415,44612500
211180,Unmechanical,2012,Puzzle,"₩10,500",0%,426,36,462,242550000,278,24,302,158550000
598070,Nevrosa: Prelude,2017,Puzzle,Free,0%,192,29,221,0,190,31,221,0
599560,Ghost Files: The Face of Guilt,2017,Puzzle,"₩4,120",75%,228,89,317,65302000,156,60,216,44496000
994340,Cat and Ghostly Road,2020,Puzzle,"₩11,000",0%,192,10,202,111100000,169,13,182,100100000
1328810,Shoot. Push. Repeat.,2020,Puzzle,"₩1,100",0%,56,10,66,3630000,56,12,68,3740000
1188330,Classic Sudoku,2019,Puzzle,"₩5,500",0%,424,35,459,126225000,423,37,460,126500000
284950,Pixel Puzzles: Japan,2014,Puzzle,Free,0%,2135,499,2634,0,0,0,0,0
1823730,Alephant,2023,Puzzle,"₩11,000",0%,44,2,46,25300000,40,2,42,23100000
2659900,Sixty Four,2024,Puzzle,"₩6,700",0%,1135,377,1512,506520000,1099,406,1505,504175000
700520,Shift Quantum - A Cyber Noir Puzzle Platformer,2018,Puzzle,"₩20,500",0%,65,6,71,72775000,38,4,42,43050000
301150,The Treasures of Montezuma 4,2014,Puzzle,"₩7,800",0%,524,122,646,251940000,492,123,615,239850000
1810270,Blood Nova,2022,Puzzle,"₩11,000",0%,99,8,107,58850000,69,8,77,42350000
701470,TTV2,2015,Puzzle,"₩1,100",0%,161,17,178,9790000,446,91,537,29535000
492180,Haimrik,2018,Puzzle,"₩11,000",0%,232,48,280,154000000,106,17,123,67650000
2429100,Homestar Runner: Halloween Hide n' Seek,2023,Puzzle,"₩2,300",0%,114,0,114,13110000,114,0,114,13110000
1879040,Mycosis,2023,Puzzle,"₩5,000",60%,16,1,17,4250000,14,1,15,3750000
385330,Stray Cat Crossing,2015,Puzzle,"₩3,300",0%,598,43,641,105765000,498,38,536,88440000
944710,TurnTack,2021,Puzzle,"₩8,900",0%,40,6,46,20470000,27,5,32,14240000
63650,URU: Complete Chronicles,2010,Puzzle,"₩11,000",0%,133,37,170,93500000,125,35,160,88000000
727640,ШП - ShP,2017,Puzzle,"₩2,200",0%,148,53,201,22110000,116,22,138,15180000
745250,YAPP: Yet Another Puzzle Platformer,2017,Puzzle,"₩2,300",0%,52,7,59,6785000,44,7,51,5865000
3320930,Paranormal Night Shift,2025,Puzzle,"₩4,500",0%,104,4,108,24300000,61,6,67,15075000
745250,YAPP: Yet Another Puzzle Platformer,2017,Puzzle,"₩2,300",0%,52,7,59,6785000,44,7,51,5865000
2469610,Forklift Simulator 2023,2023,Puzzle,"₩8,900",0%,47,16,63,28035000,46,20,66,29370000
355680,Overland,2019,Puzzle,"₩21,500",0%,384,136,520,559000000,336,118,454,488050000
1084480,Wanna Survive,2019,Puzzle,"₩12,500",0%,274,18,292,182500000,245,21,266,166250000
731940,Bars and Balance,2017,Puzzle,"₩2,300",0%,73,10,83,9545000,53,9,62,7130000
1399300,SOK PRO,2020,Puzzle,"₩5,600",0%,54,5,59,16520000,49,4,53,14840000
1025130,Oik Memory 3,2019,Puzzle,"₩1,100",0%,79,8,87,4785000,70,10,80,4400000
328730,Letter Quest: Grimm's Journey,2014,Puzzle,Unknown,0%,387,28,415,0,202,8,210,0
447800,LostWinds 2: Winter of the Melodias,2016,Puzzle,"₩10,500",0%,264,55,319,167475000,242,39,281,147525000
2133400,1989 QianShanMen,2023,Puzzle,"₩3,400",0%,44,3,47,7990000,45,2,47,7990000
216290,Gateways,2012,Puzzle,"₩5,500",0%,222,25,247,67925000,168,19,187,51425000
1525890,Death Park 2,2021,Puzzle,"₩6,500",0%,170,19,189,61425000,159,20,179,58175000
840230,Chicken ~Boiled Egg~,2018,Puzzle,"₩8,500",0%,13,1,14,5950000,9,1,10,4250000
447240,Zasa - An AI Story,2016,Puzzle,"₩1,100",0%,133,10,143,7865000,60,4,64,3520000
2656520,Mycelium Heaven,2025,Puzzle,"₩11,000",0%,33,3,36,19800000,20,0,20,11000000
869840,羽翼的祈愿 - Feather Of Praying,2018,Puzzle,"₩2,300",0%,264,10,274,31510000,254,11,265,30475000
61600,Zen Bound 2,2010,Puzzle,"₩5,600",0%,497,80,577,161560000,255,28,283,79240000
3026480,You Have To Climb Out,2024,Puzzle,"₩2,300",0%,53,2,55,6325000,48,2,50,5750000
300300,Ichi,2014,Puzzle,"₩5,500",0%,556,94,650,178750000,367,65,432,118800000
604780,aMAZE,2017,Puzzle,"₩2,300",0%,590,125,715,82225000,548,120,668,76820000
2053580,Nonozle,2022,Puzzle,"₩4,400",0%,43,0,43,9460000,40,0,40,8800000
1859580,Full Void,2023,Puzzle,"₩13,500",0%,216,22,238,160650000,198,22,220,148500000
2835590,8AM,2024,Puzzle,"₩4,500",0%,70,15,85,19125000,73,16,89,20025000
1389560,Paint Girl,2020,Puzzle,"₩2,200",0%,661,119,780,85800000,633,121,754,82940000
1068460,Stuffo the Puzzle Bot,2023,Puzzle,"₩11,000",0%,143,0,143,78650000,122,1,123,67650000
2824230,last seen online,2024,Puzzle,Free,0%,0,0,0,0,1708,35,1743,0
2737140,Slayaway Camp 2,2024,Puzzle,"₩14,500",0%,53,3,56,40600000,34,3,37,26825000
1566230,Turn on all the lights,2021,Puzzle,₩710,35%,84,6,90,3195000,77,7,84,2982000
1389560,Paint Girl,2020,Puzzle,"₩2,200",0%,661,119,780,85800000,633,121,754,82940000
1859580,Full Void,2023,Puzzle,"₩13,500",0%,216,22,238,160650000,198,22,220,148500000
361850,Portal of Evil: Stolen Runes Collector's Edition,2015,Puzzle,"₩5,600",0%,451,42,493,138040000,336,33,369,103320000
2835590,8AM,2024,Puzzle,"₩4,500",0%,70,15,85,19125000,73,16,89,20025000
1797930,Para Eyes,2025,Puzzle,"₩10,500",0%,129,5,134,70350000,114,6,120,63000000
340280,Cubot,2015,Puzzle,"₩2,200",0%,250,26,276,30360000,169,21,190,20900000
1587710,Fossil Corner,2021,Puzzle,"₩10,500",0%,298,5,303,159075000,285,6,291,152775000
1934080,Floating Life2,2023,Puzzle,"₩20,500",0%,473,327,800,820000000,326,300,626,641650000
699700,DYING: Reborn,2018,Puzzle,"₩13,500",0%,165,50,215,145125000,125,48,173,116775000
1542810,Sunshine Heavy Industries,2021,Puzzle,"₩15,500",0%,379,4,383,296825000,359,7,366,283650000
751980,Box Cats Puzzle,2020,Puzzle,"₩3,400",0%,96,4,100,17000000,83,5,88,14960000
510490,The Fall Part 2: Unbound,2018,Puzzle,"₩17,500",0%,540,125,665,581875000,488,122,610,533750000
2885620,Hidden Capybaras with Orange in the Whimsical Library,2024,Puzzle,"₩2,300",0%,0,0,0,0,62,1,63,7245000
1014280,The Devil's Calculator,2019,Puzzle,"₩3,300",0%,113,5,118,19470000,84,4,88,14520000
2207540,Pages of Time: Prologue,2022,Puzzle,Free,0%,0,0,0,0,2658,82,2740,0
1832130,VINE,2023,Puzzle,"₩15,000",0%,47,11,58,43500000,31,8,39,29250000
565120,The Station,2018,Puzzle,"₩15,500",0%,912,151,1063,823825000,812,132,944,731600000
816490,Hidden Paws,2018,Puzzle,"₩3,300",0%,731,126,857,141405000,676,129,805,132825000
2231040,Coloring Game: Studio,2024,Puzzle,"₩27,000",0%,0,0,0,0,122,3,125,168750000
3208550,Who Dies First ?,2024,Puzzle,"₩4,900",0%,26,1,27,6615000,19,1,20,4900000
611980,Oik 2,2017,Puzzle,"₩1,100",0%,1246,89,1335,73425000,1166,88,1254,68970000
242820,140,2013,Puzzle,"₩5,600",0%,4257,347,4604,1289120000,0,0,0,0
1014280,The Devil's Calculator,2019,Puzzle,"₩3,300",0%,113,5,118,19470000,84,4,88,14520000
2025610,Once Again,2022,Puzzle,"₩4,500",0%,850,77,927,208575000,779,77,856,192600000
2675900,Dear Flower,2024,Puzzle,"₩11,000",0%,0,0,0,0,11,1,12,6600000
1121530,Globesweeper: Hex Puzzler,2019,Puzzle,"₩8,900",0%,163,19,182,80990000,170,21,191,84995000
754520,Animals Memory,2017,Puzzle,"₩5,600",0%,62,13,75,21000000,52,12,64,17920000
867050,Endless Fables 3: Dark Moor,2018,Puzzle,"₩15,500",0%,178,26,204,158100000,106,20,126,97650000
3452270,Secret Paws - Cozy Offices,2025,Puzzle,Free,0%,0,0,0,0,48,4,52,0
1613050,Flex hooks,2021,Puzzle,₩710,35%,53,4,57,2023500,53,6,59,2094500
822830,Ouroboros,2018,Puzzle,"₩5,500",0%,130,8,138,37950000,127,8,135,37125000
2776810,100 Ninja Cats,2024,Puzzle,Free,0%,0,0,0,0,0,0,0,0
2708280,ESCAPE FROM BOYKISSER,2024,Puzzle,"₩2,300",0%,0,0,0,0,663,198,861,99015000
3806560,101 Cats Hidden in Medina,2025,Puzzle,"₩1,100",0%,0,0,0,0,19,1,20,1100000
1789180,Zoo Seeker,2022,Puzzle,"₩6,500",0%,25,1,26,8450000,20,0,20,6500000
453830,Innoquous 5,2016,Puzzle,"₩1,100",0%,69,10,79,4345000,64,10,74,4070000
1531490,Harmony's Odyssey,2022,Puzzle,"₩15,500",0%,477,35,512,396800000,246,19,265,205375000
845270,Mirror Drop,2018,Puzzle,"₩8,500",0%,68,5,73,31025000,60,5,65,27625000
1247020,Lovingly Evil,2020,Puzzle,"₩13,500",0%,100,15,115,77625000,83,15,98,66150000
2323660,Headlong Hunt,2023,Puzzle,"₩13,500",0%,45,0,45,30375000,40,0,40,27000000
1283500,Euphoria: Supreme Mechanics,2020,Puzzle,"₩10,780",0%,100,37,137,73843000,92,21,113,60907000
2243510,qomp2,2024,Puzzle,"₩10,750",50%,14,3,17,9137500,11,5,16,8600000
1104660,MO:Astray,2019,Puzzle,"₩17,800",0%,4530,404,4934,4391260000,0,0,0,0
2165740,SokoFrog,2022,Puzzle,"₩2,300",0%,81,4,85,9775000,79,5,84,9660000
543040,ZHED - Puzzle Game,2020,Puzzle,"₩3,950",0%,24,0,24,4740000,12,0,12,2370000
347430,Frankenstein: Master of Death,2015,Puzzle,"₩5,500",0%,1668,330,1998,549450000,1383,304,1687,463925000
543040,ZHED - Puzzle Game,2020,Puzzle,"₩3,950",0%,24,0,24,4740000,12,0,12,2370000
290510,GNOG,2018,Puzzle,"₩11,000",0%,929,80,1009,554950000,366,32,398,218900000
204180,Waveform,2012,Puzzle,"₩1,000",0%,1774,369,2143,107150000,1560,319,1879,93950000
2992740,Towerheart,2024,Puzzle,"₩2,300",0%,30,0,30,3450000,20,0,20,2300000
1214060,TRIOS - lofi beats / numbers to chill to,2021,Puzzle,"₩8,900",0%,40,4,44,19580000,39,2,41,18245000
1104660,MO:Astray,2019,Puzzle,"₩17,800",0%,4530,404,4934,4391260000,0,0,0,0
2761130,RoboSync,2024,Puzzle,"₩3,400",0%,33,0,33,5610000,17,0,17,2890000
996180,Cryptofall: Investor simulator,2020,Puzzle,"₩5,500",0%,45,7,52,14300000,42,8,50,13750000
2667750,Hungry Cats 饥饿的猫,2023,Puzzle,"₩3,400",0%,0,0,0,0,9,2,11,1870000
344480,Quell,2015,Puzzle,"₩4,400",0%,426,12,438,96360000,300,9,309,67980000
390610,Circa Infinity,2015,Puzzle,"₩12,500",0%,253,19,272,170000000,212,18,230,143750000
1121230,Bomb Bowling,2019,Puzzle,"₩5,600",0%,27,2,29,8120000,26,1,27,7560000
2057610,Soul Link,2024,Puzzle,"₩6,700",0%,23,0,23,7705000,15,0,15,5025000
485640,Genius Greedy Mouse,2016,Puzzle,Free,0%,86,19,105,0,87,19,106,0
690740,BOOKS,2017,Puzzle,"₩1,100",0%,114,68,182,10010000,107,66,173,9515000
3227640,Sorting Inc,2025,Puzzle,"₩5,600",0%,32,1,33,9240000,44,2,46,12880000
1339900,BOT.vinnik Chess: Combination Lessons,2020,Puzzle,"₩1,730",0%,108,11,119,10293500,106,9,115,9947500
2576600,Bottle Can Float,2023,Puzzle,"₩4,500",0%,76,9,85,19125000,62,9,71,15975000
1285020,Flipon,2020,Puzzle,"₩4,500",0%,113,8,121,27225000,103,9,112,25200000
2746220,Popmoji,2024,Puzzle,"₩3,400",0%,34,2,36,6120000,27,1,28,4760000
1070220,Detective Kobayashi - A Visual Novel,2019,Puzzle,"₩14,500",0%,26,3,29,21025000,15,3,18,13050000
456430,Christmas Adventure: Candy Storm,2016,Puzzle,"₩2,300",0%,382,42,424,48760000,345,38,383,44045000
3192950,The Pane Puzzle,2024,Puzzle,"₩3,400",0%,18,1,19,3230000,16,1,17,2890000
546090,Trip to Vinelands,2015,Puzzle,"₩1,100",0%,197,27,224,12320000,517,98,615,33825000
3072060,101 Cats Hidden in Las Vegas,2024,Puzzle,"₩1,100",0%,0,0,0,0,55,6,61,3355000
388420,In Between,2015,Puzzle,"₩13,000",0%,388,71,459,298350000,122,21,143,92950000
535000,EXIT,2016,Puzzle,"₩8,900",0%,52,5,57,25365000,34,5,39,17355000
3236280,Flocking Hell,2025,Puzzle,"₩8,800",19%,0,0,0,0,36,3,39,17160000
2074810,8-Bit Farm,2022,Puzzle,"₩12,000",0%,25,13,38,22800000,17,13,30,18000000
977570,The Experiment: Escape Room,2018,Puzzle,"₩4,500",0%,142,124,266,59850000,124,110,234,52650000
1239050,Mists of Aiden,2020,Puzzle,"₩7,500",0%,1026,95,1121,420375000,871,97,968,363000000
1259370,Worm Jazz,2020,Puzzle,"₩7,500",0%,18,0,18,6750000,12,0,12,4500000
757300,Truberbrook / Trüberbrook,2019,Puzzle,"₩27,930",48%,1558,588,2146,2996889000,991,367,1358,1896447000
1601410,FARAWAY TRAIN,2021,Puzzle,"₩19,510",0%,20,6,26,25363000,21,5,26,25363000
569810,LEAVES - The Return,2017,Puzzle,"₩5,600",0%,320,62,382,106960000,267,43,310,86800000
1703230,Colors!,2021,Puzzle,"₩1,100",0%,78,12,90,4950000,68,12,80,4400000
2845250,100 Istanbul Cats,2024,Puzzle,Free,0%,0,0,0,0,1554,341,1895,0
286300,Algo Bot,2018,Puzzle,"₩10,500",0%,145,30,175,91875000,118,24,142,74550000
460340,Guards,2016,Puzzle,"₩5,500",0%,399,69,468,128700000,215,44,259,71225000
3282710,Put the Sausage in the Bun,2024,Puzzle,"₩9,900",0%,14,2,16,7920000,13,1,14,6930000
857460,∀kashicforce,2019,Puzzle,"₩14,500",0%,31,5,36,26100000,20,3,23,16675000
205910,Tiny and Big: Grandpa's Leftovers,2012,Puzzle,"₩13,500",0%,3766,345,4111,2774925000,0,0,0,0
1944780,Jewel Match Solitaire X Collector's Edition,2022,Puzzle,"₩13,500",0%,31,6,37,24975000,31,6,37,24975000
3369390,PENGUIN HOTEL 2 -Snake Penguin Ambition-,2025,Puzzle,"₩11,000",0%,22,0,22,12100000,19,0,19,10450000
407780,Lethe - Episode One,2016,Puzzle,"₩16,000",0%,325,58,383,306400000,248,37,285,228000000
3806570,101 Cats Hidden in Osaka,2025,Puzzle,"₩1,100",0%,0,0,0,0,17,1,18,990000
574310,The Mooseman,2017,Puzzle,"₩8,900",0%,993,127,1120,498400000,827,102,929,413405000
1221800,Anime Artist 2: Lovely Danya,2020,Puzzle,"₩2,300",0%,93,9,102,11730000,91,9,100,11500000
1953970,MATH EXPRESSions,2022,Puzzle,Free,0%,0,0,0,0,188,33,221,0
872110,Burden of Proof,2018,Puzzle,"₩16,500",0%,31,4,35,28875000,29,4,33,27225000
1221800,Anime Artist 2: Lovely Danya,2020,Puzzle,"₩2,300",0%,93,9,102,11730000,91,9,100,11500000
872110,Burden of Proof,2018,Puzzle,"₩16,500",0%,31,4,35,28875000,29,4,33,27225000
720660,Overloop,2022,Puzzle,"₩12,500",0%,205,15,220,137500000,96,8,104,65000000
477310,Space Hole 2016,2016,Puzzle,"₩1,100",0%,71,14,85,4675000,62,9,71,3905000
1979700,Logica Emotica,2022,Puzzle,"₩3,300",0%,13,2,15,2475000,15,2,17,2805000
3370120,Block Puzzle,2024,Puzzle,"₩2,300",0%,0,0,0,0,13,1,14,1610000
1837820,Faded Stories: Greenberg,2022,Puzzle,"₩1,950",75%,43,4,47,4582500,42,4,46,4485000
751220,ETHEREAL,2019,Puzzle,"₩10,500",0%,144,19,163,85575000,76,9,85,44625000
1974230,Locks,2025,Puzzle,"₩12,000",0%,44,7,51,30600000,36,7,43,25800000
340800,Unhack,2015,Puzzle,"₩4,400",0%,262,43,305,67100000,129,8,137,30140000
754890,Firmament,2023,Puzzle,"₩37,500",0%,1054,424,1478,2771250000,580,237,817,1531875000
211440,Adventures of Shuggy,2012,Puzzle,"₩5,500",0%,1025,174,1199,329725000,252,31,283,77825000
786820,SOK MAX,2018,Puzzle,"₩1,860",0%,64,10,74,6882000,63,9,72,6696000
574310,The Mooseman,2017,Puzzle,"₩8,900",0%,993,127,1120,498400000,827,102,929,413405000
1060670,Taboos: Cracks,2019,Puzzle,"₩1,100",0%,1377,358,1735,95425000,1274,319,1593,87615000
281750,Munin,2014,Puzzle,"₩5,600",0%,772,167,939,262920000,623,137,760,212800000
3185600,No Arm,2024,Puzzle,"₩4,500",0%,17,1,18,4050000,15,1,16,3600000
748020,TERRACOTTA,2022,Puzzle,"₩21,500",0%,87,19,106,113950000,62,16,78,83850000
1580570,Blokker,2021,Puzzle,"₩2,200",0%,55,3,58,6380000,54,3,57,6270000
900790,Bunny Minesweeper,2018,Puzzle,"₩3,300",0%,66,15,81,13365000,51,10,61,10065000
2809460,Terminal ESC,2024,Puzzle,"₩1,700",50%,11,1,12,1020000,13,0,13,1105000
1303740,Love n Dream,2020,Puzzle,"₩3,400",0%,296,88,384,65280000,276,87,363,61710000
2612680,Cureocity,2024,Puzzle,Free,0%,2630,45,2675,0,0,0,0,0
812160,Etherborn,2019,Puzzle,"₩18,500",0%,313,117,430,397750000,76,21,97,89725000
2809920,Drop Mahjong tiles,2024,Puzzle,"₩4,500",0%,24,16,40,9000000,21,16,37,8325000
288060,Whispering Willows,2014,Puzzle,"₩10,500",0%,1482,321,1803,946575000,963,226,1189,624225000
1145410,Knight Swap,2019,Puzzle,"₩1,100",0%,124,16,140,7700000,105,13,118,6490000
1303740,Love n Dream,2020,Puzzle,"₩3,400",0%,296,88,384,65280000,276,87,363,61710000
2809920,Drop Mahjong tiles,2024,Puzzle,"₩4,500",0%,24,16,40,9000000,21,16,37,8325000
546080,Coffin of Ashes,2016,Puzzle,"₩7,800",0%,743,68,811,316290000,707,61,768,299520000
1683720,Hungry Fish,2021,Puzzle,₩550,50%,25,6,31,852500,19,3,22,605000
563550,Nevrosa: Escape,2017,Puzzle,"₩16,500",0%,92,22,114,94050000,82,22,104,85800000
2851020,Hannah’s Day,2024,Puzzle,"₩14,500",0%,71,6,77,55825000,58,4,62,44950000
2570630,20 Small Mazes,2024,Puzzle,Free,0%,0,0,0,0,0,0,0,0
1799560,Larry The Unlucky Part 3,2021,Puzzle,"₩2,200",0%,45,8,53,5830000,45,9,54,5940000
791470,DYO,2018,Puzzle,Free,0%,1571,52,1623,0,1617,67,1684,0
428830,Save the Dodos,2016,Puzzle,"₩3,300",0%,175,26,201,33165000,130,16,146,24090000
3568370,Asylum: Patient Zero,2025,Puzzle,"₩64,400",0%,203,59,262,843640000,96,17,113,363860000
2278300,A Symmetric Escape,2023,Puzzle,"₩4,500",0%,26,0,26,5850000,26,0,26,5850000
610900,Sumatra: Fate of Yandi,2019,Puzzle,"₩8,900",0%,160,4,164,72980000,146,5,151,67195000
2321310,Hidden Cats In Town,2023,Puzzle,"₩2,300",0%,142,32,174,20010000,134,31,165,18975000
816250,JQ: dogs & cats,2018,Puzzle,"₩1,100",0%,118,23,141,7755000,84,11,95,5225000
3601120,Toffee Cats,2025,Puzzle,"₩2,300",0%,27,0,27,3105000,25,0,25,2875000
319850,Bridge Constructor Medieval,2014,Puzzle,"₩11,000",0%,461,104,565,310750000,209,52,261,143550000
341310,Greyfox RPG,2015,Puzzle,"₩1,420",0%,1380,458,1838,130498000,1217,427,1644,116724000
222730,Reus,2013,Puzzle,"₩10,500",0%,4576,1263,5839,3065475000,0,0,0,0
2197360,Hot Heat Reset,2023,Puzzle,₩650,87%,17,1,18,585000,17,1,18,585000
374410,TransPlan,2015,Puzzle,"₩3,400",0%,254,21,275,46750000,157,17,174,29580000
2382920,Munchy Mammals,2023,Puzzle,"₩5,600",0%,30,1,31,8680000,29,0,29,8120000
610900,Sumatra: Fate of Yandi,2019,Puzzle,"₩8,900",0%,160,4,164,72980000,146,5,151,67195000
1395400,The Corruption Within,2021,Puzzle,"₩10,500",0%,144,8,152,79800000,111,7,118,61950000
374410,TransPlan,2015,Puzzle,"₩3,400",0%,254,21,275,46750000,157,17,174,29580000
3895180,Azaran: The Demon Bottle,2025,Puzzle,"₩2,300",0%,0,0,0,0,28,2,30,3450000
2563180,Days Like A Nightmare,2023,Puzzle,"₩5,600",0%,27,0,27,7560000,25,0,25,7000000
1734110,Frog Legs,2025,Puzzle,"₩3,400",0%,65,2,67,11390000,97,13,110,18700000
1902300,DROP - System Breach,2023,Puzzle,"₩6,540",40%,141,21,162,52974000,131,21,152,49704000
3731150,(The Lingering) Graveyard Visit,2025,Puzzle,"₩5,600",0%,0,0,0,0,11,0,11,3080000
845030,Evergate,2020,Puzzle,"₩11,000",0%,174,11,185,101750000,113,7,120,66000000
762840,Maquette,2021,Puzzle,"₩24,000",0%,431,188,619,742800000,396,178,574,688800000
2629340,Dungeon Bar: Gachi Puzzles,2023,Puzzle,"₩1,100",0%,68,8,76,4180000,51,4,55,3025000
204220,Snapshot,2012,Puzzle,"₩10,500",0%,185,68,253,132825000,35,9,44,23100000
775960,The Tower of Beatrice,2018,Puzzle,"₩6,500",0%,73,13,86,27950000,65,13,78,25350000
274980,Influent Language Learning Game,2014,Puzzle,"₩32,000",0%,1215,436,1651,2641600000,702,246,948,1516800000
850040,PuzzGun,2018,Puzzle,"₩3,300",0%,16,1,17,2805000,12,1,13,2145000
1458690,Mango,2021,Puzzle,"₩10,500",0%,108,12,120,63000000,102,10,112,58800000
399890,The Secret Order 2: Masked Intent,2015,Puzzle,"₩16,500",0%,393,94,487,401775000,249,59,308,254100000
2803010,100 Robo Cats,2024,Puzzle,Free,0%,0,0,0,0,922,91,1013,0
1115870,Inner Tao,2021,Puzzle,"₩3,400",0%,24,2,26,4420000,25,2,27,4590000
881040,Bug Academy,2020,Puzzle,"₩11,000",0%,272,12,284,156200000,234,12,246,135300000
99700,NightSky,2011,Puzzle,"₩10,500",0%,892,115,1007,528675000,278,27,305,160125000
2661520,There's No Easter Eggs,2024,Puzzle,"₩4,500",0%,34,3,37,8325000,23,1,24,5400000
955320,Dark Fantasy: Jigsaw Puzzle,2018,Puzzle,"₩3,150",0%,326,33,359,56542500,319,32,351,55282500
1185700,Arrog,2020,Puzzle,"₩3,300",0%,175,21,196,32340000,157,24,181,29865000
406970,The Uncertain: Last Quiet Day,2016,Puzzle,"₩10,500",0%,4404,1383,5787,3038175000,1244,393,1637,859425000
705450,Wunderdoktor,2017,Puzzle,"₩12,500",0%,95,9,104,65000000,79,10,89,55625000
476240,KNIGHTS,2016,Puzzle,"₩1,100",0%,737,48,785,43175000,696,44,740,40700000
251830,Stick it to The Man!,2013,Puzzle,"₩8,500",0%,807,46,853,362525000,465,30,495,210375000
2895090,Fairytale Furnishing,2024,Puzzle,"₩2,800",50%,20,3,23,3220000,18,3,21,2940000
406970,The Uncertain: Last Quiet Day,2016,Puzzle,"₩10,500",0%,4404,1383,5787,3038175000,1244,393,1637,859425000
2292710,Waterfall Prisoner,2023,Puzzle,"₩11,000",0%,58,1,59,32450000,53,1,54,29700000
2687190,100 Christmas Cats,2023,Puzzle,Free,0%,0,0,0,0,0,0,0,0
545030,NSFW ~ Not a Simulator For Working,2016,Puzzle,"₩3,400",0%,112,18,130,22100000,103,14,117,19890000
1826060,Night Loops,2023,Puzzle,"₩10,500",0%,112,9,121,63525000,102,9,111,58275000
3769230,Blenzzle,2025,Puzzle,"₩1,100",0%,0,0,0,0,10,0,10,550000
1185700,Arrog,2020,Puzzle,"₩3,300",0%,175,21,196,32340000,157,24,181,29865000
449730,Ahnayro: The Dream World,2016,Puzzle,"₩5,600",0%,244,35,279,78120000,189,26,215,60200000
2878720,Unable to Exit 8,2024,Puzzle,"₩5,600",0%,126,24,150,42000000,106,25,131,36680000
2094190,苍白花树繁茂之时Blood Flowers,2023,Puzzle,"₩8,500",0%,227,41,268,113900000,182,43,225,95625000
1306620,[Chilla's Art] Missing Children | 行方不明,2020,Puzzle,"₩3,400",0%,461,78,539,91630000,443,78,521,88570000
3478950,In Purr-Suit,2025,Puzzle,"₩2,200",0%,18,0,18,1980000,14,0,14,1540000
1183500,Puppy Cross,2020,Puzzle,"₩5,600",0%,274,6,280,78400000,253,8,261,73080000
3198530,Christmas Hustle,2024,Puzzle,"₩2,300",0%,15,0,15,1725000,13,0,13,1495000
692950,The Dew,2017,Puzzle,"₩2,200",0%,33,3,36,3960000,31,3,34,3740000
736840,aMAZE Double,2017,Puzzle,"₩2,300",0%,114,38,152,17480000,55,11,66,7590000
1333460,Nino Maze LOFI,2020,Puzzle,"₩1,100",0%,86,11,97,5335000,82,10,92,5060000
792650,Super Jigsaw Puzzle,2018,Puzzle,"₩5,600",0%,113,14,127,35560000,104,14,118,33040000
1524690,Chess Brain: Dark Troops,2021,Puzzle,"₩1,100",0%,58,4,62,3410000,58,4,62,3410000
574260,The Secret Order 5: The Buried Kingdom,2017,Puzzle,"₩16,500",0%,185,37,222,183150000,130,28,158,130350000
525450,King Oddball,2016,Puzzle,"₩5,600",0%,90,8,98,27440000,52,4,56,15680000
435840,The Preposterous Awesomeness of Everything,2016,Puzzle,"₩7,500",0%,139,10,149,55875000,124,4,128,48000000
1781730,502's Arcade,2024,Puzzle,"₩11,000",0%,16,1,17,9350000,15,2,17,9350000
357600,Unium,2015,Puzzle,"₩2,300",0%,293,20,313,35995000,210,11,221,25415000
2299750,Patchouli's Adventure In Doll's House,2024,Puzzle,"₩9,900",0%,40,0,40,19800000,38,0,38,18810000
3110520,101 Cats Hidden in Amsterdam,2024,Puzzle,"₩1,100",0%,0,0,0,0,69,5,74,4070000
574310,The Mooseman,2017,Puzzle,"₩8,900",0%,993,127,1120,498400000,827,102,929,413405000
45450,Fortix 2,2011,Puzzle,"₩2,200",0%,530,54,584,64240000,240,24,264,29040000
3676450,Corridor Exit 8,2025,Puzzle,"₩2,300",0%,0,0,0,0,18,7,25,2875000
2587260,Chill Seekers,2024,Puzzle,"₩4,500",0%,0,0,0,0,11,0,11,2475000
1937670,Melobot - A Last Song,2024,Puzzle,"₩19,000",0%,23,2,25,23750000,19,2,21,19950000
306680,Lexica,2014,Puzzle,"₩5,500",0%,282,96,378,103950000,160,42,202,55550000
278570,Labyrinthine Dreams,2015,Puzzle,"₩1,570",71%,290,79,369,28966500,172,40,212,16642000
2827560,100 Romantic Cats,2025,Puzzle,Free,0%,0,0,0,0,604,45,649,0
367000,Fine Sweeper,2015,Puzzle,"₩6,700",0%,395,54,449,150415000,231,31,262,87770000
2540460,Faded Stories: Full Moon,2023,Puzzle,"₩11,000",0%,22,3,25,13750000,23,5,28,15400000
573060,LOGistICAL,2017,Puzzle,"₩10,500",0%,194,40,234,122850000,186,41,227,119175000
328590,Don't Knock Twice,2017,Puzzle,"₩21,000",0%,488,187,675,708750000,447,174,621,652050000
820700,Free road,2018,Puzzle,"₩1,100",0%,18,5,23,1265000,16,4,20,1100000
1045580,Deleveled,2020,Puzzle,"₩10,500",0%,300,74,374,196350000,63,4,67,35175000
3057460,There's No Aliens,2024,Puzzle,"₩4,500",0%,13,0,13,2925000,11,1,12,2700000
1049710,Minute of Islands,2021,Puzzle,"₩20,500",0%,662,191,853,874325000,484,137,621,636525000
860860,Suicide Guy: Sleepin' Deeply,2018,Puzzle,"₩6,700",0%,372,98,470,157450000,243,81,324,108540000
1598580,Exhausted Man,2024,Puzzle,"₩11,000",0%,59,16,75,41250000,45,14,59,32450000
820900,Ceress and Orea,2018,Puzzle,"₩2,300",0%,114,16,130,14950000,108,16,124,14260000
1681560,Hungry Bunny,2021,Puzzle,"₩5,500",0%,15,4,19,5225000,12,1,13,3575000
1795110,Classic Card Games Collection,2021,Puzzle,"₩15,500",0%,16,6,22,17050000,18,5,23,17825000
2015950,Shapik: The Quest,2024,Puzzle,"₩5,340",40%,0,0,0,0,54,5,59,15753000
740090,Lost Grimoires 3: The Forgotten Well,2017,Puzzle,"₩15,500",0%,159,35,194,150350000,100,20,120,93000000
314330,DROD: Gunthro and the Epic Blunder,2016,Puzzle,"₩10,500",0%,166,11,177,92925000,112,10,122,64050000
775910,Animals Memory: Birds,2018,Puzzle,"₩4,500",0%,40,9,49,11025000,38,9,47,10575000
3876660,101 Cats Hidden in Indonesia,2025,Puzzle,₩660,40%,0,0,0,0,11,0,11,363000
578430,Puzzle Puppers,2017,Puzzle,"₩6,700",0%,98,8,106,35510000,72,5,77,25795000
450650,Polyology,2016,Puzzle,"₩1,100",0%,29,2,31,1705000,20,0,20,1100000
1128180,CROSSNIQ+,2019,Puzzle,"₩8,500",0%,81,9,90,38250000,76,9,85,36125000
1461360,Eggnog Incorporated,2020,Puzzle,"₩5,600",0%,28,2,30,8400000,21,2,23,6440000
1871880,Num One: Revised Edition,2022,Puzzle,"₩3,300",0%,21,0,21,3465000,20,0,20,3300000
567800,12 Labours of Hercules VI: Race for Olympus (Platinum Edition),2016,Puzzle,"₩3,300",0%,214,34,248,40920000,182,30,212,34980000
508530,HackyZack,2017,Puzzle,"₩10,500",0%,169,82,251,131775000,29,0,29,15225000
290380,Micron,2014,Puzzle,"₩3,400",0%,176,8,184,31280000,115,9,124,21080000
348430,Quell Reflect,2015,Puzzle,"₩4,400",0%,175,10,185,40700000,118,7,125,27500000
2165600,Boo!,2022,Puzzle,"₩2,200",0%,16,0,16,1760000,18,0,18,1980000
381870,Koala Kids,2015,Puzzle,"₩2,300",0%,243,27,270,31050000,182,14,196,22540000
643270,OLDTV,2017,Puzzle,Free,0%,5148,293,5441,0,0,0,0,0
792040,Detective Di: The Silk Rose Murders,2019,Puzzle,"₩11,500",0%,1078,135,1213,697475000,917,125,1042,599150000
642650,Pepper's Puzzles,2017,Puzzle,"₩7,500",0%,170,8,178,66750000,160,8,168,63000000
565720,Pretty Girls Panic!,2016,Puzzle,"₩2,300",0%,370,86,456,52440000,219,48,267,30705000
325520,Fire: Ungh’s Quest,2015,Puzzle,"₩12,500",0%,565,99,664,415000000,389,63,452,282500000
2715700,Teeny Tiny Town,2024,Puzzle,"₩7,800",0%,43,1,44,17160000,27,2,29,11310000
565720,Pretty Girls Panic!,2016,Puzzle,"₩2,300",0%,370,86,456,52440000,219,48,267,30705000
294230,Millie,2014,Puzzle,"₩4,400",0%,695,140,835,183700000,376,82,458,100760000
2715700,Teeny Tiny Town,2024,Puzzle,"₩7,800",0%,43,1,44,17160000,27,2,29,11310000
1296880,Sausage Hunter,2020,Puzzle,"₩32,000",0%,18,4,22,35200000,96,10,106,169600000
659190,"Sorry, James",2017,Puzzle,"₩7,800",0%,670,174,844,329160000,562,149,711,277290000
1926170,Forgotten Hill Tales,2022,Puzzle,"₩3,400",0%,81,9,90,15300000,81,9,90,15300000
2279710,Logicats,2023,Puzzle,"₩2,300",0%,65,1,66,7590000,48,0,48,5520000
820910,Last Resort Island,2018,Puzzle,"₩9,500",0%,174,29,203,96425000,142,21,163,77425000
1628890,NecroBoy : Path to Evilship,2022,Puzzle,"₩11,000",0%,28,3,31,17050000,15,0,15,8250000
678850,Uurnog Uurnlimited,2017,Puzzle,"₩11,000",0%,94,22,116,63800000,58,13,71,39050000
2604580,THE JUSOU 3,2024,Puzzle,"₩11,000",0%,11,2,13,7150000,11,1,12,6600000
2000210,Mythwrecked: Ambrosia Island,2024,Puzzle,"₩27,000",0%,89,7,96,129600000,69,6,75,101250000
1821960,The Psychoduck,2021,Puzzle,"₩2,300",0%,20,1,21,2415000,20,1,21,2415000
1504220,The Penguin IQ Test,2021,Puzzle,"₩2,300",0%,65,1,66,7590000,19,0,19,2185000
592660,Zen Garden,2017,Puzzle,"₩11,000",0%,108,34,142,78100000,98,32,130,71500000
684870,Spiral Splatter,2017,Puzzle,"₩5,600",0%,71,29,100,28000000,20,3,23,6440000
2015950,Shapik: The Quest,2024,Puzzle,"₩5,340",40%,0,0,0,0,54,5,59,15753000
1686370,Match3 mania!,2021,Puzzle,"₩5,500",0%,11,4,15,4125000,9,2,11,3025000
1975120,The Lost Dachshund,2022,Puzzle,Free,0%,0,0,0,0,682,21,703,0
504000,Endless Fables: The Minotaur's Curse,2016,Puzzle,"₩16,500",0%,289,32,321,264825000,185,23,208,171600000
1587190,Puzzletronics Digital Infinite,2021,Puzzle,"₩2,300",0%,43,9,52,5980000,43,8,51,5865000
3137530,Escape from Mutation Station,2025,Puzzle,"₩4,500",0%,63,0,63,14175000,66,1,67,15075000
550590,Archaica: The Path of Light,2017,Puzzle,"₩16,000",0%,242,17,259,207200000,193,19,212,169600000
2750390,Tiny Tales: Hidden Objects,2024,Puzzle,"₩5,600",0%,27,1,28,7840000,29,1,30,8400000
662190,The Secret Order 6: Bloodline,2017,Puzzle,"₩16,500",0%,186,16,202,166650000,133,10,143,117975000
359050,Shower With Your Dad Simulator 2015: Do You Still Shower With Your Dad,2015,Puzzle,"₩1,100",0%,9436,461,9897,544335000,0,0,0,0
1878570,Immortal Mantis,2022,Puzzle,"₩2,300",0%,215,11,226,25990000,205,13,218,25070000
2758290,PROJECT 13,2024,Puzzle,"₩4,500",0%,145,34,179,40275000,105,33,138,31050000
321480,Sigils of Elohim,2014,Puzzle,Free,0%,1063,101,1164,0,1062,105,1167,0
1251910,Kill Yourself,2020,Puzzle,"₩3,400",0%,108,14,122,20740000,91,15,106,18020000
1496320,Time Machine - Find Objects. Hidden Pictures Game,2021,Puzzle,"₩5,600",0%,79,18,97,27160000,75,18,93,26040000
1173830,Coloring Game: Pixel,2019,Puzzle,"₩5,600",0%,201,3,204,57120000,195,4,199,55720000
2027370,Ball Torture,2022,Puzzle,"₩5,500",0%,16,10,26,7150000,29,4,33,9075000
615350,Scarlett Mysteries: Cursed Child,2017,Puzzle,"₩16,500",0%,250,29,279,230175000,188,26,214,176550000
1340920,Piggy Gambit,2023,Puzzle,"₩8,900",0%,56,3,59,26255000,44,3,47,20915000
437520,ZeGame,2016,Puzzle,"₩4,400",0%,79,3,82,18040000,58,3,61,13420000
2862730,Abnormal1999:Apartment of Death,2024,Puzzle,"₩3,400",0%,40,3,43,7310000,24,2,26,4420000
2686690,Suika Shapes,2023,Puzzle,"₩5,600",0%,88,2,90,25200000,83,2,85,23800000
552160,Hade,2016,Puzzle,"₩4,400",0%,296,35,331,72820000,275,34,309,67980000
1096100,Skellboy Refractured,2021,Puzzle,"₩20,500",0%,80,13,93,95325000,42,10,52,53300000
536780,Lost Grimoires: Stolen Kingdom,2016,Puzzle,"₩16,500",0%,230,38,268,221100000,158,32,190,156750000
765100,Labirinto,2018,Puzzle,"₩1,100",0%,108,37,145,7975000,51,9,60,3300000
3609760,HONG KONG HAUNTING: FISHBALL GIRL,2025,Puzzle,"₩7,800",0%,0,0,0,0,18,5,23,8970000
1757450,Hackshot,2024,Puzzle,"₩13,500",0%,20,0,20,13500000,11,1,12,8100000
305760,Redirection,2016,Puzzle,"₩4,400",0%,141,7,148,32560000,97,4,101,22220000
1732220,The Crown of Wu,2023,Puzzle,"₩21,500",0%,37,12,49,52675000,22,5,27,29025000
548340,Abode,2016,Puzzle,"₩10,500",0%,348,29,377,197925000,271,24,295,154875000
421740,Goetia,2016,Puzzle,"₩14,500",0%,576,167,743,538675000,433,129,562,407450000
1793380,Roll The Cat,2021,Puzzle,"₩3,400",0%,100,3,103,17510000,91,4,95,16150000
323630,Ubinota,2015,Puzzle,Free,0%,224,23,247,0,224,25,249,0
1710670,Tracery of Fate,2024,Puzzle,"₩21,500",0%,99,30,129,138675000,93,26,119,127925000
3647220,What Lies Frozen,2025,Puzzle,"₩3,400",0%,24,2,26,4420000,26,4,30,5100000
1793380,Roll The Cat,2021,Puzzle,"₩3,400",0%,100,3,103,17510000,91,4,95,16150000
1090920,Gubble,2020,Puzzle,"₩10,500",0%,65,1,66,34650000,57,1,58,30450000
2323980,Dungeons & Jewels,2023,Puzzle,"₩5,600",0%,88,8,96,26880000,81,8,89,24920000
1930960,Jewel Match Origins 2 - Bavarian Palace Collector's Edition,2022,Puzzle,"₩10,500",0%,22,3,25,13125000,19,3,22,11550000
1709580,Tiny Robots Recharged,2021,Puzzle,"₩5,600",0%,56,19,75,21000000,58,20,78,21840000
512740,Flat Path,2016,Puzzle,"₩1,100",0%,79,10,89,4895000,51,8,59,3245000
987710,BLASK,2019,Puzzle,"₩5,600",0%,18,1,19,5320000,14,1,15,4200000
1678140,Shades of Sakura,2021,Puzzle,"₩2,200",0%,394,162,556,61160000,363,155,518,56980000
62100,Chime,2010,Puzzle,"₩5,500",0%,713,49,762,209550000,591,38,629,172975000
1713140,Arctictopia,2022,Puzzle,"₩5,600",0%,27,2,29,8120000,24,1,25,7000000
3052500,ColdRidge,2024,Puzzle,"₩11,000",0%,77,26,103,56650000,60,25,85,46750000
3122950,101 Cats Hidden in Berlin,2024,Puzzle,"₩1,100",0%,0,0,0,0,72,5,77,4235000
1356530,Mystery Hotel: Hidden Objects,2020,Puzzle,"₩5,600",0%,60,14,74,20720000,56,12,68,19040000
1783800,Crossroad OS,2023,Puzzle,"₩5,600",0%,262,3,265,74200000,261,5,266,74480000
2622750,Nonograms,2024,Puzzle,Free,0%,0,0,0,0,61,13,74,0
820600,ReThink | Evolved 2,2018,Puzzle,"₩11,000",0%,45,2,47,25850000,44,2,46,25300000
395520,Missing Translation,2015,Puzzle,Free,0%,2860,401,3261,0,0,0,0,0
599840,Planet RIX-13,2017,Puzzle,"₩3,400",0%,100,4,104,17680000,86,4,90,15300000
2577660,Spava,2024,Puzzle,"₩3,400",0%,0,0,0,0,30,5,35,5950000
2438090,A Void Hope,2024,Puzzle,"₩17,500",0%,54,3,57,49875000,34,4,38,33250000
3337220,That Level Again,2024,Puzzle,"₩3,400",0%,56,1,57,9690000,55,1,56,9520000
1841390,100 hidden fish,2022,Puzzle,"₩2,300",0%,444,18,462,53130000,432,18,450,51750000
429610,The Emerald Maiden: Symphony of Dreams,2016,Puzzle,"₩16,500",0%,423,72,495,408375000,246,40,286,235950000
2835030,Dino Cats,2024,Puzzle,Free,0%,0,0,0,0,198,22,220,0
3298590,101 Cats Hidden in Tokyo,2024,Puzzle,"₩1,100",0%,0,0,0,0,53,5,58,3190000
2225610,"Ready, Steady, Ship!",2024,Puzzle,"₩12,550",0%,92,34,126,79065000,70,31,101,63377500
3109270,Good Night Pan Pan,2024,Puzzle,"₩4,500",0%,20,2,22,4950000,20,3,23,5175000
3443410,The Brothers Hotel,2025,Puzzle,"₩7,800",0%,16,4,20,7800000,16,6,22,8580000
3795560,Jimmy's No. 44 House,2025,Puzzle,"₩5,600",0%,0,0,0,0,13,0,13,3640000
2246400,Confabulation,2023,Puzzle,"₩5,600",0%,90,5,95,26600000,64,7,71,19880000
740810,Pleasure Puzzle:Workshop 趣拼拼：拼图工坊,2018,Puzzle,"₩1,100",0%,200,26,226,12430000,130,21,151,8305000
2452920,Ouros,2024,Puzzle,"₩5,600",0%,194,9,203,56840000,196,10,206,57680000
382920,RETSNOM,2015,Puzzle,"₩5,600",0%,73,24,97,27160000,50,20,70,19600000
581760,True or False 2,2017,Puzzle,"₩2,730",0%,140,20,160,21840000,136,20,156,21294000
2411140,Linia Super,2023,Puzzle,"₩5,600",0%,25,0,25,7000000,19,0,19,5320000
1788520,OctoMaze,2022,Puzzle,"₩4,400",0%,24,0,24,5280000,19,0,19,4180000
1184210,Fragile,2020,Puzzle,"₩10,500",0%,269,151,420,220500000,248,140,388,203700000
725340,Lines X Free,2017,Puzzle,Free,0%,1718,123,1841,0,1735,131,1866,0
2267070,COSMIC HOLES,2023,Puzzle,"₩5,600",0%,0,0,0,0,15,0,15,4200000
80300,Puzzle Bots,2010,Puzzle,"₩5,500",0%,126,39,165,45375000,49,7,56,15400000
823610,Dungeon Of Dragon Knight,2019,Puzzle,"₩12,500",0%,269,78,347,216875000,221,77,298,186250000
765880,The Occupation,2019,Puzzle,"₩9,300",70%,234,153,387,179955000,122,57,179,83235000
2011160,Puzzles with nature,2022,Puzzle,"₩1,210",89%,12,2,14,847000,9,1,10,605000
898780,Escape Game,2018,Puzzle,"₩2,300",0%,120,24,144,16560000,100,19,119,13685000
574740,Fausts Alptraum,2017,Puzzle,Free,0%,1083,72,1155,0,1089,82,1171,0
3432160,Xi,2025,Puzzle,"₩2,300",0%,246,20,266,30590000,236,21,257,29555000
3351840,Play Twice,2025,Puzzle,"₩3,400",0%,0,0,0,0,39,2,41,6970000
2788960,Hidden Cats in Jigsaw Puzzle,2024,Puzzle,Free,0%,0,0,0,0,101,6,107,0
703700,Our End of the World,2017,Puzzle,"₩10,500",0%,3731,959,4690,2462250000,3447,916,4363,2290575000
401120,Anode,2015,Puzzle,"₩4,500",0%,98,13,111,24975000,74,10,84,18900000
1173740,Woodle Tree 2: Deluxe+,2019,Puzzle,"₩14,500",0%,80,11,91,65975000,46,10,56,40600000
3188050,Mini Mini Golf Golf,2024,Puzzle,"₩14,500",0%,35,4,39,28275000,38,3,41,29725000
2605640,Buried,2023,Puzzle,"₩2,300",0%,275,81,356,40940000,235,83,318,36570000
2071430,Roots of Yggdrasil,2024,Puzzle,"₩21,500",0%,282,30,312,335400000,238,33,271,291325000
534560,Ramify,2017,Puzzle,"₩3,400",0%,41,5,46,7820000,35,6,41,6970000
581360,FoxTail,2018,Puzzle,"₩6,300",40%,369,27,396,124740000,316,28,344,108360000
562570,Access Denied,2016,Puzzle,"₩3,400",0%,314,70,384,65280000,215,61,276,46920000
2532310,Line Link,2023,Puzzle,Free,0%,0,0,0,0,14,0,14,0
2363310,Orderly Havoc,2025,Puzzle,"₩8,900",0%,17,1,18,8010000,15,1,16,7120000
547910,The Survey,2016,Puzzle,"₩1,100",80%,588,235,823,45265000,525,215,740,40700000
1032690,Once a Tale,2024,Puzzle,"₩16,500",0%,36,4,40,33000000,35,4,39,32175000
290770,The Fall,2014,Puzzle,"₩10,500",0%,3228,445,3673,1928325000,0,0,0,0
1234890,labyrinth,2020,Puzzle,"₩3,300",0%,12,4,16,2640000,12,3,15,2475000
2057080,Resonance of the Ocean,2022,Puzzle,Free,0%,0,0,0,0,1928,60,1988,0
616040,Tales of the Tiny Planet,2017,Puzzle,"₩11,000",0%,42,8,50,27500000,26,3,29,15950000
332830,Prelogate,2014,Puzzle,"₩4,400",0%,87,9,96,21120000,69,6,75,16500000
1959350,Homebody,2023,Puzzle,"₩21,500",0%,641,43,684,735300000,565,43,608,653600000
367570,oO,2015,Puzzle,"₩1,100",0%,853,108,961,52855000,742,92,834,45870000
1830910,Cow Girls,2021,Puzzle,"₩1,100",0%,230,50,280,15400000,205,45,250,13750000
2500450,Anx Defense,2023,Puzzle,"₩11,000",0%,36,1,37,20350000,27,2,29,15950000
1726890,Hidden Kittens: Kingdom of Cats,2024,Puzzle,"₩2,300",0%,0,0,0,0,43,0,43,4945000
1614340,Matchsticks - Coffee Break Club,2021,Puzzle,"₩2,300",0%,84,3,87,10005000,80,3,83,9545000
1392130,Game Of Puzzles: Slavic Mythology,2020,Puzzle,"₩1,100",0%,25,2,27,1485000,23,0,23,1265000
3213720,101 Cats Hidden in Los Angeles,2024,Puzzle,"₩1,100",0%,0,0,0,0,50,4,54,2970000
1726890,Hidden Kittens: Kingdom of Cats,2024,Puzzle,"₩2,300",0%,0,0,0,0,43,0,43,4945000
1720790,Door3:Insignia,2021,Puzzle,"₩12,500",0%,13,2,15,9375000,10,2,12,7500000
1511140,Laser Attraction,2021,Puzzle,"₩10,500",0%,53,5,58,30450000,52,6,58,30450000
1173740,Woodle Tree 2: Deluxe+,2019,Puzzle,"₩14,500",0%,80,11,91,65975000,46,10,56,40600000
1032690,Once a Tale,2024,Puzzle,"₩16,500",0%,36,4,40,33000000,35,4,39,32175000
1611290,Puzzle Compound,2023,Puzzle,"₩13,500",0%,54,4,58,39150000,50,4,54,36450000
1593950,Don't Touch this Button!,2021,Puzzle,"₩4,500",0%,107,6,113,25425000,68,4,72,16200000
1646030,Cat Slide Tiles,2021,Puzzle,"₩2,200",0%,152,2,154,16940000,141,3,144,15840000
2303620,Turn on the lights carefully,2023,Puzzle,₩710,35%,37,0,37,1313500,37,0,37,1313500
367570,oO,2015,Puzzle,"₩1,100",0%,853,108,961,52855000,742,92,834,45870000
474050,Candy Blast,2016,Puzzle,"₩5,600",0%,151,65,216,60480000,62,14,76,21280000
2322900,Gift,2024,Puzzle,"₩27,000",0%,67,14,81,109350000,51,15,66,89100000
1323950,Dungeons & Bombs,2020,Puzzle,₩600,45%,17,3,20,600000,15,2,17,510000
873610,mr.Vegan,2018,Puzzle,"₩2,300",0%,116,22,138,15870000,79,13,92,10580000
2159050,Blessed Work,2022,Puzzle,"₩3,400",0%,9,1,10,1700000,9,1,10,1700000
616040,Tales of the Tiny Planet,2017,Puzzle,"₩11,000",0%,42,8,50,27500000,26,3,29,15950000
485730,Shift,2016,Puzzle,"₩1,100",0%,260,75,335,18425000,243,64,307,16885000
778340,Animals Memory: Dogs,2018,Puzzle,"₩4,500",0%,37,10,47,10575000,33,8,41,9225000
569800,LEAVES - The Journey,2017,Puzzle,"₩5,600",0%,528,134,662,185360000,438,103,541,151480000
2409840,Hidden Bunny,2023,Puzzle,"₩1,100",0%,21,1,22,1210000,14,1,15,825000
1302850,Tails of Trainspot,2023,Puzzle,"₩13,500",0%,48,1,49,33075000,42,1,43,29025000
674310,THE 2048,2017,Puzzle,"₩1,100",0%,92,10,102,5610000,83,10,93,5115000
674310,THE 2048,2017,Puzzle,"₩1,100",0%,92,10,102,5610000,83,10,93,5115000
2807210,Robo Cats,2024,Puzzle,Free,0%,0,0,0,0,250,37,287,0
569800,LEAVES - The Journey,2017,Puzzle,"₩5,600",0%,528,134,662,185360000,438,103,541,151480000
485730,Shift,2016,Puzzle,"₩1,100",0%,260,75,335,18425000,243,64,307,16885000
1720790,Door3:Insignia,2021,Puzzle,"₩12,500",0%,13,2,15,9375000,10,2,12,7500000
2409840,Hidden Bunny,2023,Puzzle,"₩1,100",0%,21,1,22,1210000,14,1,15,825000
1795110,Classic Card Games Collection,2021,Puzzle,"₩15,500",0%,16,6,22,17050000,18,5,23,17825000
96100,Defy Gravity Extended,2016,Puzzle,"₩2,300",0%,7365,1187,8552,983480000,0,0,0,0
1458590,Anime Artist 3: Harem,2020,Puzzle,"₩2,300",0%,62,10,72,8280000,60,11,71,8165000
806900,Them Bombs,2019,Puzzle,"₩11,500",0%,66,3,69,39675000,55,4,59,33925000
740410,Puzzle Chambers,2017,Puzzle,"₩3,400",0%,78,19,97,16490000,41,14,55,9350000
1418830,Sayonara Golden Days,2021,Puzzle,"₩2,200",0%,94,3,97,10670000,79,3,82,9020000
1970050,Temple of Starlight,2023,Puzzle,"₩5,500",0%,28,1,29,7975000,28,1,29,7975000
939620,Pleasure Puzzle:Portrait 趣拼拼：肖像画,2018,Puzzle,"₩1,100",0%,1681,173,1854,101970000,180,9,189,10395000
2380230,THE JUSOU,2023,Puzzle,"₩11,000",0%,29,10,39,21450000,30,9,39,21450000
1092430,Budget Cuts 2: Mission Insolvency,2019,Puzzle,"₩31,000",0%,420,101,521,807550000,365,86,451,699050000
1695620,CHR$(143),2021,Puzzle,"₩3,400",60%,72,3,75,12750000,66,4,70,11900000
943190,OCTOPTICOM,2018,Puzzle,"₩10,500",0%,52,3,55,28875000,51,3,54,28350000
1331910,Morkredd,2020,Puzzle,"₩21,500",0%,381,95,476,511700000,106,45,151,162325000
1915210,The Mensional,2022,Puzzle,"₩5,600",0%,56,4,60,16800000,54,4,58,16240000
2653080,Who do you want to date? professional girls сollection,2024,Puzzle,"₩1,100",0%,20,4,24,1320000,18,5,23,1265000
1618220,窓の中の先にあるもの,2021,Puzzle,"₩2,200",0%,22,0,22,2420000,23,0,23,2530000
3359580,Cats Contrast,2025,Puzzle,"₩1,100",0%,0,0,0,0,18,1,19,1045000
227200,Waking Mars,2012,Puzzle,"₩10,500",0%,1054,133,1187,623175000,575,71,646,339150000
304500,Rooms: The Main Building,2014,Puzzle,"₩11,000",0%,141,31,172,94600000,44,9,53,29150000
943190,OCTOPTICOM,2018,Puzzle,"₩10,500",0%,52,3,55,28875000,51,3,54,28350000
2653080,Who do you want to date? professional girls сollection,2024,Puzzle,"₩1,100",0%,20,4,24,1320000,18,5,23,1265000
2671970,‎My Suika – Kyo’s Fruit Merge,2023,Puzzle,"₩1,100",0%,600,90,690,37950000,1572,137,1709,93995000
377760,Fox & Flock,2015,Puzzle,"₩2,300",0%,171,30,201,23115000,132,25,157,18055000
1514000,Anime Holidays,2021,Puzzle,"₩1,100",0%,33,3,36,1980000,27,1,28,1540000
1915210,The Mensional,2022,Puzzle,"₩5,600",0%,56,4,60,16800000,54,4,58,16240000
625430,Doodle God Blitz,2017,Puzzle,Free,0%,548,256,804,0,554,261,815,0
227200,Waking Mars,2012,Puzzle,"₩10,500",0%,1054,133,1187,623175000,575,71,646,339150000
286380,Strata,2014,Puzzle,"₩8,500",0%,309,46,355,150875000,122,11,133,56525000
2747980,Clockwork Rabbit,2025,Puzzle,"₩12,500",0%,20,0,20,12500000,22,0,22,13750000
355920,Pixel Puzzles 2: Space,2016,Puzzle,₩820,85%,324,54,378,15498000,72,5,77,3157000
1362190,Endless Escape,2020,Puzzle,"₩4,400",0%,71,17,88,19360000,57,12,69,15180000
2516890,Andarin Weppes,2025,Puzzle,"₩3,400",0%,42,4,46,7820000,44,4,48,8160000
513360,Mu Cartographer,2016,Puzzle,"₩5,500",0%,202,26,228,62700000,163,20,183,50325000
2918250,Superhero Cats,2025,Puzzle,Free,0%,0,0,0,0,105,12,117,0
1849890,Neko Maid,2022,Puzzle,"₩1,100",0%,206,44,250,13750000,185,44,229,12595000
715010,Diamo XL,2017,Puzzle,"₩1,100",0%,502,34,536,29480000,483,36,519,28545000
394700,Karma. Incarnation 1,2016,Puzzle,"₩5,500",0%,301,66,367,100925000,211,46,257,70675000
2945990,Mr. Hopp's Playhouse HD,2024,Puzzle,"₩2,300",0%,51,10,61,7015000,49,12,61,7015000
1671420,Detective Holmes: Hidden Objects,2021,Puzzle,"₩5,600",0%,38,7,45,12600000,37,7,44,12320000
458540,Lines,2017,Puzzle,"₩5,600",0%,116,17,133,37240000,50,10,60,16800000
1014040,PictoQuest,2020,Puzzle,"₩8,500",0%,441,92,533,226525000,292,64,356,151300000
1745800,Doom Work,2021,Puzzle,"₩2,300",0%,32,3,35,4025000,30,2,32,3680000
3127440,101 Cats Hidden in Ireland,2024,Puzzle,"₩1,100",0%,0,0,0,0,48,5,53,2915000
3129760,101 Cats Hidden in Brazil,2024,Puzzle,"₩1,100",0%,0,0,0,0,81,8,89,4895000
1906180,Memory Traces: Japan,2022,Puzzle,"₩2,200",0%,70,5,75,8250000,65,6,71,7810000
3380740,Boo! Are you scared? The Chests Game,2025,Puzzle,"₩3,400",0%,169,12,181,30770000,175,11,186,31620000
391580,Egyptian Senet,2015,Puzzle,"₩11,000",0%,277,77,354,194700000,155,36,191,105050000
1120360,At Home Alone II,2019,Puzzle,"₩2,200",0%,191,29,220,24200000,183,30,213,23430000
1225070,Family Mysteries: Poisonous Promises,2020,Puzzle,"₩16,500",0%,202,53,255,210375000,131,33,164,135300000
3148080,Summon The DUDES!,2024,Puzzle,"₩1,100",0%,47,1,48,2640000,41,0,41,2255000
527420,Demon Hunter 3: Revelation,2016,Puzzle,"₩16,500",0%,266,31,297,245025000,172,24,196,161700000
603800,ReThink,2017,Puzzle,"₩11,000",0%,231,52,283,155650000,143,19,162,89100000
982220,Globesweeper,2019,Puzzle,"₩3,400",0%,287,31,318,54060000,275,34,309,52530000
819040,Ashi: Lake of Light,2018,Puzzle,"₩4,400",0%,46,3,49,10780000,39,3,42,9240000
876500,HyperDot,2020,Puzzle,"₩20,500",0%,32,5,37,37925000,21,3,24,24600000
663210,12 Labours of Hercules VII: Fleecing the Fleece (Platinum Edition),2018,Puzzle,"₩3,300",0%,152,18,170,28050000,120,10,130,21450000
203560,Containment: The Zombie Puzzler,2012,Puzzle,"₩5,500",0%,226,62,288,79200000,109,14,123,33825000
2558440,Block & Shot,2024,Puzzle,"₩2,300",0%,15,0,15,1725000,15,0,15,1725000
260530,So Many Me,2014,Puzzle,"₩15,500",0%,99,7,106,82150000,58,7,65,50375000
746560,Gadgeteer,2020,Puzzle,"₩15,500",0%,117,4,121,93775000,91,3,94,72850000
620650,Puzzle With Your Friends,2018,Puzzle,"₩5,500",0%,159,22,181,49775000,133,22,155,42625000
1867190,Wordle 5,2022,Puzzle,"₩32,000",0%,39,19,58,92800000,167,59,226,361600000
1146630,Yokai's Secret,2020,Puzzle,"₩2,300",0%,6178,698,6876,790740000,0,0,0,0
1199900,Hope's Farm,2019,Puzzle,"₩11,000",0%,25,5,30,16500000,23,5,28,15400000
395620,Ittle Dew 2+,2016,Puzzle,"₩21,500",0%,361,58,419,450425000,263,36,299,321425000
604450,Another Adventure,2017,Puzzle,"₩2,200",0%,3963,370,4333,476630000,0,0,0,0
546170,Gem Forge,2016,Puzzle,"₩1,100",0%,64,8,72,3960000,53,5,58,3190000
639770,UNTITLED,2017,Puzzle,Free,0%,52,4,56,0,52,3,55,0
647570,Transference™,2018,Puzzle,"₩5,400",80%,336,144,480,129600000,318,136,454,122580000
1008860,Repella Fella,2023,Puzzle,"₩11,310",42%,418,10,428,242034000,287,9,296,167388000
1644720,Project H,2021,Puzzle,Free,0%,0,0,0,0,382,52,434,0
3127440,101 Cats Hidden in Ireland,2024,Puzzle,"₩1,100",0%,0,0,0,0,48,5,53,2915000
521280,Atlantis: Pearls of the Deep,2016,Puzzle,"₩7,500",0%,67,11,78,29250000,48,10,58,21750000
3129760,101 Cats Hidden in Brazil,2024,Puzzle,"₩1,100",0%,0,0,0,0,81,8,89,4895000
2694140,Zooplop,2023,Puzzle,"₩3,400",0%,0,0,0,0,15,2,17,2890000
1542110,Daydream: Forgotten Sorrow,2023,Puzzle,"₩20,500",0%,181,81,262,268550000,144,64,208,213200000
726200,Hostil,2017,Puzzle,"₩3,400",0%,227,34,261,44370000,218,32,250,42500000
490510,Pixel Puzzles 2: Christmas,2018,Puzzle,"₩5,500",0%,102,13,115,31625000,50,4,54,14850000
594810,Color Jumper,2017,Puzzle,"₩1,100",0%,30,4,34,1870000,21,4,25,1375000
1165840,The Strange Story Of Brian Fisher: Chapter 1,2020,Puzzle,"₩7,500",0%,43,7,50,18750000,34,8,42,15750000
2621900,Railway Islands 2 - Puzzle,2023,Puzzle,"₩5,600",0%,28,4,32,8960000,23,3,26,7280000
1225070,Family Mysteries: Poisonous Promises,2020,Puzzle,"₩16,500",0%,202,53,255,210375000,131,33,164,135300000
61310,Fractal: Make Blooms Not War,2011,Puzzle,"₩7,500",0%,161,54,215,80625000,44,11,55,20625000
350810,Pixel Puzzles 2: Anime,2015,Puzzle,"₩5,920",0%,741,255,996,294816000,141,33,174,51504000
405950,Lowglow,2015,Puzzle,"₩4,400",0%,422,44,466,102520000,81,7,88,19360000
3255100,MOM,2024,Puzzle,"₩4,500",0%,20,2,22,4950000,21,3,24,5400000
1682490,Slender Threads: Prologue,2021,Puzzle,Free,0%,0,0,0,0,492,10,502,0
1520250,Gnome Jigsaw Puzzles,2021,Puzzle,"₩2,300",0%,110,4,114,13110000,60,0,60,6900000
329380,Stealth Inc 2: A Game of Clones,2015,Puzzle,"₩16,000",0%,777,253,1030,824000000,85,32,117,93600000
602430,Yono and the Celestial Elephants,2017,Puzzle,"₩15,500",0%,267,54,321,248775000,147,32,179,138725000
1548830,TAL: Arctic 4,2021,Puzzle,"₩1,100",0%,38,3,41,2255000,32,1,33,1815000
503460,Security Hole,2016,Puzzle,"₩10,000",0%,131,9,140,70000000,47,8,55,27500000
329380,Stealth Inc 2: A Game of Clones,2015,Puzzle,"₩16,000",0%,777,253,1030,824000000,85,32,117,93600000
594810,Color Jumper,2017,Puzzle,"₩1,100",0%,30,4,34,1870000,21,4,25,1375000
1682490,Slender Threads: Prologue,2021,Puzzle,Free,0%,0,0,0,0,492,10,502,0
1588940,Storm Tale 2,2021,Puzzle,"₩11,000",0%,56,6,62,34100000,54,6,60,33000000
787980,4D Minesweeper,2018,Puzzle,Free,0%,533,36,569,0,551,42,593,0
3255100,MOM,2024,Puzzle,"₩4,500",0%,20,2,22,4950000,21,3,24,5400000
2834780,101 Cats Hidden in Dubai,2024,Puzzle,"₩1,100",0%,0,0,0,0,96,6,102,5610000
503460,Security Hole,2016,Puzzle,"₩10,000",0%,131,9,140,70000000,47,8,55,27500000
1706190,SudoKats,2021,Puzzle,"₩2,300",0%,72,7,79,9085000,66,7,73,8395000
3169040,Seeking Cat,2024,Puzzle,"₩1,100",0%,55,7,62,3410000,50,7,57,3135000
377660,Blockwick 2,2015,Puzzle,"₩10,500",0%,169,5,174,91350000,112,6,118,61950000
1146630,Yokai's Secret,2020,Puzzle,"₩2,300",0%,6178,698,6876,790740000,0,0,0,0
1365390,Facility 47,2020,Puzzle,"₩5,500",0%,81,10,91,25025000,86,11,97,26675000
1176540,Sunny Girl,2023,Puzzle,"₩1,100",0%,17,3,20,1100000,16,2,18,990000
1939940,Roll Player - The Board Game,2023,Puzzle,"₩15,500",0%,131,16,147,113925000,126,17,143,110825000
316080,Parcel,2015,Puzzle,"₩5,500",0%,117,21,138,37950000,98,20,118,32450000
1065460,ReThink | Evolved 3,2019,Puzzle,"₩11,000",0%,29,1,30,16500000,29,1,30,16500000
1307380,ISOLAND: The Amusement Park,2020,Puzzle,"₩3,300",0%,73,9,82,13530000,69,6,75,12375000
726200,Hostil,2017,Puzzle,"₩3,400",0%,227,34,261,44370000,218,32,250,42500000
400160,Concrete Jungle,2015,Puzzle,"₩7,500",0%,563,81,644,241500000,282,31,313,117375000
644080,Alphabear: Hardcover Edition,2017,Puzzle,"₩11,000",0%,89,19,108,59400000,69,12,81,44550000
1654900,Orakyubu,2021,Puzzle,Free,0%,0,0,0,0,266,5,271,0
1554550,Unlock The Cat,2021,Puzzle,"₩2,200",0%,139,5,144,15840000,125,5,130,14300000
513340,Through Abandoned: The Forest,2016,Puzzle,"₩4,500",0%,329,102,431,96975000,250,79,329,74025000
758530,Sprout,2018,Puzzle,Free,0%,1625,69,1694,0,1633,68,1701,0
497700,Safety First!,2016,Puzzle,₩850,75%,315,77,392,16660000,150,25,175,7437500
377660,Blockwick 2,2015,Puzzle,"₩10,500",0%,169,5,174,91350000,112,6,118,61950000
1554550,Unlock The Cat,2021,Puzzle,"₩2,200",0%,139,5,144,15840000,125,5,130,14300000
1654900,Orakyubu,2021,Puzzle,Free,0%,0,0,0,0,266,5,271,0
2161730,Mike's Arcade,2022,Puzzle,"₩8,500",0%,9,1,10,4250000,9,1,10,4250000
299400,XING: The Land Beyond,2017,Puzzle,"₩21,500",0%,285,31,316,339700000,235,32,267,287025000
2387310,Magic Paper,2024,Puzzle,"₩14,900",0%,25,3,28,20860000,18,3,21,15645000
2922050,Suika Jelly Game,2024,Puzzle,"₩2,300",0%,29,0,29,3335000,31,0,31,3565000
463460,"Resette's Prescription ~Book of memory, Swaying scale~",2016,Puzzle,"₩14,500",0%,44,11,55,39875000,42,11,53,38425000
3284270,Blobun,2025,Puzzle,"₩16,500",0%,109,0,109,89925000,102,0,102,84150000
597700,OVIVO,2017,Puzzle,"₩11,000",0%,416,46,462,254100000,380,42,422,232100000
539460,Puzzle Cube,2016,Puzzle,"₩2,300",0%,169,49,218,25070000,116,35,151,17365000
242780,Cognition: An Erica Reed Thriller,2013,Puzzle,"₩16,000",0%,656,141,797,637600000,303,62,365,292000000
3245740,100 Hidden Kooky & Hiking Boots,2024,Puzzle,"₩2,300",0%,33,1,34,3910000,32,1,33,3795000
1703210,Box to the Box,2022,Puzzle,"₩3,400",0%,15,0,15,2550000,14,0,14,2380000
1726870,Nebraska,2021,Puzzle,"₩4,400",0%,58,14,72,15840000,58,13,71,15620000
269710,Tumblestone,2016,Puzzle,"₩27,000",0%,1427,443,1870,2524500000,143,21,164,221400000
1455230,Dungeon Slime:  Puzzle's Adventure,2020,Puzzle,"₩2,300",0%,78,2,80,9200000,67,2,69,7935000
3375220,Dogs Contrast,2025,Puzzle,"₩1,100",0%,0,0,0,0,11,1,12,660000
1275670,Outcore: Desktop Adventure,2022,Puzzle,Free,0%,14753,404,15157,0,0,0,0,0
897800,Arcane Golf,2018,Puzzle,"₩1,700",50%,57,3,60,5100000,51,1,52,4420000
2366080,911: Cannibal,2023,Puzzle,"₩4,500",0%,36,7,43,9675000,36,7,43,9675000
2331060,Gambit Shifter,2024,Puzzle,"₩8,900",0%,57,2,59,26255000,50,1,51,22695000
3182240,Tangram Collection,2024,Puzzle,Free,0%,0,0,0,0,42,9,51,0
2331060,Gambit Shifter,2024,Puzzle,"₩8,900",0%,57,2,59,26255000,50,1,51,22695000
806020,Milky Way Map,2018,Puzzle,"₩1,100",0%,50,10,60,3300000,33,6,39,2145000
2567410,The Green Room Experiment (Episode 2),2023,Puzzle,"₩11,000",0%,13,2,15,8250000,10,2,12,6600000
1444730,My Sweet Washing Machine!,2020,Puzzle,"₩2,300",0%,130,29,159,18285000,51,6,57,6555000
1922020,Land Above Sea Below,2023,Puzzle,"₩8,900",0%,101,32,133,59185000,76,28,104,46280000
864570,Chocolate makes you happy 6,2018,Puzzle,"₩2,300",0%,61,27,88,10120000,28,4,32,3680000
2638340,The Legend of Lumina,2024,Puzzle,Free,0%,87,1,88,0,96,3,99,0
461220,Beglitched,2016,Puzzle,"₩10,500",0%,110,9,119,62475000,84,7,91,47775000
705550,Burgle Bros.,2017,Puzzle,"₩4,400",0%,42,9,51,11220000,42,9,51,11220000
3406660,1.96.9 all update,2025,Puzzle,Free,0%,0,0,0,0,43,8,51,0
305920,Another Perspective,2014,Puzzle,"₩6,500",0%,279,40,319,103675000,81,6,87,28275000
626660,Flipping Death,2018,Puzzle,"₩20,500",0%,238,28,266,272650000,185,25,210,215250000
269710,Tumblestone,2016,Puzzle,"₩27,000",0%,1427,443,1870,2524500000,143,21,164,221400000
763030,Nelly Cootalot: Spoonbeaks Ahoy! HD,2019,Puzzle,"₩1,150",50%,169,19,188,10810000,137,17,154,8855000
1484600,Stand By Me,2021,Puzzle,"₩6,500",0%,27,1,28,9100000,23,1,24,7800000
2638180,Hokkaido Game,2023,Puzzle,"₩4,500",0%,161,6,167,37575000,150,6,156,35100000
2762810,Winter Cats,2024,Puzzle,Free,0%,0,0,0,0,560,69,629,0
1135090,dino game,2020,Puzzle,"₩3,300",0%,74,8,82,13530000,65,6,71,11715000
296070,MIND: Path to Thalamus Enhanced Edition,2014,Puzzle,"₩15,500",0%,925,482,1407,1090425000,523,320,843,653325000
673450,Time Lock VR 1,2017,Puzzle,"₩6,750",0%,472,189,661,223087500,445,126,571,192712500
2056490,Forrader Hero,2023,Puzzle,"₩2,250",50%,67,7,74,8325000,54,4,58,6525000
388620,DungeonUp,2015,Puzzle,"₩5,500",0%,391,88,479,131725000,321,71,392,107800000
1692060,Bad Dream: Stories,2021,Puzzle,"₩6,700",0%,95,3,98,32830000,94,3,97,32495000
404510,Heaven's Hope - Special Edition,2016,Puzzle,"₩10,500",0%,105,18,123,64575000,82,16,98,51450000
2780880,Bunny-girl with Golden tummy,2024,Puzzle,"₩1,100",0%,42,9,51,2805000,40,8,48,2640000
853050,El Hijo - A Wild West Tale,2020,Puzzle,"₩21,500",0%,167,39,206,221450000,65,26,91,97825000
396800,12 Labours of Hercules IV: Mother Nature (Platinum Edition),2015,Puzzle,"₩3,300",0%,591,64,655,108075000,324,36,360,59400000
3233130,Claire,2025,Puzzle,"₩14,850",9%,0,0,0,0,41,3,44,32670000
1960400,SokoChess,2022,Puzzle,"₩5,600",0%,42,2,44,12320000,33,2,35,9800000
568460,Ghostory,2017,Puzzle,"₩8,900",0%,60,5,65,28925000,32,2,34,15130000
2307370,Hot Heat Reset: Chapter 1,2023,Puzzle,Free,0%,0,0,0,0,76,9,85,0
2235530,The Green Room Experiment (Episode 1),2023,Puzzle,"₩5,600",0%,19,2,21,5880000,17,4,21,5880000
486630,Toxic Terror,2016,Puzzle,"₩2,300",0%,10,5,15,1725000,9,2,11,1265000
314810,Randal's Monday,2014,Puzzle,"₩21,000",0%,1252,356,1608,1688400000,987,295,1282,1346100000
546410,Grab the Bottle,2017,Puzzle,"₩3,400",0%,113,20,133,22610000,77,16,93,15810000
804530,Cubism,2020,Puzzle,"₩10,500",0%,43,0,43,22575000,33,0,33,17325000
1964420,MAZAICA,2024,Puzzle,"₩3,300",0%,32,7,39,6435000,28,12,40,6600000
2056490,Forrader Hero,2023,Puzzle,"₩2,250",50%,67,7,74,8325000,54,4,58,6525000
1133950,The Castle,2019,Puzzle,"₩6,500",0%,33,4,37,12025000,27,4,31,10075000
111800,Blocks That Matter,2011,Puzzle,"₩5,600",0%,598,172,770,215600000,320,75,395,110600000
1425510,Clown In a House,2021,Puzzle,"₩8,500",0%,68,9,77,32725000,55,8,63,26775000
2762810,Winter Cats,2024,Puzzle,Free,0%,0,0,0,0,560,69,629,0
527740,YANKAI'S TRIANGLE,2016,Puzzle,"₩6,500",0%,58,15,73,23725000,51,14,65,21125000
1972400,Package Rush,2022,Puzzle,"₩5,600",0%,33,4,37,10360000,29,3,32,8960000
1191770,混世萌王喵霸霸 Cute Chaos Demon Nyanbaba,2022,Puzzle,"₩1,100",0%,131,0,131,7205000,102,0,102,5610000
632250,DERU - The Art of Cooperation,2018,Puzzle,"₩16,000",0%,53,8,61,48800000,46,6,52,41600000
253690,Tiny Brains,2013,Puzzle,"₩10,500",0%,421,117,538,282450000,304,86,390,204750000
1875670,Gigant,2022,Puzzle,"₩4,500",0%,28,7,35,7875000,28,7,35,7875000
632250,DERU - The Art of Cooperation,2018,Puzzle,"₩16,000",0%,53,8,61,48800000,46,6,52,41600000
1133950,The Castle,2019,Puzzle,"₩6,500",0%,33,4,37,12025000,27,4,31,10075000
1425510,Clown In a House,2021,Puzzle,"₩8,500",0%,68,9,77,32725000,55,8,63,26775000
1174320,Travel Mosaics 10: Spooky Halloween,2019,Puzzle,"₩3,300",0%,16,0,16,2640000,13,0,13,2145000
370150,LOOP: A Tranquil Puzzle Game,2015,Puzzle,"₩5,500",0%,129,4,133,36575000,117,5,122,33550000
1972400,Package Rush,2022,Puzzle,"₩5,600",0%,33,4,37,10360000,29,3,32,8960000
1875670,Gigant,2022,Puzzle,"₩4,500",0%,28,7,35,7875000,28,7,35,7875000
342580,12 Labours of Hercules,2015,Puzzle,"₩3,300",0%,2926,194,3120,514800000,0,0,0,0
1692060,Bad Dream: Stories,2021,Puzzle,"₩6,700",0%,95,3,98,32830000,94,3,97,32495000
868230,Mushroom Quest,2018,Puzzle,"₩3,300",0%,62,12,74,12210000,50,9,59,9735000
1191770,混世萌王喵霸霸 Cute Chaos Demon Nyanbaba,2022,Puzzle,"₩1,100",0%,131,0,131,7205000,102,0,102,5610000
2148780,Eye of Nollyn,2023,Puzzle,"₩5,600",0%,20,2,22,6160000,20,2,22,6160000
1305050,Lightless,2020,Puzzle,Free,0%,140,28,168,0,143,29,172,0
2626960,Red Nose Guy Suika,2024,Puzzle,"₩2,300",0%,14,0,14,1610000,11,0,11,1265000
1436410,ReThink 4,2022,Puzzle,"₩11,000",0%,20,3,23,12650000,20,4,24,13200000
1806840,100 hidden frogs,2021,Puzzle,Free,0%,0,0,0,0,0,0,0,0
2933990,Cats Hidden in Christmas,2024,Puzzle,Free,0%,0,0,0,0,902,28,930,0
704470,VR Furballs - Demolition,2018,Puzzle,"₩11,000",0%,146,7,153,84150000,104,6,110,60500000
998790,Piczle Lines DX+α,2019,Puzzle,"₩10,500",0%,45,10,55,28875000,42,11,53,27825000
1771730,The City Must Grow,2021,Puzzle,"₩5,600",0%,57,10,67,18760000,51,11,62,17360000
1079450,Escape Lala 2 - Retro Point and Click Adventure,2019,Puzzle,"₩5,500",0%,149,2,151,41525000,134,3,137,37675000
1375930,Minesweeper: Collector,2020,Puzzle,"₩8,400",0%,105,9,114,47880000,105,10,115,48300000
1031900,You Can Kana - Learn Japanese Hiragana & Katakana,2021,Puzzle,"₩10,500",0%,283,3,286,150150000,237,2,239,125475000
523150,Mahjong World Contest (麻将),2016,Puzzle,"₩16,500",0%,181,28,209,172425000,165,25,190,156750000
3278760,The Happyhills Homicide,2024,Puzzle,Free,0%,0,0,0,0,1114,46,1160,0
1692060,Bad Dream: Stories,2021,Puzzle,"₩6,700",0%,95,3,98,32830000,94,3,97,32495000
1946140,Jigsaw Puzzles Infinite,2023,Puzzle,Free,0%,324,55,379,0,332,58,390,0
1412240,Lombardi's World,2020,Puzzle,"₩5,500",0%,84,8,92,25300000,69,8,77,21175000
1383410,Gravitaze: One,2020,Puzzle,"₩2,300",0%,11,0,11,1265000,10,0,10,1150000
1719660,My Cute Succubus,2021,Puzzle,"₩3,400",0%,195,56,251,42670000,171,54,225,38250000
1031900,You Can Kana - Learn Japanese Hiragana & Katakana,2021,Puzzle,"₩10,500",0%,283,3,286,150150000,237,2,239,125475000
752600,Dual Snake,2018,Puzzle,Free,0%,70,5,75,0,71,5,76,0
1267400,Test Of Courage,2020,Puzzle,"₩6,700",0%,49,7,56,18760000,45,6,51,17085000
2314850,The Legend of Skye,2024,Puzzle,"₩12,500",0%,98,5,103,64375000,89,6,95,59375000
271670,10 Second Ninja,2014,Puzzle,"₩2,200",0%,659,115,774,85140000,331,37,368,40480000
3064870,Last victim. House of Fear,2024,Puzzle,"₩1,100",0%,10,0,10,550000,11,0,11,605000
1119940,Storm Tale,2019,Puzzle,"₩11,000",0%,73,7,80,44000000,66,7,73,40150000
1016250,100$,2019,Puzzle,"₩1,100",0%,104,33,137,7535000,131,29,160,8800000
2104560,SOWON,2022,Puzzle,"₩11,000",0%,73,11,84,46200000,35,9,44,24200000
1697720,The Heilwald Loophole,2022,Puzzle,"₩10,500",0%,321,9,330,173250000,298,12,310,162750000
639560,Spacescape,2018,Puzzle,"₩8,900",0%,58,14,72,32040000,55,14,69,30705000
792340,ESPER,2018,Puzzle,"₩9,500",0%,13,2,15,7125000,9,2,11,5225000
1243790,Heart Star,2020,Puzzle,"₩5,600",0%,72,3,75,21000000,68,4,72,20160000
567210,Bunnyrama,2016,Puzzle,"₩3,400",0%,56,12,68,11560000,26,1,27,4590000
932120,TAL: Arctic 3,2018,Puzzle,"₩1,100",0%,32,9,41,2255000,30,7,37,2035000
716010,Inline,2018,Puzzle,Free,0%,101,5,106,0,106,6,112,0
1294110,Deep in the Woods,2024,Puzzle,"₩3,400",0%,57,13,70,11900000,34,10,44,7480000
654770,Ballway,2017,Puzzle,"₩5,500",0%,55,6,61,16775000,49,6,55,15125000
968370,The Blind Prophet,2020,Puzzle,"₩20,500",0%,392,56,448,459200000,316,47,363,372075000
3030550,Farm Chores,2024,Puzzle,Free,0%,115,7,122,0,114,9,123,0
792340,ESPER,2018,Puzzle,"₩9,500",0%,13,2,15,7125000,9,2,11,5225000
752600,Dual Snake,2018,Puzzle,Free,0%,70,5,75,0,71,5,76,0
1294110,Deep in the Woods,2024,Puzzle,"₩3,400",0%,57,13,70,11900000,34,10,44,7480000
218740,Pid,2012,Puzzle,"₩21,500",0%,2023,402,2425,2606875000,204,87,291,312825000
2301210,Busway Islands - Puzzle,2023,Puzzle,"₩3,400",0%,37,8,45,7650000,32,4,36,6120000
716010,Inline,2018,Puzzle,Free,0%,101,5,106,0,106,6,112,0
811270,Impulsion,2018,Puzzle,"₩13,500",0%,258,37,295,199125000,124,17,141,95175000
339160,Tales of the Orient: The Rising Sun,2015,Puzzle,"₩11,000",0%,315,69,384,211200000,51,11,62,34100000
416210,Block'hood,2017,Puzzle,"₩16,500",0%,923,320,1243,1025475000,847,313,1160,957000000
3296200,5 nights at Timokha 4: School,2024,Puzzle,₩640,72%,261,9,270,8640000,285,12,297,9504000
589100,The Moonstone Equation,2018,Puzzle,"₩10,500",0%,17,6,23,12075000,16,6,22,11550000
639560,Spacescape,2018,Puzzle,"₩8,900",0%,58,14,72,32040000,55,14,69,30705000
654770,Ballway,2017,Puzzle,"₩5,500",0%,55,6,61,16775000,49,6,55,15125000
1548750,Dahlia View,2021,Puzzle,"₩32,000",0%,281,45,326,521600000,231,34,265,424000000
3030550,Farm Chores,2024,Puzzle,Free,0%,115,7,122,0,114,9,123,0
562660,Pandarama: The Lost Toys,2016,Puzzle,"₩1,100",0%,57,11,68,3740000,44,10,54,2970000
708850,Reverie,2017,Puzzle,Free,0%,50,12,62,0,50,13,63,0
1141120,Scarlet Hood and the Wicked Wood,2021,Puzzle,"₩16,500",0%,216,36,252,207900000,153,29,182,150150000
274350,Dropsy,2015,Puzzle,"₩11,000",0%,1887,146,2033,1118150000,1436,108,1544,849200000
293660,TRI: Of Friendship and Madness,2014,Puzzle,"₩16,500",0%,429,73,502,414150000,299,61,360,297000000
546900,Fear Effect Sedna,2018,Puzzle,"₩19,500",0%,83,115,198,193050000,0,0,0,0
1237510,"Dr Livingstone, I Presume? Reversed Escape Room",2021,Puzzle,"₩7,500",0%,93,36,129,48375000,73,24,97,36375000
2614480,PortalSnake,2023,Puzzle,"₩7,800",0%,0,0,0,0,48,0,48,18720000
875110,InfiniPicross 2.0,2018,Puzzle,"₩4,900",0%,20,3,23,5635000,19,4,23,5635000
2793240,Surveillance Work -Taboo-,2024,Puzzle,"₩4,530",49%,38,0,38,8607000,39,0,39,8833500
274350,Dropsy,2015,Puzzle,"₩11,000",0%,1887,146,2033,1118150000,1436,108,1544,849200000
2896980,Cats in the Ancient City of Gu Su,2024,Puzzle,"₩1,100",0%,0,0,0,0,70,5,75,4125000
875110,InfiniPicross 2.0,2018,Puzzle,"₩4,900",0%,20,3,23,5635000,19,4,23,5635000
1373440,Picross for a Cause,2020,Puzzle,Free,0%,106,2,108,0,116,1,117,0
546900,Fear Effect Sedna,2018,Puzzle,"₩19,500",0%,83,115,198,193050000,0,0,0,0
562660,Pandarama: The Lost Toys,2016,Puzzle,"₩1,100",0%,57,11,68,3740000,44,10,54,2970000
811270,Impulsion,2018,Puzzle,"₩13,500",0%,258,37,295,199125000,124,17,141,95175000
843810,A Perfect Day,2022,Puzzle,"₩21,500",0%,1474,260,1734,1864050000,1408,249,1657,1781275000
1752730,Billy Bumbum: A Cheeky Puzzler,2023,Puzzle,"₩14,500",0%,37,1,38,27550000,20,2,22,15950000
293660,TRI: Of Friendship and Madness,2014,Puzzle,"₩16,500",0%,429,73,502,414150000,299,61,360,297000000
1888660,Mini Pipes - A Logic Puzzle Pipes Game,2022,Puzzle,"₩1,100",0%,79,1,80,4400000,81,2,83,4565000
1261700,Knight's Retreat,2020,Puzzle,"₩3,400",0%,89,8,97,16490000,69,4,73,12410000
3174280,Dusty,2024,Puzzle,Free,0%,0,0,0,0,44,10,54,0
499340,Turner,2016,Puzzle,Free,0%,74,8,82,0,76,9,85,0
3028600,City find all,2024,Puzzle,Free,0%,115,13,128,0,117,15,132,0
1410870,Trikaya,2021,Puzzle,Free,0%,289,51,340,0,292,51,343,0
301560,White Night,2015,Puzzle,"₩15,500",0%,281,99,380,294500000,214,72,286,221650000
930310,Puzzle Plunder,2018,Puzzle,Free,0%,139,23,162,0,142,23,165,0
2314110,Shutter,2023,Puzzle,Free,0%,0,0,0,0,93,12,105,0
2320410,Scavenger of Dunomini,2023,Puzzle,"₩6,700",0%,22,0,22,7370000,14,0,14,4690000
311010,The Way,2016,Puzzle,"₩16,500",0%,1053,212,1265,1043625000,718,157,875,721875000
3296920,Flibbius McDoogle and the Mysterious Flying Machine,2025,Puzzle,"₩5,600",0%,48,0,48,13440000,52,0,52,14560000
3179260,Kingdoms: Merge & Build,2024,Puzzle,"₩5,600",0%,7,3,10,2800000,7,3,10,2800000
587970,Dead Drop,2017,Puzzle,"₩5,600",0%,109,24,133,37240000,93,19,112,31360000
2445700,RPG Alchemy,2023,Puzzle,"₩3,400",0%,28,7,35,5950000,26,7,33,5610000
2445700,RPG Alchemy,2023,Puzzle,"₩3,400",0%,28,7,35,5950000,26,7,33,5610000
810630,Paint It Black,2018,Puzzle,"₩5,600",0%,47,10,57,15960000,43,11,54,15120000
560220,Estiman: Game of Estimation,2016,Puzzle,"₩4,500",0%,45,8,53,11925000,28,3,31,6975000
301560,White Night,2015,Puzzle,"₩15,500",0%,281,99,380,294500000,214,72,286,221650000
2878710,Desvelado,2024,Puzzle,"₩7,800",0%,319,1,320,124800000,309,3,312,121680000
3296920,Flibbius McDoogle and the Mysterious Flying Machine,2025,Puzzle,"₩5,600",0%,48,0,48,13440000,52,0,52,14560000
3179260,Kingdoms: Merge & Build,2024,Puzzle,"₩5,600",0%,7,3,10,2800000,7,3,10,2800000
545590,Button Tales,2016,Puzzle,"₩12,500",0%,139,7,146,91250000,39,2,41,25625000
2684780,Chromatic Isle,2024,Puzzle,Free,0%,0,0,0,0,66,4,70,0
3302650,Conscience,2024,Puzzle,Free,0%,0,0,0,0,124,9,133,0
937300,The Long Return,2019,Puzzle,"₩10,500",0%,99,19,118,61950000,87,19,106,55650000
2010320,TitTok Kitty,2023,Puzzle,"₩5,600",0%,63,7,70,19600000,59,7,66,18480000
3454210,101 Cats Hidden in Vienna,2025,Puzzle,"₩1,100",0%,0,0,0,0,26,3,29,1595000
2850300,坤坤之家,2024,Puzzle,"₩2,300",0%,84,7,91,10465000,78,8,86,9890000
771010,Containment,2018,Puzzle,"₩2,200",0%,43,8,51,5610000,37,8,45,4950000
654580,Senalux,2017,Puzzle,"₩8,500",0%,29,0,29,12325000,23,0,23,9775000
510650,Eventide 2: The Sorcerers Mirror,2016,Puzzle,"₩4,120",75%,266,72,338,69628000,166,53,219,45114000
3394460,Shieven,2025,Puzzle,"₩5,600",0%,13,0,13,3640000,12,2,14,3920000
1736710,Mummy Sandbox,2021,Puzzle,"₩3,400",0%,63,3,66,11220000,63,3,66,11220000
2607260,Demon Corporation: Onboarding,2025,Puzzle,"₩7,800",0%,54,0,54,21060000,38,0,38,14820000
1247940,Greyhat - A Digital Detective Adventure,2020,Puzzle,"₩10,500",0%,204,20,224,117600000,197,19,216,113400000
227080,Papo & Yo,2013,Puzzle,"₩16,000",0%,2649,187,2836,2268800000,1032,66,1098,878400000
895600,Mojo,2018,Puzzle,"₩3,400",0%,82,13,95,16150000,78,12,90,15300000
3735350,Akeno's Veil,2025,Puzzle,"₩5,600",0%,0,0,0,0,16,2,18,5040000
447890,Cat on a Diet,2016,Puzzle,"₩5,500",0%,807,156,963,264825000,418,92,510,140250000
401910,Darknet,2017,Puzzle,"₩16,000",0%,112,12,124,99200000,61,9,70,56000000
447890,Cat on a Diet,2016,Puzzle,"₩5,500",0%,807,156,963,264825000,418,92,510,140250000
453910,Love is Dead,2018,Puzzle,"₩13,500",0%,168,92,260,175500000,37,4,41,27675000
1566820,Cooking Trip New Challenge,2021,Puzzle,"₩16,500",0%,14,2,16,13200000,14,2,16,13200000
2608050,Cats Hidden in Jingle Jam,2023,Puzzle,Free,0%,0,0,0,0,0,0,0,0
3735890,101 Cats Hidden in Venice,2025,Puzzle,"₩1,100",0%,0,0,0,0,17,1,18,990000
497640,Trick & Treat,2016,Puzzle,Free,0%,2273,85,2358,0,0,0,0,0
2895750,So Fart Away,2025,Puzzle,"₩11,000",0%,29,0,29,15950000,12,0,12,6600000
2650510,It's Kooky - Land of Aotearoa,2024,Puzzle,"₩2,300",0%,27,5,32,3680000,26,6,32,3680000
2598490,ColorCoordination,2024,Puzzle,Free,0%,55,2,57,0,57,2,59,0
2826590,Sausage Cat,2025,Puzzle,"₩1,100",0%,29,0,29,1595000,31,0,31,1705000
552200,peakvox Mew Mew Chamber for Steam,2016,Puzzle,"₩3,400",0%,70,5,75,12750000,68,5,73,12410000
1174500,Yuletide Legends: Who Framed Santa Claus,2019,Puzzle,"₩16,500",0%,168,26,194,160050000,156,27,183,150975000
244890,Velocity®Ultra,2013,Puzzle,"₩10,500",0%,189,70,259,135975000,102,25,127,66675000
206370,Tales From Space: Mutant Blobs Attack,2012,Puzzle,"₩10,500",0%,829,77,906,475650000,517,33,550,288750000
2892300,Glitch Maze.exe,2024,Puzzle,Free,0%,0,0,0,0,58,2,60,0
539280,Tetraminos,2017,Puzzle,"₩1,050",90%,85,31,116,6090000,83,31,114,5985000
457480,Domino Sky,2016,Puzzle,"₩4,500",0%,298,71,369,83025000,277,69,346,77850000
1513310,Blockee - Sliding Puzzle,2021,Puzzle,"₩2,300",0%,43,3,46,5290000,41,3,44,5060000
3440830,New Year Home,2025,Puzzle,"₩2,300",0%,19,7,26,2990000,15,6,21,2415000
1460670,Jungle Town: Birthday quest,2020,Puzzle,"₩4,400",0%,10,1,11,2420000,9,1,10,2200000
432370,Sethian,2016,Puzzle,"₩5,500",0%,97,45,142,39050000,88,49,137,37675000
2928610,There's no Socks,2024,Puzzle,Free,0%,85,21,106,0,88,23,111,0
3061760,Colorizing,2024,Puzzle,"₩7,800",0%,22,1,23,8970000,14,1,15,5850000
1492420,EQUALINE,2021,Puzzle,"₩12,500",0%,38,0,38,23750000,31,0,31,19375000
206370,Tales From Space: Mutant Blobs Attack,2012,Puzzle,"₩10,500",0%,829,77,906,475650000,517,33,550,288750000
1710290,Helper Cat,2021,Puzzle,"₩1,100",0%,39,8,47,2585000,40,8,48,2640000
3500800,DreadOut Remastered Collection,2025,Puzzle,"₩32,000",0%,11,6,17,27200000,10,7,17,27200000
2892300,Glitch Maze.exe,2024,Puzzle,Free,0%,0,0,0,0,58,2,60,0
2231870,Persha and the Magic Labyrinth -Arabian Nyaights-,2023,Puzzle,"₩11,000",0%,25,6,31,17050000,14,4,18,9900000
539280,Tetraminos,2017,Puzzle,"₩1,050",90%,85,31,116,6090000,83,31,114,5985000
3083520,Hero Guider,2024,Puzzle,"₩2,300",0%,114,1,115,13225000,99,1,100,11500000
457480,Domino Sky,2016,Puzzle,"₩4,500",0%,298,71,369,83025000,277,69,346,77850000
3061760,Colorizing,2024,Puzzle,"₩7,800",0%,22,1,23,8970000,14,1,15,5850000
380150,STASIS,2015,Puzzle,"₩8,900",0%,1817,401,2218,987010000,1259,335,1594,709330000
799800,Animals Memory: Cats,2018,Puzzle,"₩4,500",0%,82,14,96,21600000,69,11,80,18000000
452120,Midvinter,2016,Puzzle,"₩3,400",0%,77,12,89,15130000,45,7,52,8840000
253790,rymdkapsel,2014,Puzzle,"₩8,900",0%,223,46,269,119705000,184,41,225,100125000
1573390,Lila’s Sky Ark,2022,Puzzle,"₩13,000",0%,123,18,141,91650000,77,10,87,56550000
646470,Alicia Quatermain: Secrets Of The Lost Treasures,2017,Puzzle,"₩3,300",0%,131,16,147,24255000,84,13,97,16005000
356090,Machineers - Episode 1: Tivoli Town,2015,Puzzle,"₩5,500",0%,26,1,27,7425000,21,1,22,6050000
1114460,Paranormal Detective: Escape from the 80's,2019,Puzzle,"₩10,500",0%,83,5,88,46200000,74,6,80,42000000
1875560,Mare,2022,Puzzle,"₩20,500",0%,34,8,42,43050000,30,7,37,37925000
1051580,Skjoldur Story,2021,Puzzle,"₩15,500",0%,28,6,34,26350000,14,5,19,14725000
3094150,Take Notes,2025,Puzzle,"₩7,200",0%,55,3,58,20880000,55,3,58,20880000
3219450,Nonogram Halloween,2024,Puzzle,"₩4,500",0%,14,2,16,3600000,12,2,14,3150000
2361610,In His Time,2023,Puzzle,"₩6,500",0%,28,3,31,10075000,22,4,26,8450000
1125880,LaserZone,2021,Puzzle,"₩14,500",0%,41,0,41,29725000,37,0,37,26825000
2561180,Rescue Team: Mineral of Miracles,2023,Puzzle,"₩7,800",0%,9,0,9,3510000,10,0,10,3900000
1806640,Mushroom Hunter,2021,Puzzle,"₩5,500",0%,27,2,29,7975000,20,2,22,6050000
260330,Flockers™,2014,Puzzle,"₩11,250",0%,165,51,216,121500000,116,38,154,86625000
516790,Fat Mask,2017,Puzzle,"₩10,500",0%,27,4,31,16275000,23,4,27,14175000
2561180,Rescue Team: Mineral of Miracles,2023,Puzzle,"₩7,800",0%,9,0,9,3510000,10,0,10,3900000
770410,Path to Mnemosyne,2018,Puzzle,"₩11,000",0%,180,56,236,129800000,140,35,175,96250000
561260,The Rabbit and The Owl,2018,Puzzle,"₩10,500",0%,49,0,49,25725000,28,0,28,14700000
1573390,Lila’s Sky Ark,2022,Puzzle,"₩13,000",0%,123,18,141,91650000,77,10,87,56550000
713740,Train Your Minibot,2021,Puzzle,"₩9,730",0%,11,0,11,5351500,10,0,10,4865000
384480,Six Sides of the World,2016,Puzzle,"₩5,600",0%,85,13,98,27440000,50,8,58,16240000
2361610,In His Time,2023,Puzzle,"₩6,500",0%,28,3,31,10075000,22,4,26,8450000
2638150,Choose Your Cutie,2023,Puzzle,"₩1,100",0%,25,7,32,1760000,22,5,27,1485000
341820,Plush,2015,Puzzle,"₩1,100",0%,70,12,82,4510000,44,9,53,2915000
1020940,Owyn's Adventure,2019,Puzzle,"₩2,200",0%,52,1,53,5830000,50,1,51,5610000
831070,The Cabinets of Doctor Arcana,2018,Puzzle,"₩10,500",0%,51,5,56,29400000,47,4,51,26775000
1394750,Mahjong World Contest 2,2020,Puzzle,"₩2,800",50%,11,3,14,1960000,12,3,15,2100000
1655960,Maptroid: Worlds,2022,Puzzle,"₩3,300",0%,75,5,80,13200000,69,4,73,12045000
1875560,Mare,2022,Puzzle,"₩20,500",0%,34,8,42,43050000,30,7,37,37925000
2653810,Pumpkin Game,2023,Puzzle,"₩2,300",0%,12,1,13,1495000,9,1,10,1150000
869170,Oneiros,2020,Puzzle,"₩2,240",60%,253,46,299,33488000,225,46,271,30352000
300630,Pure Chess Grandmaster Edition,2016,Puzzle,"₩16,500",0%,194,69,263,216975000,168,53,221,182325000
1395540,BOT.vinnik Chess: Winning Patterns,2020,Puzzle,"₩1,730",0%,74,8,82,7093000,69,4,73,6314500
320090,This Starry Midnight We Make,2015,Puzzle,"₩10,500",0%,46,7,53,27825000,43,8,51,26775000
2206450,Dwarfer,2022,Puzzle,"₩5,500",0%,13,1,14,3850000,23,2,25,6875000
3190610,Door4:Ultimatum,2025,Puzzle,"₩13,500",0%,10,3,13,8775000,6,4,10,6750000
1114030,The Room Syndrome,2019,Puzzle,Free,0%,339,18,357,0,337,22,359,0
341820,Plush,2015,Puzzle,"₩1,100",0%,70,12,82,4510000,44,9,53,2915000
489110,Putty Pals,2017,Puzzle,"₩10,500",0%,105,5,110,57750000,97,5,102,53550000
713740,Train Your Minibot,2021,Puzzle,"₩9,730",0%,11,0,11,5351500,10,0,10,4865000
320090,This Starry Midnight We Make,2015,Puzzle,"₩10,500",0%,46,7,53,27825000,43,8,51,26775000
1329350,蛊婆 Lady in Tomb,2021,Puzzle,"₩20,500",0%,393,27,420,430500000,372,28,400,410000000
3190610,Door4:Ultimatum,2025,Puzzle,"₩13,500",0%,10,3,13,8775000,6,4,10,6750000
1906140,SEARCH ALL - BERRIES,2022,Puzzle,"₩3,400",0%,62,10,72,12240000,57,10,67,11390000
332580,Mimpi,2015,Puzzle,"₩4,400",0%,270,54,324,71280000,226,43,269,59180000
1561060,Love Colors: Paint with Friends,2021,Puzzle,Free,0%,60,10,70,0,60,11,71,0
389270,Through Abandoned: The Underground City,2015,Puzzle,"₩1,100",0%,647,161,808,44440000,497,132,629,34595000
1655960,Maptroid: Worlds,2022,Puzzle,"₩3,300",0%,75,5,80,13200000,69,4,73,12045000
1995110,Slime Dungeon,2022,Puzzle,"₩1,100",0%,12,4,16,880000,20,6,26,1430000
583930,Faerie Solitaire Remastered,2017,Puzzle,"₩15,500",0%,508,75,583,451825000,309,46,355,275125000
916050,Clocker,2019,Puzzle,"₩5,600",0%,223,48,271,75880000,140,40,180,50400000
1173250,DE:VOID,2020,Puzzle,"₩7,500",0%,29,3,32,12000000,19,2,21,7875000
1243220,Picklock,2020,Puzzle,"₩8,500",0%,391,59,450,191250000,314,51,365,155125000
2062920,TTV4,2022,Puzzle,"₩1,100",0%,32,0,32,1760000,59,2,61,3355000
2832390,Time To Live,2025,Puzzle,"₩14,000",0%,12,1,13,9100000,11,1,12,8400000
1436920,Tandem: A Tale of Shadows,2021,Puzzle,"₩11,000",0%,197,19,216,118800000,117,19,136,74800000
1379830,Cyber Crush 2069,2020,Puzzle,"₩2,200",0%,590,191,781,85910000,518,182,700,77000000
434530,Flobe,2016,Puzzle,"₩5,600",0%,82,17,99,27720000,76,13,89,24920000
1522560,100 hidden mice,2021,Puzzle,"₩2,300",0%,395,23,418,48070000,351,18,369,42435000
2653810,Pumpkin Game,2023,Puzzle,"₩2,300",0%,12,1,13,1495000,9,1,10,1150000
1186030,Death Park,2019,Puzzle,"₩6,500",0%,138,29,167,54275000,134,26,160,52000000
1394750,Mahjong World Contest 2,2020,Puzzle,"₩2,800",50%,11,3,14,1960000,12,3,15,2100000
3027820,Nexus Rumble: The Ultimate Showdown,2024,Puzzle,Free,0%,50,3,53,0,64,7,71,0
770110,Twilight Path,2018,Puzzle,"₩15,500",0%,128,27,155,120125000,123,27,150,116250000
781820,Oik Memory 2,2018,Puzzle,"₩1,100",0%,191,23,214,11770000,189,23,212,11660000
1917810,Rooms of Realities,2023,Puzzle,"₩19,500",0%,60,3,63,61425000,46,3,49,47775000
1398910,Jorel’s Brother and The Most Important Game of the Galaxy - Complete Edition,2023,Puzzle,"₩16,500",0%,185,34,219,180675000,137,28,165,136125000
2824710,thanks mom,2024,Puzzle,"₩2,600",0%,41,8,49,6370000,35,6,41,5330000
1536520,Equinoxe,2022,Puzzle,Free,0%,0,0,0,0,53,9,62,0
1795070,Escape Logan Estate,2021,Puzzle,"₩5,600",0%,10,12,22,6160000,10,13,23,6440000
935860,The young mathematician: Easy difficulty,2018,Puzzle,"₩2,300",0%,31,7,38,4370000,28,6,34,3910000
2303320,Three Minutes To Eight,2023,Puzzle,"₩16,500",0%,118,38,156,128700000,69,35,104,85800000
530330,Blameless,2016,Puzzle,Free,0%,4195,790,4985,0,0,0,0,0
464230,Colours of Magic: Aqua Teeter,2016,Puzzle,"₩1,100",0%,78,24,102,5610000,58,21,79,4345000
2255120,Museum of Monoliths,2023,Puzzle,"₩1,190",65%,63,5,68,4046000,64,6,70,4165000
598940,Doodle Mafia,2017,Puzzle,"₩8,500",0%,98,49,147,62475000,60,21,81,34425000
3234330,Ninja Ming,2025,Puzzle,"₩11,000",0%,99,3,102,56100000,52,2,54,29700000
856600,Fur the Game,2019,Puzzle,Free,0%,138,12,150,0,138,14,152,0
734920,MEANDERS,2018,Puzzle,"₩3,300",0%,369,34,403,66495000,325,32,357,58905000
3655230,101 Cats Hidden in Mumbai,2025,Puzzle,"₩1,100",0%,0,0,0,0,23,0,23,1265000
1717120,Endless mahjong,2021,Puzzle,"₩37,500",0%,5,0,5,9375000,10,0,10,18750000
1709180,Solitaire Expeditions,2022,Puzzle,"₩11,000",0%,78,2,80,44000000,65,2,67,36850000
800190,The Adventures of Elena Temple: Definitive Edition,2018,Puzzle,"₩1,120",80%,59,3,62,3472000,40,2,42,2352000
1689980,Yummy Mahjong,2021,Puzzle,"₩5,500",0%,12,3,15,4125000,15,3,18,4950000
1844650,Krampus Kills,2022,Puzzle,"₩15,500",0%,52,11,63,48825000,48,9,57,44175000
1180610,Npc Problems: Vertex Coloring,2019,Puzzle,"₩1,100",0%,43,3,46,2530000,36,2,38,2090000
1844650,Krampus Kills,2022,Puzzle,"₩15,500",0%,52,11,63,48825000,48,9,57,44175000
1979320,Amber City,2022,Puzzle,"₩14,500",0%,49,2,51,36975000,38,2,40,29000000
800190,The Adventures of Elena Temple: Definitive Edition,2018,Puzzle,"₩1,120",80%,59,3,62,3472000,40,2,42,2352000
1426480,Fate of Kai,2021,Puzzle,"₩7,500",0%,201,16,217,81375000,147,14,161,60375000
2081670,CALAMITY CREATURES,2023,Puzzle,Free,0%,0,0,0,0,50,8,58,0
2850380,Device Doctor Simulator 2024,2025,Puzzle,"₩6,000",50%,78,41,119,35700000,76,47,123,36900000
1713050,Cave Explorer,2021,Puzzle,"₩5,500",0%,0,0,0,0,10,2,12,3300000
2720270,VFurrika!,2023,Puzzle,Free,0%,0,0,0,0,169,15,184,0
2322420,Stack Island - Survival card game,2023,Puzzle,"₩7,800",0%,8,3,11,4290000,7,3,10,3900000
533580,Entangle,2017,Puzzle,"₩6,500",0%,48,5,53,17225000,20,0,20,6500000
1180610,Npc Problems: Vertex Coloring,2019,Puzzle,"₩1,100",0%,43,3,46,2530000,36,2,38,2090000
3664530,Pyramis,2025,Puzzle,"₩5,600",0%,0,0,0,0,12,0,12,3360000
296830,Lucius II,2015,Puzzle,"₩21,000",0%,1380,860,2240,2352000000,1113,711,1824,1915200000
727070,Hex,2017,Puzzle,"₩4,400",0%,45,7,52,11440000,29,5,34,7480000
978630,Juro Janosik,2021,Puzzle,"₩12,500",0%,95,5,100,62500000,78,4,82,51250000
965510,Neon Junctions,2019,Puzzle,"₩4,500",0%,18,1,19,4275000,16,1,17,3825000
790290,Lonely in the Winter,2018,Puzzle,"₩3,400",0%,51,4,55,9350000,34,5,39,6630000
1000700,Insomnis,2022,Puzzle,"₩16,500",0%,236,23,259,213675000,131,21,152,125400000
540190,Tetropunk,2017,Puzzle,"₩5,600",0%,160,44,204,57120000,161,43,204,57120000
968820,Stormhill Mystery: Family Shadows,2019,Puzzle,"₩2,250",70%,124,30,154,17325000,113,30,143,16087500
888630,Another Sight - Definitive Edition,2018,Puzzle,"₩20,500",0%,142,41,183,187575000,108,34,142,145550000
2249590,All You Need is Help,2024,Puzzle,"₩16,500",0%,17,13,30,24750000,8,6,14,11550000
371900,Pillar,2015,Puzzle,"₩8,500",0%,36,16,52,22100000,11,1,12,5100000
3071520,There's No Monsters,2024,Puzzle,"₩4,500",0%,16,0,16,3600000,13,0,13,2925000
2341050,Cat Needs,2024,Puzzle,"₩3,400",0%,44,1,45,7650000,42,1,43,7310000
2198940,Just Hit The Button,2023,Puzzle,Free,0%,0,0,0,0,369,11,380,0
2619860,Animated Jigsaw Puzzles,2024,Puzzle,"₩5,600",0%,15,0,15,4200000,10,0,10,2800000
2954780,Nightmare House: The Original Mod,2024,Puzzle,Free,0%,0,0,0,0,1588,66,1654,0
1222570,Red Ronin,2021,Puzzle,"₩8,500",0%,149,20,169,71825000,97,15,112,47600000
297490,Spy Chameleon - RGB Agent,2014,Puzzle,"₩10,500",0%,268,36,304,159600000,103,20,123,64575000
2271000,Rayland 2,2023,Puzzle,"₩3,400",0%,37,3,40,6800000,36,3,39,6630000
497730,The Wardrobe - Even Better Edition,2017,Puzzle,"₩16,000",0%,434,103,537,429600000,405,108,513,410400000
3130800,Find My Frogs,2025,Puzzle,"₩4,500",0%,0,0,0,0,41,0,41,9225000
392610,Tricone Lab,2017,Puzzle,"₩10,500",0%,73,5,78,40950000,22,2,24,12600000
3454200,101 Cats Hidden in Milan,2025,Puzzle,"₩1,100",0%,0,0,0,0,26,1,27,1485000
362410,Adam's Venture Chronicles,2015,Puzzle,"₩10,500",0%,202,96,298,156450000,164,71,235,123375000
3452010,101 Cats Hidden in Istanbul,2025,Puzzle,"₩1,100",0%,0,0,0,0,34,2,36,1980000
337650,Soft Body,2016,Puzzle,"₩5,500",0%,41,4,45,12375000,29,3,32,8800000
1117310,Sandwich Sudoku,2019,Puzzle,"₩5,500",0%,158,5,163,44825000,154,6,160,44000000
755470,The World Next Door,2019,Puzzle,"₩10,500",0%,263,61,324,170100000,174,38,212,111300000
1919060,Kly-Kly,2022,Puzzle,"₩5,500",0%,9,2,11,3025000,10,2,12,3300000
636390,Ticket to Earth,2017,Puzzle,"₩15,500",0%,104,10,114,88350000,81,9,90,69750000
1907980,Elec Dude,2022,Puzzle,Free,0%,0,0,0,0,109,5,114,0
1500,Darwinia,2012,Puzzle,"₩13,500",0%,864,216,1080,729000000,586,165,751,506925000
2087610,UFO: Unidentified Falling Objects,2023,Puzzle,"₩16,500",0%,143,3,146,120450000,117,4,121,99825000
987880,Moo Moo Move,2019,Puzzle,Free,0%,51,6,57,0,50,7,57,0
1296560,Vectromirror 0™,2020,Puzzle,Free,0%,395,68,463,0,392,69,461,0
555290,Little Briar Rose,2016,Puzzle,"₩5,500",0%,190,37,227,62425000,166,34,200,55000000
1906150,Pixel Trouble,2022,Puzzle,"₩5,500",0%,13,2,15,4125000,10,1,11,3025000
1903080,Sharing Lights,2022,Puzzle,Free,0%,23,1,24,0,25,1,26,0
603010,Chill,2019,Puzzle,"₩1,100",0%,138,37,175,9625000,221,70,291,16005000
1397980,THE NORMAL THING,2020,Puzzle,Free,0%,457,23,480,0,457,24,481,0
910470,Backworlds,2020,Puzzle,Free,0%,56,1,57,0,58,2,60,0
3452020,101 Cats Hidden in London,2025,Puzzle,"₩1,100",0%,0,0,0,0,31,2,33,1815000
1249260,Birth ME Code,2020,Puzzle,"₩16,500",0%,76,16,92,75900000,70,15,85,70125000
1375540,Omno: Prologue,2020,Puzzle,Free,0%,265,5,270,0,0,0,0,0
3463460,Hidden Tomatoes 3,2025,Puzzle,Free,0%,0,0,0,0,100,5,105,0
645820,Odysseus Kosmos and his Robot Quest (Complete Season),2017,Puzzle,"₩16,500",0%,135,29,164,135300000,93,21,114,94050000
346250,The Old Tree,2015,Puzzle,Free,0%,2973,332,3305,0,0,0,0,0
2087610,UFO: Unidentified Falling Objects,2023,Puzzle,"₩16,500",0%,143,3,146,120450000,117,4,121,99825000
2340280,Programming Factory,2024,Puzzle,"₩2,300",0%,15,0,15,1725000,10,0,10,1150000
2568870,homebound,2023,Puzzle,Free,0%,48,5,53,0,47,5,52,0
2973820,Feet Paradise,2024,Puzzle,"₩1,100",0%,62,32,94,5170000,43,17,60,3300000
942050,2048,2018,Puzzle,"₩8,900",0%,149,23,172,76540000,142,23,165,73425000
688770,TETRUX: Online,2019,Puzzle,"₩3,300",0%,92,13,105,17325000,77,11,88,14520000
253750,Ikaruga,2014,Puzzle,"₩10,500",0%,2104,119,2223,1167075000,0,0,0,0
1072390,BirdGut,2019,Puzzle,Free,0%,4707,232,4939,0,0,0,0,0
1101660,Cooking Trip: Back on the road,2019,Puzzle,"₩16,500",0%,27,4,31,25575000,27,4,31,25575000
1412650,Conspiracy!,2021,Puzzle,"₩1,100",0%,19,4,23,1265000,21,5,26,1430000
1417540,Gravity Block,2021,Puzzle,"₩1,490",0%,45,3,48,3576000,41,3,44,3278000
2207060,Nanali in another world,2022,Puzzle,"₩5,500",0%,14,1,15,4125000,20,5,25,6875000
487160,Trials of Azra,2016,Puzzle,"₩8,900",0%,108,14,122,54290000,94,14,108,48060000
1544460,The Third Day,2021,Puzzle,"₩1,100",0%,102,19,121,6655000,84,16,100,5500000
1337530,Maskmaker,2021,Puzzle,"₩16,800",0%,277,21,298,250320000,220,19,239,200760000
3130800,Find My Frogs,2025,Puzzle,"₩4,500",0%,0,0,0,0,41,0,41,9225000
1544460,The Third Day,2021,Puzzle,"₩1,100",0%,102,19,121,6655000,84,16,100,5500000
253750,Ikaruga,2014,Puzzle,"₩10,500",0%,2104,119,2223,1167075000,0,0,0,0
450170,BOOR,2017,Puzzle,"₩1,100",0%,188,39,227,12485000,161,38,199,10945000
1419290,Out of Line,2021,Puzzle,"₩8,900",0%,199,22,221,98345000,106,17,123,54735000
858360,The Initiate 2: The First Interviews,2018,Puzzle,"₩15,500",0%,89,10,99,76725000,72,6,78,60450000
2302990,Vacuum Warrior - Idle Game,2023,Puzzle,Free,0%,616,139,755,0,629,148,777,0
914430,Pro Office Calculator,2018,Puzzle,Free,0%,349,32,381,0,363,36,399,0
1412650,Conspiracy!,2021,Puzzle,"₩1,100",0%,19,4,23,1265000,21,5,26,1430000
2161620,Lysfanga: The Time Shift Warrior,2024,Puzzle,"₩21,500",0%,118,33,151,162325000,88,30,118,126850000
1727930,Gorge,2021,Puzzle,Free,0%,67,10,77,0,68,10,78,0
375170,Gunpowder,2015,Puzzle,"₩1,100",0%,37,7,44,2420000,20,1,21,1155000
2067760,Trash Bomber,2022,Puzzle,Free,0%,0,0,0,0,187,12,199,0
205730,Insanely Twisted Shadow Planet,2012,Puzzle,"₩16,000",0%,754,113,867,693600000,483,66,549,439200000
1884990,Skala,2022,Puzzle,Free,0%,0,0,0,0,262,32,294,0
1949290,"Welcome, Get Out!",2023,Puzzle,Free,0%,0,0,0,0,57,14,71,0
3323500,Half Away,2024,Puzzle,"₩7,800",0%,16,0,16,6240000,10,0,10,3900000
2277910,I commissioned some bees 14,2023,Puzzle,"₩1,350",70%,15,0,15,1012500,15,0,15,1012500
1325910,Trainslation,2021,Puzzle,Free,0%,0,0,0,0,47,6,53,0
2843090,Chrono Recorder,2024,Puzzle,Free,0%,0,0,0,0,50,12,62,0
3500640,Arithmetic,2025,Puzzle,Free,0%,0,0,0,0,66,4,70,0
1916890,Slider,2024,Puzzle,Free,0%,0,0,0,0,359,11,370,0
595560,Legend of Hand,2017,Puzzle,"₩7,800",0%,90,7,97,37830000,75,6,81,31590000
2119740,United heist,2023,Puzzle,Free,0%,1482,317,1799,0,1544,339,1883,0
2653480,Shanshui Haven,2024,Puzzle,"₩8,900",0%,81,1,82,36490000,46,1,47,20915000
2653480,Shanshui Haven,2024,Puzzle,"₩8,900",0%,81,1,82,36490000,46,1,47,20915000
2098290,Project R4T,2022,Puzzle,Free,0%,0,0,0,0,126,8,134,0
1520680,Tetra Cube,2021,Puzzle,"₩7,500",0%,48,8,56,21000000,42,7,49,18375000
2289970,In Sink: A Co-Op Escape Prologue,2023,Puzzle,Free,0%,0,0,0,0,0,0,0,0
916160,Dreamwalker: Never Fall Asleep,2018,Puzzle,"₩4,120",75%,227,39,266,54796000,129,21,150,30900000
2206570,Geolosys,2022,Puzzle,"₩5,500",0%,13,1,14,3850000,17,3,20,5500000
2007470,SEARCH ALL - BIRDS,2022,Puzzle,"₩3,400",0%,38,5,43,7310000,36,6,42,7140000
1493300,100 hidden aliens,2020,Puzzle,"₩2,300",0%,410,73,483,55545000,372,60,432,49680000
2722570,Christmas Girls,2023,Puzzle,"₩1,100",0%,53,15,68,3740000,39,9,48,2640000
1833820,From Red to Green,2022,Puzzle,"₩2,200",0%,15,2,17,1870000,15,0,15,1650000
414370,Raining Blobs,2016,Puzzle,"₩10,500",0%,84,12,96,50400000,36,2,38,19950000
839670,Alice's Adventures - Hidden Object Puzzle Game,2018,Puzzle,"₩4,500",0%,57,9,66,14850000,53,9,62,13950000
727760,Umiro,2018,Puzzle,"₩3,400",0%,131,33,164,27880000,121,32,153,26010000
1607040,Evertried,2021,Puzzle,"₩21,500",0%,55,14,69,74175000,25,9,34,36550000
682780,Breaking Good,2017,Puzzle,"₩2,300",0%,139,18,157,18055000,95,16,111,12765000
1106830,Rainbow Billy: The Curse of the Leviathan,2021,Puzzle,"₩20,500",0%,202,14,216,221400000,122,12,134,137350000
1161360,Shisensho Solitaire,2019,Puzzle,"₩2,300",0%,80,1,81,9315000,74,1,75,8625000
1481910,Time Bandit – Part 1: Appendages of the Machine,2023,Puzzle,"₩11,000",0%,60,3,63,34650000,54,3,57,31350000
933060,Hentai Weed PuZZles,2018,Puzzle,"₩1,100",0%,130,39,169,9295000,54,14,68,3740000
1336120,Bridge Constructor: The Walking Dead,2020,Puzzle,"₩11,000",0%,223,77,300,165000000,146,60,206,113300000
1268370,holedown,2020,Puzzle,"₩11,000",0%,50,8,58,31900000,46,8,54,29700000
2063310,Joe Wander and the Enigmatic Adventures,2023,Puzzle,"₩32,000",0%,75,11,86,137600000,35,10,45,72000000
1920100,Backfirewall_,2023,Puzzle,"₩18,000",0%,388,30,418,376200000,290,29,319,287100000
1098840,ZACH-LIKE,2019,Puzzle,Free,0%,141,5,146,0,145,6,151,0
2881900,Cosmo Cats,2025,Puzzle,Free,0%,0,0,0,0,143,20,163,0
1833820,From Red to Green,2022,Puzzle,"₩2,200",0%,15,2,17,1870000,15,0,15,1650000
2685240,Where Cats 猫咪在哪里,2023,Puzzle,"₩1,100",0%,0,0,0,0,128,7,135,7425000
1812280,Cave Story's Secret Santa,2021,Puzzle,Free,0%,0,0,0,0,670,137,807,0
1384940,Egression,2022,Puzzle,"₩20,500",0%,122,4,126,129150000,110,5,115,117875000
1573750,100 hidden mushrooms,2021,Puzzle,"₩2,300",0%,393,39,432,49680000,340,30,370,42550000
414370,Raining Blobs,2016,Puzzle,"₩10,500",0%,84,12,96,50400000,36,2,38,19950000
1072620,Weakless,2020,Puzzle,"₩16,500",0%,95,31,126,103950000,78,31,109,89925000
1481910,Time Bandit – Part 1: Appendages of the Machine,2023,Puzzle,"₩11,000",0%,60,3,63,34650000,54,3,57,31350000
1158290,Mini Words - minimalist puzzle,2019,Puzzle,"₩2,300",0%,159,11,170,19550000,142,8,150,17250000
1393570,Superbugs: Awaken,2022,Puzzle,"₩15,500",0%,164,24,188,145700000,128,11,139,107725000
1106830,Rainbow Billy: The Curse of the Leviathan,2021,Puzzle,"₩20,500",0%,202,14,216,221400000,122,12,134,137350000
2063310,Joe Wander and the Enigmatic Adventures,2023,Puzzle,"₩32,000",0%,75,11,86,137600000,35,10,45,72000000
2228030,Dr. Fetus' Mean Meat Machine,2023,Puzzle,"₩11,000",0%,122,63,185,101750000,122,74,196,107800000
933060,Hentai Weed PuZZles,2018,Puzzle,"₩1,100",0%,130,39,169,9295000,54,14,68,3740000
2891870,Forgotten Hill: The Wardrobe,2024,Puzzle,"₩5,600",0%,33,12,45,12600000,35,13,48,13440000
1750350,Sebil Engineering,2023,Puzzle,"₩13,500",0%,89,2,91,61425000,76,2,78,52650000
1848150,Mysterious House,2021,Puzzle,"₩1,100",0%,9,4,13,715000,19,2,21,1155000
1098840,ZACH-LIKE,2019,Puzzle,Free,0%,141,5,146,0,145,6,151,0
839670,Alice's Adventures - Hidden Object Puzzle Game,2018,Puzzle,"₩4,500",0%,57,9,66,14850000,53,9,62,13950000
1746620,Where is Paradise ?,2024,Puzzle,"₩1,100",0%,29,7,36,1980000,18,4,22,1210000
1933180,Varney Lake,2023,Puzzle,"₩11,000",0%,63,0,63,34650000,58,0,58,31900000
1416460,Horror Globes,2020,Puzzle,"₩5,360",19%,85,7,92,24656000,76,8,84,22512000
558110,Odyssey - The Story of Science,2017,Puzzle,"₩16,000",0%,229,75,304,243200000,154,52,206,164800000
509220,Save Jesus,2016,Puzzle,"₩2,300",0%,1956,221,2177,250355000,1315,130,1445,166175000
2578110,We're Tethered Together,2023,Puzzle,Free,0%,0,0,0,0,207,6,213,0
251510,Constant C,2014,Puzzle,"₩10,500",0%,45,6,51,26775000,25,2,27,14175000
411560,Reveal The Deep,2015,Puzzle,"₩1,100",0%,1205,250,1455,80025000,1120,246,1366,75130000
1066430,Kwaidan ～Azuma manor story～,2020,Puzzle,"₩14,500",0%,48,14,62,44950000,48,12,60,43500000
2328770,House Sitter Escape Game,2023,Puzzle,"₩6,700",0%,12,0,12,4020000,10,0,10,3350000
2350390,Neko Office: Nightlife Adventures,2023,Puzzle,"₩1,100",0%,29,4,33,1815000,28,3,31,1705000
2923230,Rules & Rodents,2025,Puzzle,"₩6,700",0%,0,0,0,0,25,0,25,8375000
1628440,Trick & Treat Remake,2021,Puzzle,"₩2,200",0%,55,0,55,6050000,54,0,54,5940000
3450480,Figure it Out!,2025,Puzzle,Free,0%,0,0,0,0,85,4,89,0
2143930,Spirits of Baciu - Prologue,2022,Puzzle,Free,0%,0,0,0,0,133,18,151,0
1625080,Have a Nice Dream,2021,Puzzle,Free,0%,4313,328,4641,0,0,0,0,0
70650,Worms Blast,2011,Puzzle,"₩1,700",80%,191,154,345,29325000,112,61,173,14705000
941480,Giraffe Town,2018,Puzzle,"₩5,600",0%,315,74,389,108920000,245,50,295,82600000
454410,GIGA WRECKER,2017,Puzzle,"₩21,000",0%,563,162,725,761250000,523,156,679,712950000
2508210,Lair of Torment,2023,Puzzle,"₩4,500",0%,107,33,140,31500000,103,34,137,30825000
1690190,Portal Walk,2025,Puzzle,"₩4,200",25%,9,0,9,1890000,11,0,11,2310000
2207050,My Soul Forever,2022,Puzzle,"₩5,500",0%,15,3,18,4950000,20,3,23,6325000
848530,Cyberemo 2007,2020,Puzzle,"₩1,860",0%,82,28,110,10230000,66,16,82,7626000
72400,Clones,2010,Puzzle,"₩2,200",0%,296,95,391,43010000,249,79,328,36080000
1126470,Jewel Match Atlantis Solitaire - Collector's Edition,2019,Puzzle,"₩13,500",0%,85,17,102,68850000,58,4,62,41850000
1039830,彼岸画廊/Nether Gallery,2019,Puzzle,"₩7,500",0%,175,28,203,76125000,116,21,137,51375000
2429540,Harmonis: the hand-made kingdoms,2025,Puzzle,"₩9,500",0%,20,5,25,11875000,18,5,23,10925000
2957970,SOMNIFUGE,2025,Puzzle,"₩11,000",0%,14,1,15,8250000,15,2,17,9350000
2323670,Jigsaw Puzzle Delicious Foods,2023,Puzzle,"₩1,100",0%,16,0,16,880000,15,0,15,825000
3515250,Puzzle Paradise,2025,Puzzle,"₩64,400",0%,213,37,250,805000000,97,17,114,367080000
315430,Polarity,2016,Puzzle,"₩13,500",0%,3721,969,4690,3165750000,0,0,0,0
2323670,Jigsaw Puzzle Delicious Foods,2023,Puzzle,"₩1,100",0%,16,0,16,880000,15,0,15,825000
3515250,Puzzle Paradise,2025,Puzzle,"₩64,400",0%,213,37,250,805000000,97,17,114,367080000
873200,Teleportals. I swear it's a nice game,2018,Puzzle,"₩1,100",0%,308,12,320,17600000,264,11,275,15125000
622630,Bendy: Secrets of the Machine,2024,Puzzle,Free,0%,0,0,0,0,1633,335,1968,0
600140,Belko VR: An Escape Room Experiment,2017,Puzzle,Free,0%,577,93,670,0,575,94,669,0
2429540,Harmonis: the hand-made kingdoms,2025,Puzzle,"₩9,500",0%,20,5,25,11875000,18,5,23,10925000
207650,A Virus Named TOM,2012,Puzzle,"₩10,500",0%,421,330,751,394275000,45,17,62,32550000
3424020,Letterlike,2025,Puzzle,"₩8,900",0%,38,1,39,17355000,23,1,24,10680000
1409710,Escape from Tatris,2020,Puzzle,Free,0%,344,38,382,0,346,38,384,0
3380320,Non-Euclidean Minesweeper,2024,Puzzle,"₩3,400",0%,11,0,11,1870000,14,1,15,2550000
1004370,Paper Cut Mansion,2022,Puzzle,"₩20,500",0%,50,21,71,72775000,32,20,52,53300000
1172170,Krystopia: A Puzzle Journey,2019,Puzzle,"₩5,500",0%,52,7,59,16225000,38,6,44,12100000
1752250,How To Bathe Your Cat,2021,Puzzle,"₩1,100",0%,119,14,133,7315000,107,12,119,6545000
1492720,GunBlocks - Prologue,2021,Puzzle,Free,0%,101,3,104,0,101,3,104,0
2776550,SirKwitz,2024,Puzzle,Free,0%,0,0,0,0,78,4,82,0
3408060,Palm Cracker,2025,Puzzle,Free,0%,0,0,0,0,65,1,66,0
2207110,Power Driver,2022,Puzzle,"₩5,500",0%,14,2,16,4400000,22,0,22,6050000
1605690,Ruka,2021,Puzzle,Free,0%,0,0,0,0,261,11,272,0
316160,Broken Sword 4 - the Angel of Death (2006),2014,Puzzle,"₩10,500",0%,202,278,480,252000000,181,240,421,221025000
2052170,In to the 029,2022,Puzzle,"₩6,500",0%,32,11,43,13975000,30,11,41,13325000
3347050,101 Cats Hidden in Singapore,2025,Puzzle,"₩1,100",0%,0,0,0,0,29,3,32,1760000
897760,PUT ANNA,2018,Puzzle,₩710,35%,63,7,70,2485000,60,5,65,2307500
454410,GIGA WRECKER,2017,Puzzle,"₩21,000",0%,563,162,725,761250000,523,156,679,712950000
3665840,MineSweeper Rush,2025,Puzzle,Free,0%,0,0,0,0,56,6,62,0
1199660,The Answer Is 42,2019,Puzzle,"₩2,300",0%,142,14,156,17940000,119,6,125,14375000
3665840,MineSweeper Rush,2025,Puzzle,Free,0%,0,0,0,0,56,6,62,0
1871500,One Line: Letters and Codes,2022,Puzzle,"₩1,100",0%,57,3,60,3300000,48,3,51,2805000
3278230,Gravity Block 2,2024,Puzzle,"₩1,490",0%,11,0,11,819500,11,0,11,819500
1416460,Horror Globes,2020,Puzzle,"₩5,360",19%,85,7,92,24656000,76,8,84,22512000
2445140,Turn on the light - Jigsaw,2023,Puzzle,Free,0%,0,0,0,0,110,7,117,0
2730270,Sputnika Game,2024,Puzzle,Free,0%,0,0,0,0,443,49,492,0
1742530,My journey to your world,2021,Puzzle,Free,0%,0,0,0,0,47,11,58,0
340360,Tomb of Tyrants,2015,Puzzle,"₩8,500",0%,262,57,319,135575000,180,51,231,98175000
558790,Queen's Quest 2: Stories of Forgotten Past,2017,Puzzle,"₩16,500",0%,228,22,250,206250000,168,13,181,149325000
1970560,Bobbi Adventure,2022,Puzzle,"₩5,500",0%,20,5,25,6875000,18,4,22,6050000
1493840,BOT.vinnik Chess: Opening Traps,2020,Puzzle,"₩1,730",0%,55,7,62,5363000,50,6,56,4844000
1340310,Nine Lives,2020,Puzzle,Free,0%,10,0,10,0,10,0,10,0
3196310,MeiQi 2024,2024,Puzzle,"₩16,500",0%,27,1,28,23100000,14,0,14,11550000
2685240,Where Cats 猫咪在哪里,2023,Puzzle,"₩1,100",0%,0,0,0,0,128,7,135,7425000
262470,Rollers of the Realm,2014,Puzzle,"₩11,000",0%,619,79,698,383900000,331,37,368,202400000
2022470,Mythargia,2023,Puzzle,"₩6,700",0%,48,3,51,17085000,33,4,37,12395000
1419060,Retchid,2023,Puzzle,"₩27,000",0%,46,9,55,74250000,42,9,51,68850000
773090,Lucid Dream Adventure,2018,Puzzle,"₩6,500",0%,183,39,222,72150000,155,36,191,62075000
317320,Nelly Cootalot: The Fowl Fleet,2016,Puzzle,"₩10,750",50%,276,15,291,156412500,204,13,217,116637500
1607670,Secret Agent HD,2021,Puzzle,"₩8,500",0%,150,2,152,64600000,150,3,153,65025000
1542840,PuzzlePet - Feed your cat,2021,Puzzle,"₩1,100",0%,54,1,55,3025000,44,2,46,2530000
3020130,Foxlore,2025,Puzzle,"₩11,000",0%,9,1,10,5500000,10,0,10,5500000
1305720,Delores: A Thimbleweed Park Mini-Adventure,2020,Puzzle,Free,0%,536,75,611,0,534,80,614,0
2508210,Lair of Torment,2023,Puzzle,"₩4,500",0%,107,33,140,31500000,103,34,137,30825000
853310,Mr. Maze,2019,Puzzle,"₩2,300",0%,49,10,59,6785000,41,10,51,5865000
1426980,Hidden Memory - Nature,2020,Puzzle,"₩2,300",0%,78,13,91,10465000,65,11,76,8740000
773090,Lucid Dream Adventure,2018,Puzzle,"₩6,500",0%,183,39,222,72150000,155,36,191,62075000
647040,Riaaf The Spider,2017,Puzzle,"₩1,100",0%,168,30,198,10890000,132,20,152,8360000
3655240,101 Cats Hidden in Taiwan,2025,Puzzle,"₩1,100",0%,0,0,0,0,22,2,24,1320000
922820,Lotus Bloom,2021,Puzzle,"₩2,200",0%,17,1,18,1980000,10,1,11,1210000
1176480,The City of Time,2020,Puzzle,"₩1,100",0%,26,1,27,1485000,23,1,24,1320000
1599690,WORDLAND,2021,Puzzle,"₩2,300",0%,31,1,32,3680000,30,1,31,3565000
845350,Color Path,2018,Puzzle,"₩2,300",0%,15,3,18,2070000,12,3,15,1725000
552970,Sumoman,2017,Puzzle,"₩13,500",0%,493,126,619,417825000,416,110,526,355050000
1300560,Mars Power Industries: First Job,2020,Puzzle,Free,0%,61,4,65,0,60,4,64,0
601930,Trianguluv,2017,Puzzle,"₩2,300",0%,60,10,70,8050000,45,5,50,5750000
2306710,Enigma Manor,2023,Puzzle,"₩11,000",0%,17,9,26,14300000,15,9,24,13200000
853310,Mr. Maze,2019,Puzzle,"₩2,300",0%,49,10,59,6785000,41,10,51,5865000
983450,Astral Towers,2020,Puzzle,"₩5,500",0%,43,7,50,13750000,39,7,46,12650000
1077160,Game Of Puzzles: Animals,2019,Puzzle,Free,0%,116,8,124,0,117,9,126,0
618470,Qbik,2017,Puzzle,"₩5,500",0%,111,13,124,34100000,104,12,116,31900000
1305720,Delores: A Thimbleweed Park Mini-Adventure,2020,Puzzle,Free,0%,536,75,611,0,534,80,614,0
2611580,Quiet is the Eyes,2023,Puzzle,Free,0%,0,0,0,0,195,8,203,0
1044020,Potata: fairy flower,2019,Puzzle,"₩9,500",0%,70,17,87,41325000,52,17,69,32775000
809240,Vandals,2018,Puzzle,₩880,84%,76,21,97,4268000,58,18,76,3344000
3550060,Minesweeper Together,2025,Puzzle,"₩3,400",0%,23,0,23,3910000,26,1,27,4590000
375310,Mighty Switch Force! Hose It Down!,2015,Puzzle,"₩3,300",0%,64,10,74,12210000,58,10,68,11220000
383690,Mu Complex,2015,Puzzle,"₩9,500",0%,159,41,200,95000000,148,39,187,88825000
2611590,Tale of Time: Bagua,2024,Puzzle,Free,0%,0,0,0,0,21,2,23,0
1933180,Varney Lake,2023,Puzzle,"₩11,000",0%,63,0,63,34650000,58,0,58,31900000
